,Account,Balance Date,Transaction Value,Balance
0,10005367,2023-01-31,,728.25
1522,10005367,2023-02-02,-1097.6,-369.3499999999999
510,10005367,2023-02-04,144.75,-224.5999999999999
6944,10005367,2023-02-04,-67.01,-291.6099999999999
2641,10005367,2023-02-05,-108.26,-399.8699999999999
8620,10005367,2023-02-08,941.0,541.1300000000001
1494,10005367,2023-02-08,-65.49,475.6400000000001
8445,10005367,2023-02-10,-27.61,448.0300000000001
6258,10005367,2023-02-11,137.25,585.2800000000001
1,10011977,2023-01-31,,676.54
1420,10011977,2023-02-02,-51.0,625.54
497,10011977,2023-02-03,120.88,746.42
4025,10011977,2023-02-04,58.05,804.4699999999999
1082,10011977,2023-02-04,-170.56,633.91
4213,10011977,2023-02-04,-189.38,444.53
3647,10011977,2023-02-05,-124.61,319.91999999999996
8493,10011977,2023-02-08,133.74,453.65999999999997
7619,10011977,2023-02-10,-103.55,350.10999999999996
2023,10011977,2023-02-11,-43.89,306.21999999999997
2244,10011977,2023-02-14,1100.7,1406.92
2,10024680,2023-01-31,,567.46
2998,10024680,2023-02-01,-153.43,414.03000000000003
6187,10024680,2023-02-03,676.5,1090.53
7032,10024680,2023-02-07,-91.92,998.61
2115,10024680,2023-02-07,-127.45,871.16
5147,10024680,2023-02-08,-138.18,732.98
3,10031238,2023-01-31,,576.52
1368,10031238,2023-02-05,121.7,698.22
5860,10031238,2023-02-05,-110.07,588.15
2602,10031238,2023-02-09,-35.39,552.76
4533,10031238,2023-02-10,65.02,617.78
2017,10031238,2023-02-10,-160.6,457.18
5671,10031238,2023-02-11,-157.96,299.22
4,10034341,2023-01-31,,390.39
8614,10034341,2023-02-03,1566.6,1956.9899999999998
3395,10034341,2023-02-05,-217.15,1739.8399999999997
4287,10034341,2023-02-08,-110.25,1629.5899999999997
2312,10034341,2023-02-12,123.13,1752.7199999999998
6579,10034341,2023-02-14,-74.72,1677.9999999999998
5,10079965,2023-01-31,,799.27
2132,10079965,2023-02-03,156.35,955.62
748,10079965,2023-02-08,-63.9,891.72
5478,10079965,2023-02-08,-132.2,759.52
2276,10079965,2023-02-08,-442.3,317.21999999999997
6,10091076,2023-01-31,,831.83
6002,10091076,2023-02-01,75.45,907.2800000000001
3331,10091076,2023-02-01,-18.77,888.51
1121,10091076,2023-02-01,-83.96,804.5500000000001
343,10091076,2023-02-05,53.92,858.47
7566,10091076,2023-02-14,53.72,912.19
7932,10091076,2023-02-14,-10.22,901.97
7,10231977,2023-01-31,,61.63
1752,10231977,2023-02-01,116.0,177.63
1116,10231977,2023-02-08,-68.31,109.32
3644,10231977,2023-02-09,-1410.1,-1300.78
1000,10231977,2023-02-14,78.92,-1221.86
2977,10231977,2023-02-14,-723.4,-1945.26
8,10232603,2023-01-31,,732.55
2827,10232603,2023-02-01,125.68,858.23
6240,10232603,2023-02-02,-1190.9,-332.6700000000001
2775,10232603,2023-02-04,-888.9,-1221.5700000000002
4228,10232603,2023-02-06,88.22,-1133.3500000000001
5741,10232603,2023-02-07,-185.47,-1318.8200000000002
8439,10232603,2023-02-10,85.03,-1233.79
7941,10232603,2023-02-10,-1128.4,-2362.19
9,10243581,2023-01-31,,104.27
1493,10243581,2023-02-04,-109.65,-5.38000000000001
2773,10243581,2023-02-06,-78.93,-84.31000000000002
5046,10243581,2023-02-10,83.3,-1.0100000000000193
6820,10243581,2023-02-12,-1482.9,-1483.91
6119,10243581,2023-02-13,-20.17,-1504.0800000000002
4335,10243581,2023-02-14,-134.51,-1638.5900000000001
10,10271519,2023-01-31,,50.02
4334,10271519,2023-02-03,2285.6,2335.62
3664,10271519,2023-02-03,95.05,2430.67
7830,10271519,2023-02-03,17.57,2448.24
140,10271519,2023-02-03,-100.99,2347.25
5643,10271519,2023-02-11,-89.55,2257.7
3643,10271519,2023-02-12,98.81,2356.5099999999998
4160,10271519,2023-02-12,76.71,2433.22
11,10273387,2023-01-31,,581.83
5886,10273387,2023-02-03,113.03,694.86
8245,10273387,2023-02-03,-556.5,138.36
8159,10273387,2023-02-06,181.24,319.6
926,10273387,2023-02-07,-38.41,281.19000000000005
56,10273387,2023-02-08,-140.45,140.74000000000004
5083,10273387,2023-02-10,138.8,279.5400000000001
363,10273387,2023-02-10,-71.11,208.43000000000006
6891,10273387,2023-02-12,130.68,339.11000000000007
3019,10273387,2023-02-14,278.4,617.51
12,10288821,2023-01-31,,642.41
5472,10288821,2023-02-07,-151.7,490.71
1595,10288821,2023-02-11,85.41,576.12
8413,10288821,2023-02-12,228.52,804.64
6722,10288821,2023-02-14,94.21,898.85
13,10295384,2023-01-31,,153.85
2685,10295384,2023-02-03,10.64,164.49
1830,10295384,2023-02-04,55.98,220.47
1606,10295384,2023-02-04,-96.09,124.38
1327,10295384,2023-02-06,100.34,224.72
2,10295384,2023-02-06,87.57,312.28999999999996
7020,10295384,2023-02-07,186.15,498.44
3634,10295384,2023-02-07,133.09,631.53
5165,10295384,2023-02-09,-110.01,521.52
7677,10295384,2023-02-11,-62.52,459.0
7897,10295384,2023-02-13,128.0,587.0
14,10350324,2023-01-31,,861.81
1711,10350324,2023-02-03,247.64,1109.4499999999998
5623,10350324,2023-02-04,81.35,1190.8
1893,10350324,2023-02-04,47.39,1238.1899999999998
467,10350324,2023-02-07,-42.19,1196.0
7540,10350324,2023-02-10,-91.04,1104.96
4154,10350324,2023-02-11,132.19,1237.1499999999999
4029,10350324,2023-02-11,119.75,1356.8999999999999
2197,10350324,2023-02-13,-142.63,1214.27
15,10437896,2023-01-31,,661.08
6392,10437896,2023-02-04,55.24,716.32
5572,10437896,2023-02-04,-51.84,664.48
3630,10437896,2023-02-06,68.72,733.2
7256,10437896,2023-02-09,116.34,849.5400000000001
3576,10437896,2023-02-11,1107.1,1956.6399999999999
8431,10437896,2023-02-13,73.97,2030.61
16,10449180,2023-01-31,,228.24
4837,10449180,2023-02-01,48.99,277.23
21,10449180,2023-02-02,25.81,303.04
4684,10449180,2023-02-06,784.3,1087.34
8492,10449180,2023-02-11,75.88,1163.2199999999998
17,10464544,2023-01-31,,755.99
1775,10464544,2023-02-01,-89.56,666.4300000000001
6309,10464544,2023-02-07,135.77,802.2
8297,10464544,2023-02-08,132.1,934.3
4847,10464544,2023-02-12,-463.1,471.2
7825,10464544,2023-02-14,987.9,1459.1
7536,10464544,2023-02-14,-81.26,1377.84
18,10473116,2023-01-31,,387.7
3309,10473116,2023-02-01,-94.91,292.78999999999996
5529,10473116,2023-02-03,87.46,380.25
7855,10473116,2023-02-06,-1194.9,-814.6500000000001
103,10473116,2023-02-08,103.49,-711.1600000000001
4189,10473116,2023-02-10,28.23,-682.9300000000001
5847,10473116,2023-02-12,-108.51,-791.44
19,10521885,2023-01-31,,54.87
869,10521885,2023-02-01,127.41,182.28
3997,10521885,2023-02-01,-83.86,98.42
4563,10521885,2023-02-03,120.33,218.75
5265,10521885,2023-02-09,37.14,255.89
7583,10521885,2023-02-12,70.6,326.49
4583,10521885,2023-02-14,150.19,476.68
7439,10521885,2023-02-14,53.35,530.03
20,10553619,2023-01-31,,756.2
1352,10553619,2023-02-01,72.18,828.3800000000001
5926,10553619,2023-02-01,-112.77,715.61
7800,10553619,2023-02-03,133.94,849.5500000000001
2481,10553619,2023-02-04,-1263.9,-414.35
4371,10553619,2023-02-05,-89.62,-503.97
78,10553619,2023-02-06,-1085.4,-1589.3700000000001
5185,10553619,2023-02-11,873.9,-715.4700000000001
4428,10553619,2023-02-14,1485.6,770.1299999999998
2663,10553619,2023-02-14,-43.02,727.1099999999998
21,10554116,2023-01-31,,243.95
7203,10554116,2023-02-01,-121.83,122.11999999999999
22,10586481,2023-01-31,,73.83
7273,10586481,2023-02-03,100.42,174.25
5950,10586481,2023-02-11,142.56,316.81
943,10586481,2023-02-12,128.32,445.13
5326,10586481,2023-02-12,-49.53,395.6
2547,10586481,2023-02-14,-24.89,370.71
23,10608220,2023-01-31,,632.92
8580,10608220,2023-02-01,33.49,666.41
6881,10608220,2023-02-01,-89.41,577.0
6445,10608220,2023-02-04,-117.26,459.73999999999995
4162,10608220,2023-02-05,78.8,538.54
5036,10608220,2023-02-10,-55.88,482.65999999999997
5950,10608220,2023-02-11,-142.56,340.09999999999997
5918,10608220,2023-02-13,86.79,426.89
5178,10608220,2023-02-13,-98.19,328.7
1065,10608220,2023-02-13,-118.5,210.2
24,10631690,2023-01-31,,947.45
8517,10631690,2023-02-03,165.39,1112.8400000000001
3544,10631690,2023-02-03,-41.04,1071.8
4436,10631690,2023-02-11,-151.02,920.78
25,10675607,2023-01-31,,284.84
2648,10675607,2023-02-01,-114.21,170.63
6520,10675607,2023-02-08,-19.11,151.51999999999998
2909,10675607,2023-02-14,-908.4,-756.88
26,10725127,2023-01-31,,984.69
920,10725127,2023-02-04,-1268.7,-284.01
6691,10725127,2023-02-09,148.39,-135.62
3577,10725127,2023-02-11,102.03,-33.59
8413,10725127,2023-02-12,-228.52,-262.11
7422,10725127,2023-02-13,-157.99,-420.1
27,10769769,2023-01-31,,906.91
7303,10769769,2023-02-01,-93.28,813.63
278,10769769,2023-02-02,38.78,852.41
2280,10769769,2023-02-02,-20.72,831.6899999999999
7140,10769769,2023-02-02,-96.8,734.89
878,10769769,2023-02-02,-1502.2,-767.3100000000001
2084,10769769,2023-02-03,-89.51,-856.82
1455,10769769,2023-02-05,145.08,-711.74
6298,10769769,2023-02-05,-59.15,-770.8900000000001
6863,10769769,2023-02-08,-143.57,-914.46
252,10769769,2023-02-09,58.86,-855.6
6260,10769769,2023-02-10,-51.82,-907.4200000000001
7329,10769769,2023-02-10,-85.7,-993.1200000000001
8224,10769769,2023-02-11,666.5,-326.6200000000001
3123,10769769,2023-02-11,172.32,-154.30000000000013
28,10783139,2023-01-31,,992.98
546,10783139,2023-02-04,103.81,1096.79
5734,10783139,2023-02-05,-92.78,1004.01
5236,10783139,2023-02-08,-96.33,907.6800000000001
888,10783139,2023-02-09,9.69,917.37
300,10783139,2023-02-09,-129.76,787.61
2675,10783139,2023-02-10,72.06,859.6700000000001
5167,10783139,2023-02-12,109.08,968.75
29,10799356,2023-01-31,,915.04
537,10799356,2023-02-06,138.24,1053.28
3081,10799356,2023-02-06,127.85,1181.1299999999999
3275,10799356,2023-02-11,-120.98,1060.1499999999999
298,10799356,2023-02-11,-259.39,800.76
1820,10799356,2023-02-12,-94.16,706.6
8204,10799356,2023-02-14,-1314.7,-608.1
30,10819898,2023-01-31,,750.25
6923,10819898,2023-02-01,103.68,853.9300000000001
824,10819898,2023-02-02,15.52,869.45
608,10819898,2023-02-03,-91.02,778.4300000000001
8646,10819898,2023-02-05,-36.13,742.3
6472,10819898,2023-02-08,123.29,865.59
2939,10819898,2023-02-10,-104.75,760.84
4489,10819898,2023-02-12,98.15,858.99
6646,10819898,2023-02-14,114.54,973.53
5730,10819898,2023-02-14,47.83,1021.36
31,10842511,2023-01-31,,651.77
3516,10842511,2023-02-02,-155.92,495.85
8052,10842511,2023-02-13,102.44,598.29
32,10847941,2023-01-31,,40.25
30,10847941,2023-02-06,-64.29,-24.040000000000006
4005,10847941,2023-02-07,-143.62,-167.66000000000003
6544,10847941,2023-02-08,92.54,-75.12000000000002
713,10847941,2023-02-10,-146.12,-221.24
4256,10847941,2023-02-11,1094.0,872.76
33,10864084,2023-01-31,,119.98
128,10864084,2023-02-02,-150.75,-30.769999999999996
2295,10864084,2023-02-02,-179.69,-210.45999999999998
5933,10864084,2023-02-05,-39.08,-249.53999999999996
401,10864084,2023-02-06,154.92,-94.62
3226,10864084,2023-02-06,114.81,20.189999999999998
5923,10864084,2023-02-06,72.7,92.89
4035,10864084,2023-02-10,98.32,191.20999999999998
6411,10864084,2023-02-11,65.15,256.36
7741,10864084,2023-02-13,-1545.5,-1289.1399999999999
34,10942334,2023-01-31,,55.42
1276,10942334,2023-02-05,-92.89,-37.47
4224,10942334,2023-02-07,-33.98,-71.44999999999999
3626,10942334,2023-02-10,116.67,45.22
3833,10942334,2023-02-11,84.45,129.67000000000002
35,10949168,2023-01-31,,471.8
4820,10949168,2023-02-04,-105.89,365.91
4105,10949168,2023-02-04,-127.73,238.18
6712,10949168,2023-02-07,71.99,310.17
2795,10949168,2023-02-09,-214.76,95.41000000000003
3260,10949168,2023-02-11,146.95,242.36
7973,10949168,2023-02-12,52.81,295.17
1703,10949168,2023-02-14,-13.43,281.74
36,10989769,2023-01-31,,334.18
7522,10989769,2023-02-03,854.4,1188.58
6478,10989769,2023-02-12,-154.56,1034.02
8607,10989769,2023-02-13,102.22,1136.24
5717,10989769,2023-02-13,-66.55,1069.69
37,11008868,2023-01-31,,271.3
3615,11008868,2023-02-02,-0.91,270.39
2742,11008868,2023-02-07,-207.86,62.53
6860,11008868,2023-02-13,96.98,159.51
1989,11008868,2023-02-13,93.56,253.07
1296,11008868,2023-02-14,131.58,384.65000000000003
38,11026937,2023-01-31,,303.44
3771,11026937,2023-02-02,90.91,394.35
3302,11026937,2023-02-02,-47.72,346.63
1252,11026937,2023-02-06,-85.44,261.19
6873,11026937,2023-02-07,-75.08,186.11
3553,11026937,2023-02-07,-92.55,93.56
1495,11026937,2023-02-13,-42.26,51.300000000000004
5678,11026937,2023-02-14,67.47,118.77000000000001
39,11061291,2023-01-31,,72.7
536,11061291,2023-02-01,-162.41,-89.71
5986,11061291,2023-02-03,-53.42,-143.13
2798,11061291,2023-02-03,-149.54,-292.66999999999996
706,11061291,2023-02-04,186.95,-105.72
4353,11061291,2023-02-08,61.41,-44.31
5868,11061291,2023-02-08,5.73,-38.58
6252,11061291,2023-02-09,-119.17,-157.75
2754,11061291,2023-02-12,121.86,-35.89
3789,11061291,2023-02-14,-78.98,-114.87
40,11067879,2023-01-31,,481.56
2020,11067879,2023-02-01,187.01,668.5699999999999
6826,11067879,2023-02-01,-812.6,-144.02999999999997
824,11067879,2023-02-02,-15.52,-159.54999999999998
4002,11067879,2023-02-04,81.63,-77.91999999999997
2925,11067879,2023-02-06,97.09,19.17000000000003
2473,11067879,2023-02-07,151.33,170.50000000000006
4658,11067879,2023-02-07,-96.93,73.57000000000002
3085,11067879,2023-02-07,-123.45,-49.87999999999998
1592,11067879,2023-02-08,-66.39,-116.26999999999998
4618,11067879,2023-02-11,172.57,56.30000000000001
8675,11067879,2023-02-11,-87.16,-30.859999999999985
1422,11067879,2023-02-13,-78.91,-109.76999999999998
41,11110085,2023-01-31,,861.29
3326,11110085,2023-02-03,107.9,969.1899999999999
741,11110085,2023-02-05,1712.2,2681.39
3762,11110085,2023-02-06,97.33,2778.7200000000003
1835,11110085,2023-02-11,109.66,2888.38
2637,11110085,2023-02-12,122.36,3010.7400000000002
3204,11110085,2023-02-12,-66.27,2944.4700000000003
908,11110085,2023-02-13,-147.67,2796.8
7504,11110085,2023-02-14,1397.8,4194.6
2086,11110085,2023-02-14,-152.84,4041.76
42,11150945,2023-01-31,,858.83
7250,11150945,2023-02-01,240.2,1099.03
2339,11150945,2023-02-01,-345.3,753.73
2584,11150945,2023-02-03,32.07,785.8000000000001
2326,11150945,2023-02-03,-189.03,596.77
6565,11150945,2023-02-06,43.59,640.36
596,11150945,2023-02-09,133.16,773.52
436,11150945,2023-02-09,98.03,871.55
7892,11150945,2023-02-13,763.2,1634.75
5783,11150945,2023-02-13,-126.72,1508.03
43,11228111,2023-01-31,,130.36
4577,11228111,2023-02-01,-142.2,-11.839999999999975
2170,11228111,2023-02-02,-1501.3,-1513.1399999999999
6379,11228111,2023-02-09,179.65,-1333.4899999999998
8663,11228111,2023-02-10,169.47,-1164.02
4562,11228111,2023-02-11,77.54,-1086.4799999999998
8237,11228111,2023-02-11,69.11,-1017.3699999999999
44,11242986,2023-01-31,,344.68
407,11242986,2023-02-01,-160.4,184.28
3666,11242986,2023-02-06,-21.12,163.16
8015,11242986,2023-02-08,-93.77,69.39
1515,11242986,2023-02-09,55.87,125.25999999999999
2182,11242986,2023-02-11,-102.16,23.099999999999994
45,11251776,2023-01-31,,504.02
3873,11251776,2023-02-03,88.94,592.96
738,11251776,2023-02-04,84.15,677.11
3467,11251776,2023-02-09,150.22,827.3299999999999
4844,11251776,2023-02-10,-67.69,759.64
3747,11251776,2023-02-11,79.08,838.72
5335,11251776,2023-02-14,-950.7,-111.98000000000002
46,11302888,2023-01-31,,458.83
2605,11302888,2023-02-04,117.6,576.43
5818,11302888,2023-02-05,-80.56,495.87
934,11302888,2023-02-06,182.96,678.8299999999999
525,11302888,2023-02-10,-19.72,659.11
47,11306584,2023-01-31,,522.4
6992,11306584,2023-02-01,52.0,574.4
7702,11306584,2023-02-03,-432.2,142.2
8401,11306584,2023-02-07,1198.9,1341.1000000000001
5312,11306584,2023-02-07,45.38,1386.4800000000002
5224,11306584,2023-02-09,151.14,1537.6200000000001
3612,11306584,2023-02-10,-30.61,1507.0100000000002
6346,11306584,2023-02-11,63.83,1570.8400000000001
5353,11306584,2023-02-12,1681.9,3252.7400000000002
7812,11306584,2023-02-12,-71.74,3181.0000000000005
5110,11306584,2023-02-14,-701.1,2479.9
48,11333185,2023-01-31,,693.23
696,11333185,2023-02-02,99.58,792.8100000000001
4139,11333185,2023-02-06,113.2,906.01
5649,11333185,2023-02-06,-676.7,229.30999999999995
2484,11333185,2023-02-07,186.08,415.39
7011,11333185,2023-02-07,-1440.9,-1025.5100000000002
8089,11333185,2023-02-10,-67.29,-1092.8000000000002
2314,11333185,2023-02-11,155.81,-936.9900000000002
3884,11333185,2023-02-11,88.41,-848.5800000000003
8654,11333185,2023-02-11,-138.48,-987.0600000000002
1497,11333185,2023-02-13,1582.4,595.3399999999999
49,11346696,2023-01-31,,661.99
207,11346696,2023-02-04,-91.69,570.3
731,11346696,2023-02-06,-75.77,494.53000000000003
4647,11346696,2023-02-09,-113.15,381.38
5022,11346696,2023-02-10,-812.8,-431.41999999999996
843,11346696,2023-02-13,-1487.7,-1919.12
50,11359678,2023-01-31,,837.17
7669,11359678,2023-02-07,65.16,902.3299999999999
2512,11359678,2023-02-07,-67.04,835.29
8361,11359678,2023-02-11,62.24,897.53
894,11359678,2023-02-14,-74.53,823.0
51,11360263,2023-01-31,,136.79
7712,11360263,2023-02-01,100.02,236.81
7167,11360263,2023-02-03,130.53,367.34
4441,11360263,2023-02-03,101.8,469.14
6529,11360263,2023-02-06,173.03,642.17
6156,11360263,2023-02-06,80.15,722.3199999999999
4557,11360263,2023-02-09,-68.25,654.0699999999999
4298,11360263,2023-02-12,-47.25,606.8199999999999
52,11368995,2023-01-31,,565.8
2226,11368995,2023-02-01,-63.48,502.31999999999994
128,11368995,2023-02-02,150.75,653.0699999999999
3662,11368995,2023-02-02,-140.61,512.4599999999999
8421,11368995,2023-02-04,-121.49,390.96999999999997
6610,11368995,2023-02-05,-92.6,298.36999999999995
419,11368995,2023-02-06,52.22,350.59
949,11368995,2023-02-08,65.06,415.65
53,11437275,2023-01-31,,115.34
7261,11437275,2023-02-05,98.47,213.81
6184,11437275,2023-02-07,112.5,326.31
8298,11437275,2023-02-07,-144.5,181.81
8116,11437275,2023-02-09,94.06,275.87
6697,11437275,2023-02-10,-100.43,175.44
5065,11437275,2023-02-10,-112.61,62.83
54,11438427,2023-01-31,,484.08
5952,11438427,2023-02-06,123.77,607.85
2001,11438427,2023-02-07,-23.9,583.9499999999999
6536,11438427,2023-02-08,-190.12,393.83
6112,11438427,2023-02-08,-1686.0,-1292.17
55,11463412,2023-01-31,,342.53
3818,11463412,2023-02-07,-97.82,244.70999999999998
8313,11463412,2023-02-09,1582.3,1827.01
56,11475827,2023-01-31,,363.88
4652,11475827,2023-02-01,48.39,412.27
8571,11475827,2023-02-07,89.09,501.36
4644,11475827,2023-02-08,-45.54,455.82
2615,11475827,2023-02-11,1129.9,1585.72
6394,11475827,2023-02-11,86.86,1672.58
2842,11475827,2023-02-12,106.02,1778.6
57,11522216,2023-01-31,,590.37
578,11522216,2023-02-03,43.61,633.98
8286,11522216,2023-02-04,199.41,833.39
7233,11522216,2023-02-10,106.62,940.01
3906,11522216,2023-02-10,82.97,1022.98
1408,11522216,2023-02-14,81.37,1104.35
58,11662506,2023-01-31,,573.89
7442,11662506,2023-02-01,-167.85,406.03999999999996
6295,11662506,2023-02-05,102.96,509.0
5434,11662506,2023-02-05,89.72,598.72
7110,11662506,2023-02-09,-38.09,560.63
1502,11662506,2023-02-09,-134.78,425.84999999999997
4995,11662506,2023-02-11,-84.35,341.5
8041,11662506,2023-02-14,-77.33,264.16999999999996
7504,11662506,2023-02-14,-1397.8,-1133.63
59,11694020,2023-01-31,,379.2
1656,11694020,2023-02-04,-189.72,189.48
7300,11694020,2023-02-06,44.43,233.91
4132,11694020,2023-02-09,-1363.6,-1129.6899999999998
6234,11694020,2023-02-12,1.29,-1128.3999999999999
986,11694020,2023-02-14,725.0,-403.39999999999986
60,11717885,2023-01-31,,6.06
5782,11717885,2023-02-05,-72.53,-66.47
6999,11717885,2023-02-13,-86.51,-152.98000000000002
61,11728970,2023-01-31,,711.65
5373,11728970,2023-02-06,123.61,835.26
5372,11728970,2023-02-06,84.79,920.05
4141,11728970,2023-02-09,-135.18,784.87
2477,11728970,2023-02-14,93.35,878.22
62,11736814,2023-01-31,,381.51
5845,11736814,2023-02-03,-133.06,248.45
3187,11736814,2023-02-05,-790.5,-542.05
5822,11736814,2023-02-06,98.86,-443.18999999999994
8548,11736814,2023-02-11,-1851.4,-2294.59
63,11744491,2023-01-31,,105.92
7383,11744491,2023-02-01,142.98,248.89999999999998
1217,11744491,2023-02-01,112.17,361.07
5977,11744491,2023-02-03,656.3,1017.3699999999999
510,11744491,2023-02-04,-144.75,872.6199999999999
4409,11744491,2023-02-06,-92.39,780.2299999999999
6766,11744491,2023-02-09,87.15,867.3799999999999
1892,11744491,2023-02-09,-176.85,690.53
8137,11744491,2023-02-10,-39.7,650.8299999999999
576,11744491,2023-02-11,85.89,736.7199999999999
6373,11744491,2023-02-12,-55.81,680.9099999999999
1685,11744491,2023-02-13,115.86,796.7699999999999
3984,11744491,2023-02-13,-121.39,675.3799999999999
64,11764022,2023-01-31,,286.66
1765,11764022,2023-02-01,-117.24,169.42000000000002
374,11764022,2023-02-03,3.65,173.07000000000002
2997,11764022,2023-02-10,86.61,259.68000000000006
65,11778031,2023-01-31,,514.7
5702,11778031,2023-02-08,-37.69,477.01000000000005
1402,11778031,2023-02-09,-64.44,412.57000000000005
2177,11778031,2023-02-11,102.08,514.6500000000001
8197,11778031,2023-02-13,569.6,1084.25
66,11790056,2023-01-31,,49.7
622,11790056,2023-02-01,119.97,169.67000000000002
7230,11790056,2023-02-01,-95.49,74.18
698,11790056,2023-02-03,12.0,86.18
4462,11790056,2023-02-05,-91.81,-5.6299999999999955
2033,11790056,2023-02-06,-47.78,-53.41
609,11790056,2023-02-06,-688.5,-741.91
3672,11790056,2023-02-08,90.7,-651.2099999999999
822,11790056,2023-02-08,-41.57,-692.78
7920,11790056,2023-02-09,-969.7,-1662.48
67,11804173,2023-01-31,,353.62
443,11804173,2023-02-02,119.36,472.98
239,11804173,2023-02-04,100.25,573.23
814,11804173,2023-02-04,-159.42,413.81
2232,11804173,2023-02-11,-53.59,360.22
68,11826060,2023-01-31,,782.13
4894,11826060,2023-02-05,63.32,845.45
2370,11826060,2023-02-07,81.64,927.09
7947,11826060,2023-02-09,38.13,965.22
6346,11826060,2023-02-11,-63.83,901.39
7548,11826060,2023-02-13,118.67,1020.06
1657,11826060,2023-02-13,93.04,1113.1
69,11831265,2023-01-31,,292.14
7778,11831265,2023-02-01,-91.77,200.37
7511,11831265,2023-02-01,-103.4,96.96999999999998
1312,11831265,2023-02-01,-140.67,-43.7
3340,11831265,2023-02-09,-98.31,-142.01
932,11831265,2023-02-10,89.98,-52.03
7422,11831265,2023-02-13,157.99,105.96000000000001
5925,11831265,2023-02-14,-85.67,20.290000000000006
70,11836917,2023-01-31,,650.14
2890,11836917,2023-02-01,-138.19,511.95
423,11836917,2023-02-12,90.66,602.61
1175,11836917,2023-02-14,165.55,768.16
3448,11836917,2023-02-14,87.88,856.04
71,11846043,2023-01-31,,915.59
1198,11846043,2023-02-02,69.49,985.08
1220,11846043,2023-02-06,87.82,1072.9
8660,11846043,2023-02-07,-56.28,1016.62
5787,11846043,2023-02-10,-1640.4,-623.7800000000001
1585,11846043,2023-02-12,139.76,-484.0200000000001
72,11882775,2023-01-31,,299.41
2570,11882775,2023-02-01,-105.63,193.78000000000003
3100,11882775,2023-02-01,-1058.7,-864.9200000000001
2662,11882775,2023-02-03,118.76,-746.1600000000001
4764,11882775,2023-02-03,-753.5,-1499.66
2769,11882775,2023-02-05,84.05,-1415.6100000000001
5169,11882775,2023-02-06,-90.05,-1505.66
4923,11882775,2023-02-06,-1791.9,-3297.5600000000004
2082,11882775,2023-02-08,209.73,-3087.8300000000004
5704,11882775,2023-02-09,1202.9,-1884.93
73,11910409,2023-01-31,,241.22
2694,11910409,2023-02-01,-80.43,160.79
1350,11910409,2023-02-04,-78.93,81.85999999999999
5041,11910409,2023-02-05,78.36,160.21999999999997
2308,11910409,2023-02-05,-118.22,41.999999999999986
1889,11910409,2023-02-06,-53.53,-11.530000000000015
3914,11910409,2023-02-12,103.79,92.25999999999999
7882,11910409,2023-02-13,112.31,204.57
74,11928523,2023-01-31,,818.51
3214,11928523,2023-02-05,-149.91,668.6
7451,11928523,2023-02-07,-76.58,592.02
8174,11928523,2023-02-08,-74.38,517.64
641,11928523,2023-02-11,99.31,616.95
8047,11928523,2023-02-12,2208.4,2825.3500000000004
8285,11928523,2023-02-13,68.67,2894.02
75,12035637,2023-01-31,,461.35
1036,12035637,2023-02-02,-779.9,-318.54999999999995
6460,12035637,2023-02-02,-1138.0,-1456.55
8253,12035637,2023-02-03,-36.14,-1492.69
2168,12035637,2023-02-07,1190.8,-301.8900000000001
4379,12035637,2023-02-07,260.82,-41.07000000000011
5291,12035637,2023-02-07,230.31,189.2399999999999
3457,12035637,2023-02-08,-90.52,98.7199999999999
333,12035637,2023-02-08,-143.15,-44.430000000000106
5134,12035637,2023-02-08,-1169.6,-1214.03
81,12035637,2023-02-10,551.6,-662.43
4702,12035637,2023-02-11,-137.31,-799.74
6576,12035637,2023-02-12,-123.5,-923.24
76,12042151,2023-01-31,,336.44
7466,12042151,2023-02-03,-89.74,246.7
3704,12042151,2023-02-05,97.45,344.15
293,12042151,2023-02-07,101.5,445.65
1945,12042151,2023-02-09,-64.03,381.62
3067,12042151,2023-02-11,1271.5,1653.12
3676,12042151,2023-02-11,-32.04,1621.08
7986,12042151,2023-02-13,-61.53,1559.55
77,12088180,2023-01-31,,656.51
5149,12088180,2023-02-11,22.62,679.13
1620,12088180,2023-02-12,190.9,870.03
1764,12088180,2023-02-14,-45.9,824.13
78,12099406,2023-01-31,,681.11
8201,12099406,2023-02-01,-94.97,586.14
4120,12099406,2023-02-07,-934.2,-348.06000000000006
7051,12099406,2023-02-10,-143.73,-491.7900000000001
3827,12099406,2023-02-12,1201.1,709.3099999999998
5687,12099406,2023-02-13,112.0,821.3099999999998
79,12111805,2023-01-31,,890.99
1594,12111805,2023-02-01,110.9,1001.89
1451,12111805,2023-02-03,-79.35,922.54
678,12111805,2023-02-06,128.91,1051.45
1737,12111805,2023-02-10,-185.21,866.24
3384,12111805,2023-02-11,-77.84,788.4
3223,12111805,2023-02-13,-202.54,585.86
4804,12111805,2023-02-14,-94.45,491.41
80,12172627,2023-01-31,,550.41
3413,12172627,2023-02-02,137.03,687.4399999999999
283,12172627,2023-02-05,-116.16,571.28
473,12172627,2023-02-12,-76.51,494.77
81,12185627,2023-01-31,,873.23
288,12185627,2023-02-02,-30.52,842.71
1937,12185627,2023-02-03,225.89,1068.6
2778,12185627,2023-02-04,-50.19,1018.41
8595,12185627,2023-02-05,-80.67,937.74
7328,12185627,2023-02-10,206.97,1144.71
4174,12185627,2023-02-11,193.89,1338.6
2300,12185627,2023-02-11,100.94,1439.54
4832,12185627,2023-02-12,-72.94,1366.6
6011,12185627,2023-02-13,-91.8,1274.8
82,12198380,2023-01-31,,445.46
4393,12198380,2023-02-03,145.97,591.43
1550,12198380,2023-02-04,134.24,725.67
6514,12198380,2023-02-05,100.05,825.72
1823,12198380,2023-02-05,-144.38,681.3399999999999
1684,12198380,2023-02-05,-171.75,509.59
2883,12198380,2023-02-07,-34.47,475.12
2707,12198380,2023-02-09,145.71,620.8299999999999
3293,12198380,2023-02-12,67.66,688.49
7977,12198380,2023-02-14,-85.37,603.12
83,12199229,2023-01-31,,804.0
7775,12199229,2023-02-11,-30.47,773.53
2027,12199229,2023-02-11,-31.4,742.13
84,12233762,2023-01-31,,386.05
3465,12233762,2023-02-05,-114.97,271.08000000000004
4941,12233762,2023-02-06,-102.35,168.73000000000002
2400,12233762,2023-02-07,-110.05,58.68000000000002
7654,12233762,2023-02-07,-134.62,-75.93999999999998
4198,12233762,2023-02-10,83.93,7.990000000000023
3101,12233762,2023-02-11,-370.4,-362.40999999999997
3940,12233762,2023-02-12,150.86,-211.54999999999995
6567,12233762,2023-02-14,-176.37,-387.91999999999996
85,12240007,2023-01-31,,894.48
2107,12240007,2023-02-02,93.98,988.46
730,12240007,2023-02-04,-2.44,986.02
7604,12240007,2023-02-05,1748.6,2734.62
708,12240007,2023-02-05,-64.41,2670.21
2228,12240007,2023-02-12,-127.13,2543.08
3335,12240007,2023-02-13,-562.4,1980.6799999999998
86,12241820,2023-01-31,,207.29
87,12388837,2023-01-31,,463.31
5458,12388837,2023-02-03,55.47,518.78
4815,12388837,2023-02-05,-183.42,335.36
69,12388837,2023-02-07,65.45,400.81
444,12388837,2023-02-13,111.37,512.1800000000001
6528,12388837,2023-02-14,87.61,599.79
88,12420291,2023-01-31,,578.47
4918,12420291,2023-02-03,-1223.8,-645.3299999999999
5765,12420291,2023-02-08,-796.3,-1441.6299999999999
7046,12420291,2023-02-11,-105.46,-1547.09
1882,12420291,2023-02-12,-70.05,-1617.1399999999999
89,12423613,2023-01-31,,459.18
4747,12423613,2023-02-02,-1805.5,-1346.32
5204,12423613,2023-02-04,95.13,-1251.19
2288,12423613,2023-02-14,73.71,-1177.48
90,12440230,2023-01-31,,842.67
7966,12440230,2023-02-07,16.27,858.9399999999999
6047,12440230,2023-02-07,-197.12,661.8199999999999
4676,12440230,2023-02-14,-175.06,486.76
91,12493067,2023-01-31,,404.61
6113,12493067,2023-02-03,86.49,491.1
2221,12493067,2023-02-06,114.74,605.84
6157,12493067,2023-02-08,-105.32,500.52
1657,12493067,2023-02-13,-93.04,407.48
4921,12493067,2023-02-14,44.96,452.44
92,12494185,2023-01-31,,762.16
2772,12494185,2023-02-04,71.39,833.55
6680,12494185,2023-02-04,-97.26,736.29
3812,12494185,2023-02-07,-97.29,639.0
8412,12494185,2023-02-07,-117.32,521.68
93,12499656,2023-01-31,,96.27
2720,12499656,2023-02-01,168.84,265.11
6402,12499656,2023-02-01,75.09,340.2
1745,12499656,2023-02-02,140.57,480.77
2974,12499656,2023-02-03,-111.35,369.41999999999996
3346,12499656,2023-02-05,147.75,517.17
4228,12499656,2023-02-06,-88.22,428.95
4490,12499656,2023-02-07,-38.62,390.33
2143,12499656,2023-02-10,152.92,543.25
4404,12499656,2023-02-13,98.34,641.5899999999999
6583,12499656,2023-02-14,-156.27,485.31999999999994
94,12560453,2023-01-31,,85.03
5962,12560453,2023-02-01,147.6,232.63
3003,12560453,2023-02-05,152.02,384.65
1617,12560453,2023-02-05,71.33,455.98
4163,12560453,2023-02-08,47.58,503.56
5150,12560453,2023-02-08,-55.71,447.85
4808,12560453,2023-02-13,-49.05,398.8
95,12583269,2023-01-31,,910.46
7490,12583269,2023-02-02,125.46,1035.92
7534,12583269,2023-02-03,-118.33,917.59
5322,12583269,2023-02-04,-129.11,788.48
3686,12583269,2023-02-05,80.89,869.37
17,12583269,2023-02-14,63.34,932.71
96,12666385,2023-01-31,,554.24
6752,12666385,2023-02-01,246.14,800.38
6155,12666385,2023-02-01,106.46,906.84
1931,12666385,2023-02-04,1593.8,2500.64
6419,12666385,2023-02-12,149.57,2650.21
97,12680102,2023-01-31,,674.64
8390,12680102,2023-02-05,-41.65,632.99
8069,12680102,2023-02-08,603.0,1235.99
7436,12680102,2023-02-09,-97.29,1138.7
5058,12680102,2023-02-11,-1010.6,128.10000000000002
1763,12680102,2023-02-12,94.03,222.13000000000002
2212,12680102,2023-02-13,-851.7,-629.57
98,12725274,2023-01-31,,26.19
7442,12725274,2023-02-01,167.85,194.04
5423,12725274,2023-02-04,125.11,319.15
3564,12725274,2023-02-05,-58.28,260.87
1139,12725274,2023-02-14,412.8,673.6700000000001
3706,12725274,2023-02-14,-162.9,510.77
99,12859818,2023-01-31,,151.06
34,12859818,2023-02-01,89.22,240.28
83,12859818,2023-02-03,-129.38,110.9
1226,12859818,2023-02-04,-81.01,29.89
2684,12859818,2023-02-04,-110.3,-80.41
6149,12859818,2023-02-07,-106.24,-186.64999999999998
4199,12859818,2023-02-10,-36.91,-223.56
3835,12859818,2023-02-10,-131.38,-354.94
2767,12859818,2023-02-13,-203.37,-558.31
2547,12859818,2023-02-14,24.89,-533.42
100,12899540,2023-01-31,,957.2
1655,12899540,2023-02-01,-83.35,873.85
2261,12899540,2023-02-04,125.25,999.1
2005,12899540,2023-02-06,159.04,1158.14
2433,12899540,2023-02-06,-78.47,1079.67
8439,12899540,2023-02-10,-85.03,994.6400000000001
101,12964138,2023-01-31,,557.04
620,12964138,2023-02-01,101.62,658.66
7814,12964138,2023-02-01,-55.49,603.17
7157,12964138,2023-02-06,104.0,707.17
4865,12964138,2023-02-13,-357.3,349.86999999999995
102,12985543,2023-01-31,,402.94
6834,12985543,2023-02-01,-140.27,262.66999999999996
902,12985543,2023-02-07,-99.51,163.15999999999997
5431,12985543,2023-02-09,118.41,281.57
8082,12985543,2023-02-11,57.3,338.87
4268,12985543,2023-02-13,-62.13,276.73999999999995
103,13058003,2023-01-31,,218.0
1568,13058003,2023-02-02,-35.9,182.1
8468,13058003,2023-02-09,-1246.4,-1064.3000000000002
5987,13058003,2023-02-11,-96.36,-1160.66
2331,13058003,2023-02-13,565.6,-595.0600000000002
104,13076932,2023-01-31,,419.47
7490,13076932,2023-02-02,-125.46,294.01000000000005
4278,13076932,2023-02-08,-94.91,199.10000000000002
4887,13076932,2023-02-11,146.03,345.13000000000005
7935,13076932,2023-02-13,136.72,481.85
105,13117442,2023-01-31,,799.69
4181,13117442,2023-02-02,-46.31,753.3800000000001
4355,13117442,2023-02-05,101.84,855.22
6819,13117442,2023-02-05,59.8,915.0200000000001
988,13117442,2023-02-05,-164.35,750.6700000000001
1264,13117442,2023-02-08,-109.72,640.95
4727,13117442,2023-02-11,1828.9,2469.8500000000004
1622,13117442,2023-02-12,-132.28,2337.57
106,13167285,2023-01-31,,301.93
4214,13167285,2023-02-01,-3.89,298.04
4133,13167285,2023-02-01,-199.99,98.05000000000001
4781,13167285,2023-02-03,139.6,237.65
5746,13167285,2023-02-03,-529.6,-291.95000000000005
4831,13167285,2023-02-05,-21.67,-313.62000000000006
6993,13167285,2023-02-06,204.86,-108.76000000000005
3416,13167285,2023-02-07,-78.2,-186.96000000000004
1138,13167285,2023-02-09,-20.1,-207.06000000000006
6569,13167285,2023-02-13,-99.54,-306.6
2263,13167285,2023-02-13,-136.9,-443.50000000000006
1566,13167285,2023-02-14,38.92,-404.58000000000004
107,13176075,2023-01-31,,67.3
2961,13176075,2023-02-04,127.96,195.26
5078,13176075,2023-02-08,-167.77,27.48999999999998
2462,13176075,2023-02-12,-149.27,-121.78000000000003
108,13182613,2023-01-31,,384.42
4144,13182613,2023-02-05,220.0,604.4200000000001
1137,13182613,2023-02-06,63.49,667.91
399,13182613,2023-02-08,-113.46,554.45
2059,13182613,2023-02-09,55.88,610.33
2350,13182613,2023-02-09,-79.45,530.88
109,13197335,2023-01-31,,625.71
439,13197335,2023-02-01,98.45,724.1600000000001
5903,13197335,2023-02-01,85.83,809.99
2096,13197335,2023-02-02,100.61,910.6
7150,13197335,2023-02-02,-93.5,817.1
3799,13197335,2023-02-08,79.86,896.96
5997,13197335,2023-02-09,1043.8,1940.76
2242,13197335,2023-02-10,1812.5,3753.26
8482,13197335,2023-02-11,-215.83,3537.43
110,13267945,2023-01-31,,299.77
7752,13267945,2023-02-03,102.35,402.12
1677,13267945,2023-02-04,1080.2,1482.3200000000002
2518,13267945,2023-02-07,81.75,1564.07
6339,13267945,2023-02-08,154.6,1718.6699999999998
363,13267945,2023-02-10,71.11,1789.78
111,13274987,2023-01-31,,902.06
3291,13274987,2023-02-01,-33.51,868.55
6589,13274987,2023-02-03,-53.43,815.1199999999999
6304,13274987,2023-02-03,-111.04,704.0799999999999
4802,13274987,2023-02-04,-93.78,610.3
7873,13274987,2023-02-05,101.16,711.4599999999999
1195,13274987,2023-02-08,1290.2,2001.6599999999999
5359,13274987,2023-02-12,118.61,2120.27
8261,13274987,2023-02-12,-117.48,2002.79
112,13277127,2023-01-31,,793.22
4569,13277127,2023-02-03,17.26,810.48
2557,13277127,2023-02-05,-17.93,792.5500000000001
3419,13277127,2023-02-06,-1037.3,-244.7499999999999
689,13277127,2023-02-08,714.2,469.45000000000016
4019,13277127,2023-02-08,251.9,721.3500000000001
113,13322659,2023-01-31,,690.27
4821,13322659,2023-02-01,-153.9,536.37
8206,13322659,2023-02-02,-145.27,391.09999999999997
5716,13322659,2023-02-04,123.49,514.5899999999999
8628,13322659,2023-02-05,36.77,551.36
343,13322659,2023-02-05,-53.92,497.43999999999994
8590,13322659,2023-02-09,-85.8,411.64
2390,13322659,2023-02-09,-106.38,305.26
3816,13322659,2023-02-14,-113.46,191.79999999999995
114,13388069,2023-01-31,,13.45
2506,13388069,2023-02-07,134.99,148.44
277,13388069,2023-02-08,27.53,175.97
5955,13388069,2023-02-12,-69.99,105.98
115,13426667,2023-01-31,,70.47
1368,13426667,2023-02-05,-121.7,-51.230000000000004
6744,13426667,2023-02-08,32.44,-18.790000000000006
4282,13426667,2023-02-12,1224.6,1205.81
4128,13426667,2023-02-13,-902.0,303.80999999999995
116,13459523,2023-01-31,,814.31
2292,13459523,2023-02-03,135.59,949.9
3744,13459523,2023-02-03,-952.0,-2.1000000000000227
7597,13459523,2023-02-06,-171.67,-173.77
5957,13459523,2023-02-07,57.31,-116.46000000000001
8312,13459523,2023-02-08,898.2,781.74
437,13459523,2023-02-10,166.54,948.28
5277,13459523,2023-02-10,-132.35,815.9300000000001
6675,13459523,2023-02-13,162.92,978.85
117,13474543,2023-01-31,,438.36
5956,13474543,2023-02-01,120.92,559.28
5896,13474543,2023-02-05,-107.87,451.41
528,13474543,2023-02-06,87.33,538.74
1294,13474543,2023-02-09,264.6,803.34
3372,13474543,2023-02-14,159.08,962.4200000000001
4481,13474543,2023-02-14,76.83,1039.25
118,13537427,2023-01-31,,556.98
1749,13537427,2023-02-01,52.56,609.54
5343,13537427,2023-02-07,164.7,774.24
3999,13537427,2023-02-11,246.42,1020.66
1117,13537427,2023-02-12,-172.13,848.53
119,13551717,2023-01-31,,26.95
8128,13551717,2023-02-01,-1361.0,-1334.05
3614,13551717,2023-02-05,-627.1,-1961.15
6946,13551717,2023-02-11,-42.85,-2004.0
3281,13551717,2023-02-14,-115.32,-2119.32
120,13558846,2023-01-31,,598.45
4362,13558846,2023-02-01,50.33,648.7800000000001
2986,13558846,2023-02-01,-94.06,554.72
8258,13558846,2023-02-04,148.08,702.8000000000001
5920,13558846,2023-02-05,-148.46,554.34
3895,13558846,2023-02-09,-115.1,439.24000000000007
8386,13558846,2023-02-13,-112.18,327.06000000000006
121,13563384,2023-01-31,,952.65
3025,13563384,2023-02-02,39.75,992.4
7389,13563384,2023-02-11,54.28,1046.68
1882,13563384,2023-02-12,70.05,1116.73
6318,13563384,2023-02-14,-860.1,256.63
122,13584908,2023-01-31,,162.0
7444,13584908,2023-02-02,-75.16,86.84
4761,13584908,2023-02-05,-85.05,1.7900000000000063
5119,13584908,2023-02-10,135.21,137.0
3749,13584908,2023-02-10,-81.43,55.57000000000002
123,13610259,2023-01-31,,587.73
4803,13610259,2023-02-09,33.72,621.45
4102,13610259,2023-02-10,655.8,1277.25
7933,13610259,2023-02-11,91.03,1368.28
2213,13610259,2023-02-12,-100.74,1267.54
124,13687711,2023-01-31,,757.76
2966,13687711,2023-02-02,-75.11,682.65
4554,13687711,2023-02-04,-135.11,547.54
1857,13687711,2023-02-11,-73.61,473.92999999999995
3510,13687711,2023-02-13,734.3,1208.23
4481,13687711,2023-02-14,-76.83,1131.3999999999999
125,13713704,2023-01-31,,1.48
2657,13713704,2023-02-02,91.84,93.32000000000001
6333,13713704,2023-02-04,-184.38,-91.05999999999999
5681,13713704,2023-02-10,122.82,31.760000000000005
1167,13713704,2023-02-10,-97.03,-65.27
1511,13713704,2023-02-11,78.2,12.930000000000007
4849,13713704,2023-02-13,-14.09,-1.159999999999993
126,13788234,2023-01-31,,302.78
7252,13788234,2023-02-06,-100.59,202.18999999999997
3982,13788234,2023-02-07,-140.37,61.819999999999965
282,13788234,2023-02-07,-163.8,-101.98000000000005
3944,13788234,2023-02-08,-33.64,-135.62000000000006
2279,13788234,2023-02-10,147.03,11.409999999999968
8357,13788234,2023-02-14,112.47,123.87999999999997
5122,13788234,2023-02-14,90.07,213.94999999999996
127,13945841,2023-01-31,,339.81
8020,13945841,2023-02-01,473.7,813.51
2663,13945841,2023-02-14,43.02,856.53
128,13965360,2023-01-31,,299.46
879,13965360,2023-02-11,-1655.3,-1355.84
129,13997603,2023-01-31,,516.79
793,13997603,2023-02-03,34.72,551.51
8149,13997603,2023-02-07,788.3,1339.81
5803,13997603,2023-02-07,52.55,1392.36
4561,13997603,2023-02-10,-69.88,1322.48
4422,13997603,2023-02-10,-155.28,1167.1999999999998
130,14000447,2023-01-31,,443.94
3794,14000447,2023-02-01,97.79,541.73
3829,14000447,2023-02-06,-154.42,387.31
2926,14000447,2023-02-09,-74.98,312.33
6104,14000447,2023-02-10,26.87,339.2
908,14000447,2023-02-13,147.67,486.87
7517,14000447,2023-02-13,-55.26,431.60999999999996
131,14014401,2023-01-31,,554.46
8262,14014401,2023-02-06,185.73,740.19
5895,14014401,2023-02-08,40.08,780.27
7587,14014401,2023-02-09,-1549.1,-768.8299999999999
5446,14014401,2023-02-10,73.16,-695.67
132,14039438,2023-01-31,,94.52
3075,14039438,2023-02-02,248.7,343.21999999999997
5213,14039438,2023-02-03,117.17,460.39
1214,14039438,2023-02-05,35.3,495.68999999999994
1537,14039438,2023-02-06,-155.88,339.80999999999995
4866,14039438,2023-02-09,141.4,481.21
133,14045416,2023-01-31,,265.63
4639,14045416,2023-02-01,-53.46,212.17
3814,14045416,2023-02-02,152.95,365.12
1501,14045416,2023-02-03,67.35,432.46999999999997
271,14045416,2023-02-03,-89.03,343.43999999999994
2019,14045416,2023-02-08,-42.88,300.55999999999995
134,14052052,2023-01-31,,915.74
2039,14052052,2023-02-05,-89.52,826.22
1944,14052052,2023-02-08,-192.5,633.72
1272,14052052,2023-02-09,-512.3,121.42000000000007
2963,14052052,2023-02-09,-666.4,-544.9799999999999
7686,14052052,2023-02-12,117.55,-427.4299999999999
6941,14052052,2023-02-14,-137.73,-565.1599999999999
135,14086187,2023-01-31,,340.59
2301,14086187,2023-02-02,551.2,891.79
6510,14086187,2023-02-03,166.13,1057.92
2487,14086187,2023-02-04,146.29,1204.21
4698,14086187,2023-02-05,-98.2,1106.01
6377,14086187,2023-02-06,135.77,1241.78
387,14086187,2023-02-08,58.95,1300.73
2052,14086187,2023-02-08,-42.56,1258.17
136,14103210,2023-01-31,,369.01
2610,14103210,2023-02-04,-111.88,257.13
2114,14103210,2023-02-06,-1.14,255.99
1551,14103210,2023-02-06,-1144.5,-888.51
1905,14103210,2023-02-08,116.37,-772.14
107,14103210,2023-02-09,-6.19,-778.33
4807,14103210,2023-02-11,130.19,-648.14
341,14103210,2023-02-11,-151.17,-799.31
4955,14103210,2023-02-13,1406.7,607.3900000000001
137,14136082,2023-01-31,,219.84
1816,14136082,2023-02-01,82.18,302.02
4405,14136082,2023-02-02,526.8,828.8199999999999
1925,14136082,2023-02-03,89.93,918.75
6364,14136082,2023-02-07,49.76,968.51
4072,14136082,2023-02-09,125.63,1094.1399999999999
4482,14136082,2023-02-11,-39.58,1054.56
6748,14136082,2023-02-11,-169.33,885.2299999999999
5189,14136082,2023-02-12,351.6,1236.83
6531,14136082,2023-02-14,140.8,1377.6299999999999
138,14144267,2023-01-31,,97.69
7066,14144267,2023-02-06,44.47,142.16
7141,14144267,2023-02-08,114.12,256.28
3513,14144267,2023-02-09,89.43,345.71000000000004
139,14183437,2023-01-31,,779.47
1634,14183437,2023-02-02,30.01,809.48
1320,14183437,2023-02-02,-95.08,714.4000000000001
5211,14183437,2023-02-03,99.07,813.47
749,14183437,2023-02-10,1975.6,2789.0699999999997
2688,14183437,2023-02-11,43.17,2832.24
1102,14183437,2023-02-11,-90.85,2741.39
6192,14183437,2023-02-14,120.06,2861.45
140,14253152,2023-01-31,,43.85
1363,14253152,2023-02-03,81.28,125.13
628,14253152,2023-02-04,-111.13,14.0
5193,14253152,2023-02-06,176.53,190.53
4239,14253152,2023-02-08,215.14,405.66999999999996
2864,14253152,2023-02-09,-157.13,248.54
1269,14253152,2023-02-11,-130.43,118.10999999999999
7359,14253152,2023-02-14,100.16,218.26999999999998
5812,14253152,2023-02-14,-963.5,-745.23
141,14337606,2023-01-31,,561.8
6948,14337606,2023-02-04,-53.8,507.99999999999994
259,14337606,2023-02-04,-79.62,428.37999999999994
2799,14337606,2023-02-06,-1792.7,-1364.3200000000002
7061,14337606,2023-02-08,-160.99,-1525.3100000000002
4811,14337606,2023-02-09,-158.61,-1683.92
6481,14337606,2023-02-11,175.69,-1508.2300000000002
7878,14337606,2023-02-11,-170.72,-1678.9500000000003
5382,14337606,2023-02-12,-132.03,-1810.9800000000002
3830,14337606,2023-02-14,76.49,-1734.4900000000002
142,14355869,2023-01-31,,329.16
7280,14355869,2023-02-01,-1052.6,-723.4399999999998
7295,14355869,2023-02-03,123.39,-600.0499999999998
1826,14355869,2023-02-04,-515.6,-1115.6499999999999
8682,14355869,2023-02-12,-19.96,-1135.61
143,14397662,2023-01-31,,363.51
3994,14397662,2023-02-04,61.88,425.39
6095,14397662,2023-02-08,1800.8,2226.19
8364,14397662,2023-02-08,126.11,2352.2999999999997
7076,14397662,2023-02-08,54.11,2406.41
5702,14397662,2023-02-08,37.69,2444.1
8527,14397662,2023-02-11,-74.51,2369.5899999999997
144,14421453,2023-01-31,,813.76
6030,14421453,2023-02-01,150.38,964.14
1938,14421453,2023-02-04,44.06,1008.2
903,14421453,2023-02-04,-183.25,824.95
4410,14421453,2023-02-06,67.0,891.95
6753,14421453,2023-02-08,35.51,927.46
6374,14421453,2023-02-11,-102.02,825.44
145,14448009,2023-01-31,,958.46
2676,14448009,2023-02-01,-102.39,856.07
5976,14448009,2023-02-01,-107.97,748.1
6421,14448009,2023-02-02,144.05,892.1500000000001
5003,14448009,2023-02-02,122.38,1014.53
2702,14448009,2023-02-04,-1367.4,-352.8700000000001
262,14448009,2023-02-08,-1779.2,-2132.07
2645,14448009,2023-02-09,-139.36,-2271.4300000000003
6414,14448009,2023-02-09,-1300.7,-3572.13
3789,14448009,2023-02-14,78.98,-3493.15
7098,14448009,2023-02-14,-14.98,-3508.13
146,14505806,2023-01-31,,689.25
771,14505806,2023-02-01,974.4,1663.65
2999,14505806,2023-02-08,121.72,1785.37
5215,14505806,2023-02-09,-102.41,1682.96
1269,14505806,2023-02-11,130.43,1813.3899999999999
3947,14505806,2023-02-11,38.37,1851.76
3930,14505806,2023-02-13,-71.51,1780.25
872,14505806,2023-02-14,956.2,2736.45
147,14564252,2023-01-31,,263.39
200,14564252,2023-02-02,-133.0,130.39
2868,14564252,2023-02-14,-158.38,-27.99000000000001
148,14592080,2023-01-31,,245.22
3538,14592080,2023-02-02,149.36,394.58000000000004
8323,14592080,2023-02-02,-70.88,323.70000000000005
1862,14592080,2023-02-02,-113.73,209.97000000000003
3807,14592080,2023-02-04,-213.8,-3.829999999999984
2994,14592080,2023-02-05,99.57,95.74000000000001
2211,14592080,2023-02-06,-93.76,1.980000000000004
1348,14592080,2023-02-07,50.0,51.980000000000004
149,14594928,2023-01-31,,470.64
1607,14594928,2023-02-03,-145.32,325.32
505,14594928,2023-02-07,123.7,449.02
6969,14594928,2023-02-10,75.71,524.73
8442,14594928,2023-02-12,-140.65,384.08
150,14600288,2023-01-31,,622.77
1108,14600288,2023-02-02,43.55,666.3199999999999
7297,14600288,2023-02-02,-140.31,526.01
6384,14600288,2023-02-02,-147.71,378.29999999999995
87,14600288,2023-02-03,88.58,466.88
6090,14600288,2023-02-05,110.92,577.8
6067,14600288,2023-02-08,93.19,670.99
272,14600288,2023-02-13,-138.07,532.92
6026,14600288,2023-02-14,83.11,616.03
151,14648004,2023-01-31,,236.67
3777,14648004,2023-02-01,92.2,328.87
4657,14648004,2023-02-01,-77.41,251.45999999999998
6699,14648004,2023-02-04,100.53,351.99
8503,14648004,2023-02-04,72.87,424.86
1824,14648004,2023-02-05,-16.24,408.62
7092,14648004,2023-02-07,114.81,523.4300000000001
8514,14648004,2023-02-07,21.02,544.45
4958,14648004,2023-02-07,-111.26,433.19
4752,14648004,2023-02-08,-1330.7,-897.51
6077,14648004,2023-02-12,-1808.9,-2706.41
2717,14648004,2023-02-13,-113.24,-2819.65
152,14685853,2023-01-31,,45.2
2248,14685853,2023-02-01,-142.37,-97.17
5486,14685853,2023-02-04,109.08,11.909999999999997
3182,14685853,2023-02-06,79.32,91.22999999999999
6243,14685853,2023-02-07,26.93,118.16
3101,14685853,2023-02-11,370.4,488.55999999999995
153,14723713,2023-01-31,,378.07
3137,14723713,2023-02-10,67.56,445.63
5562,14723713,2023-02-10,-113.36,332.27
8387,14723713,2023-02-11,126.78,459.05
8333,14723713,2023-02-13,149.91,608.96
154,14749214,2023-01-31,,194.54
7121,14749214,2023-02-03,49.32,243.85999999999999
6197,14749214,2023-02-07,-145.52,98.33999999999997
7916,14749214,2023-02-12,207.81,306.15
155,14780986,2023-01-31,,180.2
1577,14780986,2023-02-01,105.85,286.04999999999995
2940,14780986,2023-02-04,164.38,450.42999999999995
7369,14780986,2023-02-06,-965.2,-514.7700000000001
4638,14780986,2023-02-07,132.81,-381.9600000000001
6277,14780986,2023-02-07,-168.78,-550.7400000000001
156,14812157,2023-01-31,,534.54
3271,14812157,2023-02-01,645.5,1180.04
4573,14812157,2023-02-04,-134.48,1045.56
1651,14812157,2023-02-06,-473.7,571.86
4679,14812157,2023-02-09,-117.1,454.76
3334,14812157,2023-02-14,-120.54,334.22
157,14840078,2023-01-31,,584.16
6054,14840078,2023-02-01,-118.24,465.91999999999996
4049,14840078,2023-02-05,62.37,528.29
5186,14840078,2023-02-06,-188.27,340.02
6854,14840078,2023-02-07,-87.19,252.82999999999996
181,14840078,2023-02-09,-102.32,150.50999999999996
1603,14840078,2023-02-10,210.07,360.5799999999999
2297,14840078,2023-02-10,-144.1,216.47999999999996
535,14840078,2023-02-13,-82.99,133.48999999999995
3782,14840078,2023-02-14,75.98,209.46999999999997
158,14866733,2023-01-31,,249.35
6682,14866733,2023-02-01,-77.78,171.57
2991,14866733,2023-02-02,16.74,188.31
6222,14866733,2023-02-03,68.61,256.91999999999996
4691,14866733,2023-02-07,83.68,340.6
389,14866733,2023-02-14,-38.4,302.2
650,14866733,2023-02-14,-93.66,208.54
159,14897645,2023-01-31,,89.0
4841,14897645,2023-02-01,113.69,202.69
1540,14897645,2023-02-09,-69.51,133.18
6855,14897645,2023-02-11,-51.73,81.44999999999999
5379,14897645,2023-02-12,106.92,188.37
3225,14897645,2023-02-14,143.79,332.15999999999997
160,14907946,2023-01-31,,845.72
1959,14907946,2023-02-03,66.37,912.09
5233,14907946,2023-02-07,-84.76,827.33
6140,14907946,2023-02-07,-150.1,677.23
8291,14907946,2023-02-08,129.86,807.09
6068,14907946,2023-02-10,11.73,818.82
1151,14907946,2023-02-12,115.04,933.86
7145,14907946,2023-02-14,190.15,1124.01
6586,14907946,2023-02-14,98.03,1222.04
4629,14907946,2023-02-14,-67.7,1154.3400000000001
6629,14907946,2023-02-14,-161.34,993.0
161,15033812,2023-01-31,,504.58
162,15044055,2023-01-31,,204.3
4802,15044055,2023-02-04,93.78,298.08000000000004
1724,15044055,2023-02-06,-78.94,219.14000000000001
7850,15044055,2023-02-09,-1434.1,-1214.9599999999998
4637,15044055,2023-02-10,-181.71,-1396.6699999999998
441,15044055,2023-02-14,161.91,-1234.7599999999998
1875,15044055,2023-02-14,52.78,-1181.9799999999998
163,15052808,2023-01-31,,786.05
5645,15052808,2023-02-02,936.1,1722.15
2755,15052808,2023-02-09,953.9,2676.05
2893,15052808,2023-02-09,127.23,2803.2799999999997
2770,15052808,2023-02-14,-71.18,2732.1
7070,15052808,2023-02-14,-1288.0,1444.1
164,15055504,2023-01-31,,339.94
5965,15055504,2023-02-05,-170.82,169.12
6204,15055504,2023-02-07,-106.77,62.35000000000001
2555,15055504,2023-02-08,22.97,85.32000000000001
5435,15055504,2023-02-11,-107.49,-22.169999999999987
3559,15055504,2023-02-11,-126.14,-148.31
165,15077298,2023-01-31,,507.62
4783,15077298,2023-02-01,-77.55,430.07
5748,15077298,2023-02-01,-81.02,349.05
6109,15077298,2023-02-04,75.48,424.53000000000003
5503,15077298,2023-02-04,-150.76,273.77000000000004
6139,15077298,2023-02-07,-46.51,227.26000000000005
586,15077298,2023-02-09,88.16,315.4200000000001
6206,15077298,2023-02-09,-56.29,259.13000000000005
8194,15077298,2023-02-11,124.08,383.21000000000004
166,15100785,2023-01-31,,934.1
6694,15100785,2023-02-02,25.61,959.71
2777,15100785,2023-02-05,54.49,1014.2
327,15100785,2023-02-06,-114.3,899.9000000000001
1027,15100785,2023-02-06,-149.07,750.83
4034,15100785,2023-02-07,166.29,917.12
6829,15100785,2023-02-09,1038.5,1955.62
2910,15100785,2023-02-11,-178.01,1777.61
8604,15100785,2023-02-12,128.81,1906.4199999999998
167,15163829,2023-01-31,,458.6
5476,15163829,2023-02-04,120.19,578.79
8677,15163829,2023-02-07,-97.64,481.15000000000003
4077,15163829,2023-02-08,-141.03,340.12
1753,15163829,2023-02-12,-98.23,241.89
921,15163829,2023-02-13,43.56,285.45
168,15258886,2023-01-31,,689.34
5413,15258886,2023-02-01,-124.86,564.48
7190,15258886,2023-02-05,-155.76,408.72
7993,15258886,2023-02-08,-103.03,305.69000000000005
5026,15258886,2023-02-08,-134.18,171.51000000000002
7607,15258886,2023-02-10,47.01,218.52
6907,15258886,2023-02-11,1733.6,1952.12
7827,15258886,2023-02-12,-135.05,1817.07
4526,15258886,2023-02-13,-87.58,1729.4899999999998
169,15265650,2023-01-31,,147.72
5135,15265650,2023-02-01,146.1,293.82
2268,15265650,2023-02-03,-81.73,212.08999999999997
5107,15265650,2023-02-04,-63.54,148.54999999999998
2200,15265650,2023-02-05,-98.03,50.51999999999998
3636,15265650,2023-02-08,-10.58,39.93999999999998
8389,15265650,2023-02-11,-100.86,-60.920000000000016
6784,15265650,2023-02-11,-105.66,-166.58
8134,15265650,2023-02-12,64.01,-102.57000000000001
2054,15265650,2023-02-13,-25.57,-128.14000000000001
6580,15265650,2023-02-14,-118.21,-246.35
170,15265700,2023-01-31,,829.86
4550,15265700,2023-02-01,19.88,849.74
1544,15265700,2023-02-02,77.04,926.78
8655,15265700,2023-02-02,-83.44,843.34
8312,15265700,2023-02-08,-898.2,-54.860000000000014
2035,15265700,2023-02-12,91.07,36.20999999999998
171,15290238,2023-01-31,,93.23
1121,15290238,2023-02-01,83.96,177.19
7509,15290238,2023-02-04,-59.13,118.06
4069,15290238,2023-02-09,-119.77,-1.710000000000008
506,15290238,2023-02-13,-103.44,-105.15
172,15296624,2023-01-31,,731.68
2774,15296624,2023-02-01,-58.05,673.63
67,15296624,2023-02-01,-80.86,592.77
7691,15296624,2023-02-06,152.83,745.5999999999999
8059,15296624,2023-02-09,104.33,849.93
1191,15296624,2023-02-09,-141.82,708.1099999999999
2764,15296624,2023-02-14,120.42,828.53
173,15324178,2023-01-31,,833.62
1181,15324178,2023-02-05,91.78,925.4
1530,15324178,2023-02-07,-82.91,842.49
1134,15324178,2023-02-08,157.76,1000.25
3018,15324178,2023-02-09,-898.1,102.14999999999998
5357,15324178,2023-02-13,-96.04,6.109999999999971
2737,15324178,2023-02-13,-134.6,-128.49
174,15334737,2023-01-31,,197.12
906,15334737,2023-02-01,115.14,312.26
8673,15334737,2023-02-01,102.21,414.47
207,15334737,2023-02-04,91.69,506.15999999999997
8322,15334737,2023-02-04,-91.7,414.46
5193,15334737,2023-02-06,-176.53,237.93
7425,15334737,2023-02-07,63.12,301.05
4063,15334737,2023-02-12,86.27,387.32
175,15377274,2023-01-31,,902.14
3482,15377274,2023-02-04,-124.14,778.0
6140,15377274,2023-02-07,150.1,928.0999999999999
2879,15377274,2023-02-07,-56.42,871.68
3231,15377274,2023-02-12,102.73,974.41
7505,15377274,2023-02-14,135.14,1109.55
176,15428008,2023-01-31,,131.02
5835,15428008,2023-02-07,-199.86,-68.84
1995,15428008,2023-02-09,-548.3,-617.14
3282,15428008,2023-02-12,-1077.3,-1694.44
8375,15428008,2023-02-13,-47.89,-1742.33
441,15428008,2023-02-14,-161.91,-1904.2399999999998
177,15468532,2023-01-31,,819.87
5751,15468532,2023-02-03,-40.13,779.74
7441,15468532,2023-02-03,-141.04,638.7
639,15468532,2023-02-09,132.75,771.45
178,15522788,2023-01-31,,154.26
620,15522788,2023-02-01,-101.62,52.639999999999986
7823,15522788,2023-02-02,117.73,170.37
1493,15522788,2023-02-04,109.65,280.02
1226,15522788,2023-02-04,81.01,361.03
5468,15522788,2023-02-05,-23.13,337.9
1212,15522788,2023-02-06,-99.27,238.63
6525,15522788,2023-02-08,66.05,304.68
179,15529292,2023-01-31,,382.95
8268,15529292,2023-02-01,-117.6,265.35
767,15529292,2023-02-06,76.0,341.35
5874,15529292,2023-02-12,154.74,496.09000000000003
180,15563919,2023-01-31,,492.34
603,15563919,2023-02-01,-90.71,401.63
5069,15563919,2023-02-02,46.46,448.09
44,15563919,2023-02-04,174.55,622.64
8358,15563919,2023-02-05,65.68,688.3199999999999
63,15563919,2023-02-06,178.82,867.14
4199,15563919,2023-02-10,36.91,904.05
3136,15563919,2023-02-14,1083.0,1987.05
181,15665459,2023-01-31,,68.94
7325,15665459,2023-02-02,-74.71,-5.769999999999996
4600,15665459,2023-02-03,534.6,528.83
3256,15665459,2023-02-05,67.95,596.7800000000001
7464,15665459,2023-02-07,161.73,758.51
913,15665459,2023-02-13,-66.23,692.2800000000001
182,15668160,2023-01-31,,810.02
8050,15668160,2023-02-05,179.02,989.04
3452,15668160,2023-02-09,-156.67,832.37
2116,15668160,2023-02-13,201.95,1034.32
183,15732629,2023-01-31,,975.81
5908,15732629,2023-02-02,191.44,1167.25
3726,15732629,2023-02-04,-362.7,804.55
5113,15732629,2023-02-05,78.82,883.3699999999999
3857,15732629,2023-02-08,144.78,1028.1499999999999
333,15732629,2023-02-08,143.15,1171.3
3251,15732629,2023-02-12,76.86,1248.1599999999999
6238,15732629,2023-02-13,-1393.1,-144.94000000000005
184,15768459,2023-01-31,,997.4
1885,15768459,2023-02-02,-154.06,843.3399999999999
3131,15768459,2023-02-03,-44.0,799.3399999999999
5614,15768459,2023-02-08,120.35,919.6899999999999
8045,15768459,2023-02-08,118.54,1038.23
7206,15768459,2023-02-13,139.76,1177.99
2575,15768459,2023-02-13,-131.61,1046.3799999999999
185,15779976,2023-01-31,,129.01
6570,15779976,2023-02-03,-120.76,8.249999999999986
3795,15779976,2023-02-12,-127.27,-119.02000000000001
2121,15779976,2023-02-14,-100.83,-219.85000000000002
6473,15779976,2023-02-14,-128.39,-348.24
186,15793232,2023-01-31,,45.88
3736,15793232,2023-02-02,-120.7,-74.82
6310,15793232,2023-02-05,1580.8,1505.98
4678,15793232,2023-02-12,57.42,1563.4
6186,15793232,2023-02-14,20.41,1583.81
187,15796180,2023-01-31,,755.58
6539,15796180,2023-02-07,-105.97,649.61
6830,15796180,2023-02-07,-113.23,536.38
1807,15796180,2023-02-10,114.59,650.97
2686,15796180,2023-02-12,133.04,784.01
188,15801209,2023-01-31,,8.84
7120,15801209,2023-02-01,-695.3,-686.4599999999999
2666,15801209,2023-02-05,-45.42,-731.8799999999999
6552,15801209,2023-02-08,126.03,-605.8499999999999
6735,15801209,2023-02-13,134.72,-471.12999999999994
7874,15801209,2023-02-13,46.32,-424.80999999999995
4969,15801209,2023-02-13,-80.6,-505.40999999999997
189,15805500,2023-01-31,,230.39
417,15805500,2023-02-02,170.79,401.17999999999995
8335,15805500,2023-02-06,-175.36,225.81999999999996
383,15805500,2023-02-09,-71.12,154.69999999999996
190,15810455,2023-01-31,,81.69
6483,15810455,2023-02-06,110.66,192.35
2129,15810455,2023-02-08,238.9,431.25
8591,15810455,2023-02-08,100.19,531.44
7048,15810455,2023-02-11,165.48,696.92
1416,15810455,2023-02-11,112.23,809.15
4227,15810455,2023-02-12,-145.1,664.05
1372,15810455,2023-02-13,80.87,744.9200000000001
191,15826579,2023-01-31,,596.77
3929,15826579,2023-02-01,-948.2,-351.43000000000006
7063,15826579,2023-02-09,255.62,-95.81000000000006
4465,15826579,2023-02-10,-1662.6,-1758.4099999999999
22,15826579,2023-02-11,1137.9,-620.5099999999998
2856,15826579,2023-02-13,128.09,-492.41999999999973
192,15830962,2023-01-31,,570.89
594,15830962,2023-02-03,50.42,621.31
7872,15830962,2023-02-07,65.97,687.28
4386,15830962,2023-02-10,-97.09,590.1899999999999
193,15841031,2023-01-31,,579.98
8394,15841031,2023-02-05,-61.09,518.89
3345,15841031,2023-02-08,124.32,643.21
2208,15841031,2023-02-14,133.19,776.4
194,15899774,2023-01-31,,773.38
7629,15899774,2023-02-06,151.33,924.71
2380,15899774,2023-02-08,1382.5,2307.21
7820,15899774,2023-02-09,-64.55,2242.66
195,15914466,2023-01-31,,436.62
8533,15914466,2023-02-08,157.06,593.6800000000001
5543,15914466,2023-02-09,-109.67,484.01
3959,15914466,2023-02-09,-1208.0,-723.99
1750,15914466,2023-02-11,-125.01,-849.0
196,15918861,2023-01-31,,781.97
2209,15918861,2023-02-03,122.97,904.94
3088,15918861,2023-02-04,-22.38,882.5600000000001
2582,15918861,2023-02-09,-103.16,779.4000000000001
4893,15918861,2023-02-14,125.82,905.22
197,15922706,2023-01-31,,478.87
1672,15922706,2023-02-02,150.2,629.0699999999999
4173,15922706,2023-02-04,104.07,733.14
28,15922706,2023-02-04,-44.55,688.59
8189,15922706,2023-02-06,77.22,765.81
4308,15922706,2023-02-06,64.62,830.43
4948,15922706,2023-02-06,-124.41,706.02
5599,15922706,2023-02-08,80.77,786.79
5300,15922706,2023-02-09,88.92,875.71
7184,15922706,2023-02-11,1370.2,2245.91
8026,15922706,2023-02-14,29.41,2275.32
198,15944303,2023-01-31,,977.44
1279,15944303,2023-02-05,-108.31,869.1300000000001
581,15944303,2023-02-06,-100.18,768.95
6847,15944303,2023-02-09,181.01,949.96
7599,15944303,2023-02-12,1267.9,2217.86
4900,15944303,2023-02-13,107.16,2325.02
199,15960008,2023-01-31,,455.42
4638,15960008,2023-02-07,-132.81,322.61
7970,15960008,2023-02-10,-43.52,279.09000000000003
3580,15960008,2023-02-13,-47.03,232.06
200,15980710,2023-01-31,,955.7
4519,15980710,2023-02-03,158.58,1114.28
4461,15980710,2023-02-04,97.86,1212.14
1948,15980710,2023-02-11,-58.0,1154.14
2135,15980710,2023-02-13,134.36,1288.5
2931,15980710,2023-02-14,79.89,1368.39
201,16013218,2023-01-31,,322.63
1204,16013218,2023-02-02,83.89,406.52
1075,16013218,2023-02-06,1436.4,1842.92
3581,16013218,2023-02-06,-111.41,1731.51
5340,16013218,2023-02-10,26.43,1757.94
3769,16013218,2023-02-10,-77.1,1680.8400000000001
2360,16013218,2023-02-12,115.11,1795.95
5440,16013218,2023-02-12,-228.38,1567.5700000000002
202,16026987,2023-01-31,,772.57
6505,16026987,2023-02-02,-96.85,675.72
3606,16026987,2023-02-03,56.34,732.0600000000001
1664,16026987,2023-02-07,101.07,833.1300000000001
4205,16026987,2023-02-08,95.14,928.2700000000001
5659,16026987,2023-02-13,1678.8,2607.07
203,16030234,2023-01-31,,174.55
2443,16030234,2023-02-01,-92.81,81.74000000000001
1412,16030234,2023-02-01,-189.32,-107.57999999999998
5836,16030234,2023-02-06,-170.43,-278.01
7153,16030234,2023-02-08,129.99,-148.01999999999998
115,16030234,2023-02-09,-97.62,-245.64
141,16030234,2023-02-10,-86.54,-332.18
527,16030234,2023-02-12,-80.58,-412.76
204,16063411,2023-01-31,,896.73
7237,16063411,2023-02-13,-77.8,818.9300000000001
6268,16063411,2023-02-14,128.86,947.79
2413,16063411,2023-02-14,17.11,964.9
205,16067516,2023-01-31,,494.33
5642,16067516,2023-02-06,-646.5,-152.17000000000002
6515,16067516,2023-02-08,-1044.7,-1196.8700000000001
1228,16067516,2023-02-12,168.73,-1028.14
206,16087504,2023-01-31,,56.65
1377,16087504,2023-02-01,144.25,200.9
8042,16087504,2023-02-03,147.01,347.90999999999997
3317,16087504,2023-02-12,-895.2,-547.2900000000001
8552,16087504,2023-02-13,18.85,-528.44
2616,16087504,2023-02-14,-93.61,-622.0500000000001
207,16093178,2023-01-31,,96.62
3060,16093178,2023-02-02,-136.28,-39.66
4220,16093178,2023-02-03,114.47,74.81
2104,16093178,2023-02-05,57.87,132.68
2004,16093178,2023-02-11,87.08,219.76
5856,16093178,2023-02-11,-159.21,60.54999999999998
664,16093178,2023-02-13,-118.36,-57.81000000000002
208,16118153,2023-01-31,,829.58
981,16118153,2023-02-03,173.01,1002.59
5513,16118153,2023-02-05,-45.9,956.69
3492,16118153,2023-02-05,-49.78,906.9100000000001
3653,16118153,2023-02-09,125.98,1032.89
7227,16118153,2023-02-09,113.36,1146.25
3250,16118153,2023-02-10,-59.44,1086.81
680,16118153,2023-02-13,1827.6,2914.41
209,16124993,2023-01-31,,148.14
745,16124993,2023-02-05,25.75,173.89
3822,16124993,2023-02-06,46.33,220.21999999999997
789,16124993,2023-02-06,-97.34,122.87999999999998
5663,16124993,2023-02-08,1668.5,1791.3799999999999
7343,16124993,2023-02-08,-167.59,1623.79
4692,16124993,2023-02-11,245.04,1868.83
2598,16124993,2023-02-11,124.32,1993.1499999999999
6930,16124993,2023-02-12,-643.6,1349.5499999999997
5905,16124993,2023-02-14,-104.78,1244.7699999999998
26,16124993,2023-02-14,-143.07,1101.6999999999998
210,16152779,2023-01-31,,65.09
3347,16152779,2023-02-01,131.11,196.20000000000002
8422,16152779,2023-02-01,96.26,292.46000000000004
3287,16152779,2023-02-02,-135.95,156.51000000000005
2245,16152779,2023-02-04,173.9,330.4100000000001
7387,16152779,2023-02-12,-117.51,212.90000000000003
211,16157014,2023-01-31,,858.73
2947,16157014,2023-02-01,99.09,957.82
6987,16157014,2023-02-03,-76.11,881.71
4225,16157014,2023-02-08,103.69,985.4
1948,16157014,2023-02-11,58.0,1043.4
5621,16157014,2023-02-13,-111.36,932.04
212,16181964,2023-01-31,,979.44
1633,16181964,2023-02-01,-49.69,929.75
8242,16181964,2023-02-03,-121.15,808.6
8107,16181964,2023-02-06,59.73,868.33
3102,16181964,2023-02-07,-80.36,787.97
7892,16181964,2023-02-13,-763.2,24.769999999999982
213,16191280,2023-01-31,,825.86
7524,16191280,2023-02-02,666.0,1491.8600000000001
2151,16191280,2023-02-03,21.47,1513.33
7852,16191280,2023-02-07,113.55,1626.88
812,16191280,2023-02-08,138.88,1765.76
1540,16191280,2023-02-09,69.51,1835.27
5819,16191280,2023-02-10,-121.81,1713.46
4996,16191280,2023-02-12,86.65,1800.11
7241,16191280,2023-02-13,-77.77,1722.34
6535,16191280,2023-02-14,173.04,1895.38
214,16223952,2023-01-31,,222.18
2633,16223952,2023-02-03,197.64,419.82
4415,16223952,2023-02-05,1174.8,1594.62
1403,16223952,2023-02-08,83.5,1678.12
6549,16223952,2023-02-09,168.19,1846.31
7506,16223952,2023-02-11,-94.59,1751.7199999999998
215,16229373,2023-01-31,,256.89
8422,16229373,2023-02-01,-96.26,160.63
8207,16229373,2023-02-03,-1131.6,-970.9699999999999
2431,16229373,2023-02-05,161.01,-809.9599999999999
5025,16229373,2023-02-09,127.53,-682.43
3113,16229373,2023-02-13,83.84,-598.5899999999999
3077,16229373,2023-02-13,-153.16,-751.7499999999999
216,16270746,2023-01-31,,904.31
5125,16270746,2023-02-01,49.84,954.15
6347,16270746,2023-02-07,227.16,1181.31
7797,16270746,2023-02-14,110.13,1291.44
217,16306280,2023-01-31,,921.83
6058,16306280,2023-02-04,139.51,1061.3400000000001
6137,16306280,2023-02-06,136.49,1197.83
2267,16306280,2023-02-08,70.15,1267.98
4673,16306280,2023-02-13,79.84,1347.8200000000002
7037,16306280,2023-02-14,143.03,1490.8500000000001
218,16312979,2023-01-31,,833.92
5117,16312979,2023-02-02,-57.84,776.0799999999999
7551,16312979,2023-02-05,47.51,823.5899999999999
6636,16312979,2023-02-06,155.04,978.6299999999999
6231,16312979,2023-02-07,-100.4,878.2299999999999
717,16312979,2023-02-08,2113.3,2991.53
219,16334793,2023-01-31,,297.75
6446,16334793,2023-02-02,-126.12,171.63
957,16334793,2023-02-08,-77.8,93.83
5300,16334793,2023-02-09,-88.92,4.909999999999997
3135,16334793,2023-02-11,-1991.3,-1986.3899999999999
7539,16334793,2023-02-12,-81.87,-2068.2599999999998
220,16453812,2023-01-31,,356.9
5939,16453812,2023-02-04,63.26,420.15999999999997
8388,16453812,2023-02-09,146.33,566.49
1081,16453812,2023-02-13,-159.89,406.6
11,16453812,2023-02-14,-47.25,359.35
221,16506904,2023-01-31,,602.17
7710,16506904,2023-02-01,-106.68,495.48999999999995
7860,16506904,2023-02-03,125.04,620.53
7108,16506904,2023-02-06,-22.66,597.87
2429,16506904,2023-02-07,-134.11,463.75999999999993
1457,16506904,2023-02-09,-164.72,299.03999999999996
916,16506904,2023-02-12,77.47,376.50999999999993
7487,16506904,2023-02-13,-53.69,322.81999999999994
3019,16506904,2023-02-14,-278.4,44.41999999999996
222,16584745,2023-01-31,,129.46
1069,16584745,2023-02-01,-136.51,-7.049999999999983
1742,16584745,2023-02-04,109.21,102.16000000000001
1927,16584745,2023-02-05,-62.34,39.82000000000001
4103,16584745,2023-02-06,-76.04,-36.22
1043,16584745,2023-02-09,-912.8,-949.02
4131,16584745,2023-02-10,55.02,-894.0
5104,16584745,2023-02-11,-184.5,-1078.5
6997,16584745,2023-02-12,170.0,-908.5
444,16584745,2023-02-13,-111.37,-1019.87
223,16628269,2023-01-31,,27.11
896,16628269,2023-02-04,155.79,182.89999999999998
231,16628269,2023-02-04,-53.03,129.87
3838,16628269,2023-02-05,88.27,218.14
403,16628269,2023-02-05,55.52,273.66
8203,16628269,2023-02-11,-79.06,194.6
86,16628269,2023-02-12,151.34,345.94
8643,16628269,2023-02-13,41.75,387.69
224,16633794,2023-01-31,,263.05
8432,16633794,2023-02-02,75.84,338.89
1061,16633794,2023-02-08,113.42,452.31
1721,16633794,2023-02-09,89.39,541.7
3069,16633794,2023-02-10,86.39,628.09
2025,16633794,2023-02-13,61.69,689.78
225,16676577,2023-01-31,,407.24
4657,16676577,2023-02-01,77.41,484.65
1041,16676577,2023-02-04,-77.7,406.95
1075,16676577,2023-02-06,-1436.4,-1029.45
5615,16676577,2023-02-09,-105.57,-1135.02
281,16676577,2023-02-10,-103.59,-1238.6100000000001
226,16927652,2023-01-31,,637.58
2656,16927652,2023-02-01,-14.22,623.36
3474,16927652,2023-02-04,153.96,777.32
5715,16927652,2023-02-05,122.62,899.94
227,16977372,2023-01-31,,675.5
6822,16977372,2023-02-01,-181.11,494.39
1146,16977372,2023-02-08,195.9,690.29
6886,16977372,2023-02-10,-89.47,600.8199999999999
71,16977372,2023-02-14,302.9,903.72
228,16984772,2023-01-31,,823.43
3907,16984772,2023-02-02,1351.2,2174.63
466,16984772,2023-02-05,-76.23,2098.4
289,16984772,2023-02-05,-113.3,1985.1
7291,16984772,2023-02-05,-179.34,1805.7599999999998
6056,16984772,2023-02-07,151.91,1957.6699999999998
8657,16984772,2023-02-07,62.17,2019.84
8083,16984772,2023-02-07,-93.07,1926.77
7222,16984772,2023-02-08,-209.9,1716.87
6093,16984772,2023-02-10,-93.29,1623.58
229,17024652,2023-01-31,,918.84
5289,17024652,2023-02-02,101.39,1020.23
5611,17024652,2023-02-07,11.35,1031.58
6241,17024652,2023-02-09,1558.7,2590.2799999999997
3987,17024652,2023-02-13,30.37,2620.65
230,17039422,2023-01-31,,941.44
6513,17039422,2023-02-02,124.23,1065.67
1957,17039422,2023-02-03,-199.09,866.58
3594,17039422,2023-02-03,-208.56,658.02
3362,17039422,2023-02-06,-1053.5,-395.48
231,17051223,2023-01-31,,558.16
3386,17051223,2023-02-08,125.79,683.9499999999999
4353,17051223,2023-02-08,-61.41,622.54
232,17085651,2023-01-31,,945.51
8152,17085651,2023-02-05,119.48,1064.99
4581,17085651,2023-02-08,-81.34,983.65
3969,17085651,2023-02-11,-1168.2,-184.55000000000007
7682,17085651,2023-02-11,-1635.6,-1820.15
7158,17085651,2023-02-12,-159.82,-1979.97
675,17085651,2023-02-14,-1583.4,-3563.37
233,17138963,2023-01-31,,131.95
7804,17138963,2023-02-01,-1500.7,-1368.75
6221,17138963,2023-02-05,110.72,-1258.03
6152,17138963,2023-02-06,58.79,-1199.24
101,17138963,2023-02-08,-35.48,-1234.72
391,17138963,2023-02-14,63.85,-1170.87
234,17144855,2023-01-31,,355.14
2321,17144855,2023-02-01,182.36,537.5
7988,17144855,2023-02-01,112.98,650.48
312,17144855,2023-02-02,-51.28,599.2
3257,17144855,2023-02-02,-96.07,503.13
1090,17144855,2023-02-03,51.41,554.54
2259,17144855,2023-02-04,129.7,684.24
8318,17144855,2023-02-06,-104.58,579.66
5629,17144855,2023-02-09,-140.26,439.40000000000003
1510,17144855,2023-02-13,-59.04,380.36
3514,17144855,2023-02-13,-165.67,214.69000000000005
235,17191420,2023-01-31,,717.28
1543,17191420,2023-02-01,130.78,848.06
1771,17191420,2023-02-02,-98.15,749.91
6580,17191420,2023-02-14,118.21,868.12
236,17228160,2023-01-31,,567.87
4196,17228160,2023-02-01,-105.61,462.26
4372,17228160,2023-02-01,-780.9,-318.64
4012,17228160,2023-02-02,1556.9,1238.2600000000002
3625,17228160,2023-02-02,-54.57,1183.6900000000003
5795,17228160,2023-02-05,179.42,1363.1100000000001
4255,17228160,2023-02-05,123.79,1486.9000000000003
7555,17228160,2023-02-08,-35.2,1451.7000000000003
6213,17228160,2023-02-10,-190.65,1261.0500000000002
5253,17228160,2023-02-11,-200.58,1060.4700000000003
237,17264146,2023-01-31,,345.33
4090,17264146,2023-02-07,171.45,516.78
1486,17264146,2023-02-10,-38.88,477.9
7083,17264146,2023-02-11,-151.65,326.25
395,17264146,2023-02-12,-76.94,249.30999999999997
849,17264146,2023-02-14,58.68,307.98999999999995
5313,17264146,2023-02-14,-163.39,144.6
238,17284705,2023-01-31,,145.59
4932,17284705,2023-02-01,-81.56,64.03
3318,17284705,2023-02-03,-138.68,-74.65
4975,17284705,2023-02-04,-66.05,-140.7
613,17284705,2023-02-10,-47.4,-188.1
5671,17284705,2023-02-11,157.96,-30.139999999999986
7677,17284705,2023-02-11,62.52,32.38000000000002
3954,17284705,2023-02-13,12.26,44.640000000000015
239,17301178,2023-01-31,,311.47
1273,17301178,2023-02-02,-120.32,191.15000000000003
6740,17301178,2023-02-03,152.95,344.1
6204,17301178,2023-02-07,106.77,450.87
5428,17301178,2023-02-07,-1147.4,-696.5300000000001
5150,17301178,2023-02-08,55.71,-640.82
8162,17301178,2023-02-10,-24.85,-665.6700000000001
2791,17301178,2023-02-13,-127.43,-793.1000000000001
240,17434670,2023-01-31,,148.92
1777,17434670,2023-02-04,-99.5,49.41999999999999
3853,17434670,2023-02-05,44.51,93.92999999999998
6479,17434670,2023-02-07,169.25,263.17999999999995
1475,17434670,2023-02-07,80.47,343.65
5254,17434670,2023-02-07,-48.65,295.0
7152,17434670,2023-02-10,-705.9,-410.9
6953,17434670,2023-02-10,-737.2,-1148.1
8482,17434670,2023-02-11,215.83,-932.27
5880,17434670,2023-02-12,139.56,-792.71
929,17434670,2023-02-12,43.72,-748.99
668,17434670,2023-02-14,106.21,-642.78
241,17469776,2023-01-31,,443.18
185,17469776,2023-02-05,89.23,532.41
2329,17469776,2023-02-05,-94.95,437.46000000000004
4880,17469776,2023-02-07,60.73,498.19
6439,17469776,2023-02-08,-61.39,436.8
1057,17469776,2023-02-12,76.6,513.4
242,17483941,2023-01-31,,483.81
421,17483941,2023-02-01,48.78,532.59
6457,17483941,2023-02-01,-110.45,422.14
5374,17483941,2023-02-01,-164.06,258.08
7749,17483941,2023-02-02,102.4,360.48
665,17483941,2023-02-03,120.86,481.34
3290,17483941,2023-02-03,76.66,558.0
2431,17483941,2023-02-05,-161.01,396.99
1930,17483941,2023-02-08,145.66,542.65
8056,17483941,2023-02-11,9.21,551.86
243,17533114,2023-01-31,,274.53
4839,17533114,2023-02-05,-94.53,179.99999999999997
4943,17533114,2023-02-07,-35.98,144.01999999999998
6157,17533114,2023-02-08,105.32,249.33999999999997
1098,17533114,2023-02-13,-123.27,126.06999999999998
8259,17533114,2023-02-14,-133.43,-7.360000000000028
244,17534364,2023-01-31,,758.41
3926,17534364,2023-02-05,-120.48,637.93
2052,17534364,2023-02-08,42.56,680.49
2140,17534364,2023-02-10,-153.84,526.65
2561,17534364,2023-02-11,102.43,629.0799999999999
2058,17534364,2023-02-14,-59.8,569.28
245,17543122,2023-01-31,,681.64
3766,17543122,2023-02-04,-48.4,633.24
2461,17543122,2023-02-05,-37.98,595.26
6866,17543122,2023-02-05,-135.04,460.22
5859,17543122,2023-02-05,-193.92,266.3
7473,17543122,2023-02-06,-19.45,246.85000000000002
5037,17543122,2023-02-08,118.77,365.62
5214,17543122,2023-02-10,-149.61,216.01
5617,17543122,2023-02-13,183.79,399.79999999999995
246,17644586,2023-01-31,,222.45
4382,17644586,2023-02-01,92.85,315.29999999999995
7266,17644586,2023-02-01,-148.34,166.95999999999998
4881,17644586,2023-02-02,-122.21,44.749999999999986
7908,17644586,2023-02-03,146.39,191.14
5807,17644586,2023-02-04,109.76,300.9
1848,17644586,2023-02-09,50.02,350.92
3284,17644586,2023-02-11,125.33,476.25
1949,17644586,2023-02-13,110.34,586.59
247,17648252,2023-01-31,,75.02
5227,17648252,2023-02-01,646.2,721.22
2761,17648252,2023-02-01,-570.3,150.92000000000007
454,17648252,2023-02-05,124.83,275.75000000000006
6448,17648252,2023-02-05,-18.13,257.62000000000006
2753,17648252,2023-02-06,95.31,352.93000000000006
6892,17648252,2023-02-06,-84.46,268.4700000000001
1921,17648252,2023-02-13,132.3,400.7700000000001
1768,17648252,2023-02-14,553.6,954.3700000000001
248,17669623,2023-01-31,,163.19
6637,17669623,2023-02-05,142.97,306.15999999999997
5363,17669623,2023-02-07,171.17,477.33
7362,17669623,2023-02-09,-125.94,351.39
7010,17669623,2023-02-14,106.34,457.73
2262,17669623,2023-02-14,-64.22,393.51
249,17692892,2023-01-31,,457.79
6773,17692892,2023-02-03,22.26,480.05
3873,17692892,2023-02-03,-88.94,391.11
7271,17692892,2023-02-06,-45.55,345.56000000000006
5310,17692892,2023-02-09,174.92,520.48
250,17722231,2023-01-31,,944.22
1235,17722231,2023-02-01,-67.01,877.21
8289,17722231,2023-02-02,22.39,899.6
2744,17722231,2023-02-06,-462.2,437.40000000000003
2573,17722231,2023-02-09,105.04,542.44
251,17749893,2023-01-31,,889.45
8001,17749893,2023-02-01,176.41,1065.8600000000001
6265,17749893,2023-02-01,-143.83,922.03
1426,17749893,2023-02-07,-211.2,710.83
6716,17749893,2023-02-12,-28.42,682.4100000000001
7599,17749893,2023-02-12,-1267.9,-585.49
7030,17749893,2023-02-13,90.8,-494.69
6872,17749893,2023-02-13,-88.79,-583.48
252,17810734,2023-01-31,,348.22
8687,17810734,2023-02-09,-138.8,209.42000000000002
253,17840180,2023-01-31,,557.56
7601,17840180,2023-02-01,0.96,558.52
3482,17840180,2023-02-04,124.14,682.66
209,17840180,2023-02-14,-81.15,601.51
254,17868317,2023-01-31,,706.58
7508,17868317,2023-02-01,-172.78,533.8000000000001
4466,17868317,2023-02-07,-52.36,481.44000000000005
8366,17868317,2023-02-09,72.19,553.63
1179,17868317,2023-02-13,124.33,677.96
2374,17868317,2023-02-14,110.14,788.1
255,17881363,2023-01-31,,415.27
5735,17881363,2023-02-02,-46.77,368.5
8684,17881363,2023-02-03,-64.03,304.46999999999997
3088,17881363,2023-02-04,22.38,326.84999999999997
2826,17881363,2023-02-05,125.17,452.02
5039,17881363,2023-02-13,-817.7,-365.68000000000006
256,17925406,2023-01-31,,393.37
2164,17925406,2023-02-02,160.62,553.99
1090,17925406,2023-02-03,-51.41,502.58000000000004
6201,17925406,2023-02-06,109.52,612.1
5590,17925406,2023-02-06,-81.99,530.11
5116,17925406,2023-02-08,87.59,617.7
6029,17925406,2023-02-10,-74.72,542.98
8685,17925406,2023-02-13,112.38,655.36
2504,17925406,2023-02-14,116.9,772.26
257,17933377,2023-01-31,,189.05
2037,17933377,2023-02-02,95.27,284.32
6197,17933377,2023-02-07,145.52,429.84000000000003
7062,17933377,2023-02-07,24.33,454.17
4204,17933377,2023-02-08,-109.29,344.88
258,17938672,2023-01-31,,904.99
2606,17938672,2023-02-01,102.95,1007.94
4062,17938672,2023-02-02,-93.88,914.0600000000001
5268,17938672,2023-02-07,-46.29,867.77
2420,17938672,2023-02-08,39.85,907.62
7112,17938672,2023-02-11,129.67,1037.29
3384,17938672,2023-02-11,77.84,1115.13
259,17939571,2023-01-31,,396.93
7287,17939571,2023-02-02,68.63,465.56
915,17939571,2023-02-07,149.48,615.04
8532,17939571,2023-02-07,108.09,723.13
7790,17939571,2023-02-07,-53.14,669.99
1883,17939571,2023-02-09,-43.87,626.12
2034,17939571,2023-02-12,78.98,705.1
2336,17939571,2023-02-12,77.02,782.12
6626,17939571,2023-02-12,50.65,832.77
260,17983851,2023-01-31,,849.24
407,17983851,2023-02-01,160.4,1009.64
1653,17983851,2023-02-02,794.9,1804.54
6810,17983851,2023-02-02,200.43,2004.97
7620,17983851,2023-02-04,-26.48,1978.49
6732,17983851,2023-02-06,-154.69,1823.8
2412,17983851,2023-02-07,99.73,1923.53
1048,17983851,2023-02-09,-67.11,1856.42
3191,17983851,2023-02-12,89.62,1946.04
8560,17983851,2023-02-12,37.05,1983.09
6081,17983851,2023-02-12,-76.82,1906.27
261,18046225,2023-01-31,,205.83
2482,18046225,2023-02-03,-96.51,109.32000000000001
7186,18046225,2023-02-07,151.4,260.72
1113,18046225,2023-02-10,63.32,324.04
262,18052851,2023-01-31,,672.09
6307,18052851,2023-02-02,-177.51,494.58000000000004
7819,18052851,2023-02-08,-115.63,378.95000000000005
8625,18052851,2023-02-13,48.19,427.14000000000004
6017,18052851,2023-02-14,159.03,586.1700000000001
263,18095448,2023-01-31,,73.28
8225,18095448,2023-02-03,159.69,232.97
816,18095448,2023-02-03,-164.36,68.60999999999999
25,18095448,2023-02-05,92.4,161.01
4767,18095448,2023-02-12,797.7,958.71
4478,18095448,2023-02-12,16.68,975.39
264,18133554,2023-01-31,,733.1
233,18133554,2023-02-02,-114.29,618.8100000000001
2185,18133554,2023-02-03,-168.82,449.99
5649,18133554,2023-02-06,676.7,1126.69
677,18133554,2023-02-06,100.05,1226.74
5479,18133554,2023-02-07,1277.4,2504.1400000000003
2742,18133554,2023-02-07,207.86,2712.0
4938,18133554,2023-02-07,109.2,2821.2000000000003
1892,18133554,2023-02-09,176.85,2998.05
4857,18133554,2023-02-09,118.62,3116.67
7528,18133554,2023-02-10,-75.3,3041.3700000000003
5602,18133554,2023-02-11,1104.0,4145.37
8531,18133554,2023-02-11,107.81,4253.18
2179,18133554,2023-02-14,-18.54,4234.64
265,18179400,2023-01-31,,768.78
1800,18179400,2023-02-03,18.62,787.4
2669,18179400,2023-02-06,-131.6,655.8
4317,18179400,2023-02-08,-197.96,457.84
2478,18179400,2023-02-11,560.2,1018.04
266,18185362,2023-01-31,,609.36
1536,18185362,2023-02-02,-117.9,491.46000000000004
6037,18185362,2023-02-04,124.08,615.54
1567,18185362,2023-02-11,-10.99,604.55
127,18185362,2023-02-12,-1955.6,-1351.05
1062,18185362,2023-02-14,91.78,-1259.27
267,18198770,2023-01-31,,108.23
5480,18198770,2023-02-02,76.14,184.37
7106,18198770,2023-02-04,146.89,331.26
4921,18198770,2023-02-14,-44.96,286.3
268,18305932,2023-01-31,,834.42
773,18305932,2023-02-08,-129.7,704.72
367,18305932,2023-02-11,-120.95,583.77
3639,18305932,2023-02-14,79.12,662.89
4177,18305932,2023-02-14,-18.23,644.66
269,18308848,2023-01-31,,570.65
3058,18308848,2023-02-07,147.36,718.01
2134,18308848,2023-02-14,-27.68,690.33
270,18346988,2023-01-31,,450.36
3518,18346988,2023-02-02,-131.15,319.21000000000004
3446,18346988,2023-02-03,-36.94,282.27
2846,18346988,2023-02-04,-436.5,-154.23000000000002
8303,18346988,2023-02-07,-856.5,-1010.73
956,18346988,2023-02-14,-73.19,-1083.92
271,18348734,2023-01-31,,579.93
7065,18348734,2023-02-01,-147.58,432.3499999999999
1687,18348734,2023-02-02,-950.2,-517.8500000000001
577,18348734,2023-02-06,-111.94,-629.7900000000002
7691,18348734,2023-02-06,-152.83,-782.6200000000001
323,18348734,2023-02-07,-211.77,-994.3900000000001
6887,18348734,2023-02-08,-56.83,-1051.2200000000003
7408,18348734,2023-02-08,-68.73,-1119.9500000000003
7904,18348734,2023-02-08,-1032.4,-2152.3500000000004
7411,18348734,2023-02-09,1045.1,-1107.2500000000005
5283,18348734,2023-02-09,-76.46,-1183.7100000000005
5020,18348734,2023-02-11,148.74,-1034.9700000000005
2556,18348734,2023-02-11,-1669.7,-2704.6700000000005
715,18348734,2023-02-13,-98.15,-2802.8200000000006
4006,18348734,2023-02-14,2010.0,-792.8200000000006
272,18447548,2023-01-31,,574.24
5945,18447548,2023-02-01,99.41,673.65
7913,18447548,2023-02-08,-180.39,493.26
3613,18447548,2023-02-10,133.0,626.26
1332,18447548,2023-02-10,-88.61,537.65
415,18447548,2023-02-12,44.09,581.74
225,18447548,2023-02-13,75.56,657.3000000000001
4884,18447548,2023-02-13,-104.27,553.03
3454,18447548,2023-02-13,-1370.8,-817.77
5483,18447548,2023-02-14,-101.91,-919.68
273,18451683,2023-01-31,,501.75
1700,18451683,2023-02-03,157.43,659.1800000000001
4453,18451683,2023-02-03,102.01,761.19
4093,18451683,2023-02-05,112.34,873.53
7399,18451683,2023-02-05,-103.38,770.15
5832,18451683,2023-02-06,-56.08,714.07
3405,18451683,2023-02-06,-159.49,554.58
2387,18451683,2023-02-10,143.3,697.88
7981,18451683,2023-02-11,-65.22,632.6600000000001
3670,18451683,2023-02-12,-985.9,-353.24
2652,18451683,2023-02-13,62.08,-291.16
274,18517970,2023-01-31,,709.95
5155,18517970,2023-02-02,142.95,852.9000000000001
6813,18517970,2023-02-03,-510.1,342.8
4105,18517970,2023-02-04,127.73,470.53000000000003
3016,18517970,2023-02-08,-31.2,439.33000000000004
1128,18517970,2023-02-09,54.57,493.90000000000003
5937,18517970,2023-02-10,95.98,589.88
3610,18517970,2023-02-12,-92.12,497.76
1062,18517970,2023-02-14,-91.78,405.98
275,18563743,2023-01-31,,649.46
2094,18563743,2023-02-04,34.82,684.2800000000001
4800,18563743,2023-02-07,-124.7,559.58
8409,18563743,2023-02-09,-36.49,523.09
4987,18563743,2023-02-11,137.26,660.35
5032,18563743,2023-02-12,-58.63,601.72
4146,18563743,2023-02-12,-102.95,498.77
276,18582171,2023-01-31,,732.99
6489,18582171,2023-02-03,-109.86,623.13
884,18582171,2023-02-05,122.01,745.14
5166,18582171,2023-02-06,105.34,850.48
7188,18582171,2023-02-09,136.48,986.96
240,18582171,2023-02-11,72.82,1059.78
3605,18582171,2023-02-11,-147.31,912.47
4909,18582171,2023-02-13,123.86,1036.33
1764,18582171,2023-02-14,45.9,1082.23
4812,18582171,2023-02-14,-85.38,996.85
277,18584434,2023-01-31,,877.81
1871,18584434,2023-02-02,-103.88,773.93
7526,18584434,2023-02-03,-94.83,679.0999999999999
3120,18584434,2023-02-05,78.62,757.7199999999999
5715,18584434,2023-02-05,-122.62,635.0999999999999
3627,18584434,2023-02-08,-96.34,538.76
278,18645136,2023-01-31,,554.87
6237,18645136,2023-02-01,120.09,674.96
1302,18645136,2023-02-03,111.0,785.96
2859,18645136,2023-02-04,199.43,985.39
2724,18645136,2023-02-05,-2.25,983.14
1593,18645136,2023-02-13,61.15,1044.29
6101,18645136,2023-02-14,-116.52,927.77
279,18685463,2023-01-31,,476.02
3699,18685463,2023-02-09,-37.65,438.37
1292,18685463,2023-02-10,73.39,511.76
1067,18685463,2023-02-14,118.69,630.45
7649,18685463,2023-02-14,80.0,710.45
280,18718399,2023-01-31,,716.22
50,18718399,2023-02-04,119.96,836.1800000000001
6981,18718399,2023-02-06,374.5,1210.68
7709,18718399,2023-02-10,1800.7,3011.38
281,18850031,2023-01-31,,191.3
140,18850031,2023-02-03,100.99,292.29
6516,18850031,2023-02-05,181.42,473.71
3926,18850031,2023-02-05,120.48,594.1899999999999
3622,18850031,2023-02-07,-171.4,422.78999999999996
3607,18850031,2023-02-11,172.5,595.29
2172,18850031,2023-02-11,-34.52,560.77
7089,18850031,2023-02-13,105.74,666.51
282,18859451,2023-01-31,,441.04
7242,18859451,2023-02-02,-469.3,-28.25999999999999
6294,18859451,2023-02-06,110.47,82.21000000000001
6276,18859451,2023-02-06,-102.2,-19.989999999999995
3879,18859451,2023-02-13,46.16,26.17
105,18859451,2023-02-14,92.17,118.34
283,18899132,2023-01-31,,244.46
452,18899132,2023-02-05,-69.58,174.88
789,18899132,2023-02-06,97.34,272.22
5815,18899132,2023-02-08,-63.18,209.04000000000002
284,18928638,2023-01-31,,150.95
8576,18928638,2023-02-02,-162.41,-11.460000000000008
2589,18928638,2023-02-02,-192.77,-204.23000000000002
2393,18928638,2023-02-10,-184.75,-388.98
285,19001745,2023-01-31,,507.55
6084,19001745,2023-02-03,76.42,583.97
3966,19001745,2023-02-04,55.54,639.51
1619,19001745,2023-02-10,344.3,983.81
8274,19001745,2023-02-10,99.66,1083.47
6110,19001745,2023-02-11,-173.15,910.3199999999999
5658,19001745,2023-02-13,-82.89,827.43
1563,19001745,2023-02-14,102.06,929.49
478,19001745,2023-02-14,-181.24,748.25
286,19094015,2023-01-31,,548.65
5002,19094015,2023-02-01,74.43,623.0799999999999
6103,19094015,2023-02-02,-224.1,398.98
1207,19094015,2023-02-06,-186.65,212.32999999999998
3669,19094015,2023-02-06,-1695.0,-1482.67
33,19094015,2023-02-12,1761.1,278.42999999999984
2691,19094015,2023-02-13,-767.3,-488.8700000000001
287,19154395,2023-01-31,,274.06
3181,19154395,2023-02-01,456.2,730.26
2303,19154395,2023-02-01,173.96,904.22
99,19154395,2023-02-05,185.3,1089.52
745,19154395,2023-02-05,-25.75,1063.77
3477,19154395,2023-02-06,-23.13,1040.64
288,19160862,2023-01-31,,211.53
6596,19160862,2023-02-02,-110.38,101.15
6258,19160862,2023-02-11,-137.25,-36.099999999999994
289,19201987,2023-01-31,,624.55
1637,19201987,2023-02-04,-54.37,570.18
7808,19201987,2023-02-04,-107.38,462.79999999999995
1356,19201987,2023-02-06,-140.78,322.02
5387,19201987,2023-02-09,80.63,402.65
8361,19201987,2023-02-11,-62.24,340.40999999999997
290,19216744,2023-01-31,,123.53
6435,19216744,2023-02-03,79.86,203.39
291,19220216,2023-01-31,,628.89
2778,19220216,2023-02-04,50.19,679.0799999999999
6729,19220216,2023-02-04,-148.35,530.73
1279,19220216,2023-02-05,108.31,639.04
1617,19220216,2023-02-05,-71.33,567.71
1898,19220216,2023-02-06,833.9,1401.6100000000001
4106,19220216,2023-02-06,-162.13,1239.48
8631,19220216,2023-02-11,-102.26,1137.22
3588,19220216,2023-02-12,51.02,1188.24
6605,19220216,2023-02-13,187.8,1376.04
7145,19220216,2023-02-14,-190.15,1185.89
292,19242274,2023-01-31,,65.28
1118,19242274,2023-02-01,116.71,181.99
1482,19242274,2023-02-01,-107.29,74.69999999999999
4471,19242274,2023-02-08,-94.16,-19.460000000000008
6985,19242274,2023-02-09,-32.83,-52.290000000000006
4663,19242274,2023-02-10,1324.9,1272.6100000000001
6917,19242274,2023-02-10,-98.85,1173.7600000000002
293,19283264,2023-01-31,,301.31
6527,19283264,2023-02-07,-85.44,215.87
5834,19283264,2023-02-07,-126.94,88.93
1839,19283264,2023-02-10,103.62,192.55
3702,19283264,2023-02-10,-96.34,96.21000000000001
7497,19283264,2023-02-12,39.42,135.63
294,19315124,2023-01-31,,447.16
3082,19315124,2023-02-11,64.7,511.86
1531,19315124,2023-02-11,-93.58,418.28000000000003
8093,19315124,2023-02-14,634.0,1052.28
3121,19315124,2023-02-14,-90.11,962.17
295,19317267,2023-01-31,,51.87
1880,19317267,2023-02-03,-113.25,-61.38
6904,19317267,2023-02-14,1191.7,1130.32
6598,19317267,2023-02-14,33.66,1163.98
1727,19317267,2023-02-14,-198.2,965.78
296,19334563,2023-01-31,,525.45
2981,19334563,2023-02-01,-774.6,-249.14999999999998
5378,19334563,2023-02-08,130.38,-118.76999999999998
3508,19334563,2023-02-12,41.59,-77.17999999999998
3408,19334563,2023-02-13,-107.17,-184.34999999999997
4475,19334563,2023-02-14,1773.6,1589.25
297,19387921,2023-01-31,,927.28
7679,19387921,2023-02-01,-86.97,840.31
8443,19387921,2023-02-02,124.34,964.65
53,19387921,2023-02-06,144.74,1109.3899999999999
2029,19387921,2023-02-11,-58.94,1050.45
3706,19387921,2023-02-14,162.9,1213.35
1722,19387921,2023-02-14,70.52,1283.87
4893,19387921,2023-02-14,-125.82,1158.05
298,19429964,2023-01-31,,694.43
6351,19429964,2023-02-04,220.77,915.1999999999999
2486,19429964,2023-02-05,200.2,1115.3999999999999
7499,19429964,2023-02-08,-58.6,1056.8
3223,19429964,2023-02-13,202.54,1259.34
2233,19429964,2023-02-14,97.35,1356.69
299,19432211,2023-01-31,,24.19
8613,19432211,2023-02-02,114.87,139.06
2719,19432211,2023-02-02,-124.78,14.280000000000001
43,19432211,2023-02-07,-107.2,-92.92
4791,19432211,2023-02-08,76.6,-16.320000000000007
300,19524427,2023-01-31,,579.16
4710,19524427,2023-02-03,-772.8,-193.64
7122,19524427,2023-02-06,151.44,-42.19999999999999
2654,19524427,2023-02-09,287.8,245.60000000000002
5137,19524427,2023-02-13,148.89,394.49
301,19530097,2023-01-31,,960.21
2294,19530097,2023-02-05,44.78,1004.99
1194,19530097,2023-02-06,105.81,1110.8
434,19530097,2023-02-10,79.86,1190.66
6731,19530097,2023-02-10,-100.23,1090.43
5414,19530097,2023-02-13,151.84,1242.27
302,19559937,2023-01-31,,727.4
7804,19559937,2023-02-01,1500.7,2228.1
4319,19559937,2023-02-01,-86.72,2141.38
1436,19559937,2023-02-05,-114.03,2027.3500000000001
3819,19559937,2023-02-09,-50.41,1976.94
2050,19559937,2023-02-10,64.28,2041.2200000000003
5258,19559937,2023-02-10,-88.53,1952.69
8246,19559937,2023-02-11,-157.4,1795.2900000000002
1806,19559937,2023-02-12,1025.1,2820.3900000000003
303,19574610,2023-01-31,,104.29
5911,19574610,2023-02-02,91.54,195.83
7151,19574610,2023-02-04,186.59,382.42
3860,19574610,2023-02-04,-133.61,248.81
5072,19574610,2023-02-05,815.7,1064.51
7020,19574610,2023-02-07,-186.15,878.36
5981,19574610,2023-02-10,-28.58,849.78
2447,19574610,2023-02-11,-182.68,667.0999999999999
5076,19574610,2023-02-13,68.69,735.79
7991,19574610,2023-02-13,-62.72,673.0699999999999
4384,19574610,2023-02-14,-77.33,595.74
304,19647966,2023-01-31,,849.89
3923,19647966,2023-02-05,176.88,1026.77
3750,19647966,2023-02-08,128.8,1155.57
3350,19647966,2023-02-10,106.72,1262.29
4579,19647966,2023-02-12,164.29,1426.58
3354,19647966,2023-02-14,83.33,1509.91
4826,19647966,2023-02-14,-94.55,1415.36
305,19686460,2023-01-31,,416.7
3815,19686460,2023-02-01,818.4,1235.1
5329,19686460,2023-02-07,115.39,1350.49
6262,19686460,2023-02-08,1379.8,2730.29
5023,19686460,2023-02-11,754.3,3484.59
5790,19686460,2023-02-14,-72.93,3411.66
306,19705767,2023-01-31,,997.48
6666,19705767,2023-02-04,-134.22,863.26
6767,19705767,2023-02-08,-136.38,726.88
2915,19705767,2023-02-10,101.58,828.46
2938,19705767,2023-02-11,132.19,960.6500000000001
5929,19705767,2023-02-13,46.08,1006.73
5967,19705767,2023-02-14,-7.09,999.64
307,19789505,2023-01-31,,893.9
8554,19789505,2023-02-01,1041.9,1935.8000000000002
28,19789505,2023-02-04,44.55,1980.3500000000001
7664,19789505,2023-02-08,118.76,2099.11
5212,19789505,2023-02-08,-14.65,2084.46
2523,19789505,2023-02-10,40.02,2124.48
6130,19789505,2023-02-11,117.67,2242.15
873,19789505,2023-02-13,-1665.4,576.75
308,19836996,2023-01-31,,245.14
233,19836996,2023-02-02,114.29,359.43
4208,19836996,2023-02-04,165.75,525.1800000000001
3412,19836996,2023-02-06,-104.32,420.86
7669,19836996,2023-02-07,-65.16,355.70000000000005
3079,19836996,2023-02-07,-1159.5,-803.8
309,19876635,2023-01-31,,883.25
8143,19876635,2023-02-01,-81.16,802.09
8369,19876635,2023-02-01,-101.28,700.81
931,19876635,2023-02-02,-236.79,464.02
3658,19876635,2023-02-03,128.62,592.64
2292,19876635,2023-02-03,-135.59,457.05
3801,19876635,2023-02-10,-128.06,328.99
5706,19876635,2023-02-11,147.81,476.8
3671,19876635,2023-02-14,-135.7,341.1
310,19920990,2023-01-31,,70.95
4973,19920990,2023-02-03,-145.14,-74.18999999999998
4650,19920990,2023-02-07,-1370.6,-1444.79
3672,19920990,2023-02-08,-90.7,-1535.49
285,19920990,2023-02-09,53.56,-1481.93
2880,19920990,2023-02-13,871.5,-610.43
8588,19920990,2023-02-14,38.18,-572.25
311,19931073,2023-01-31,,404.96
3368,19931073,2023-02-13,40.02,444.97999999999996
312,19956941,2023-01-31,,723.33
6246,19956941,2023-02-03,1121.6,1844.9299999999998
4364,19956941,2023-02-05,-173.68,1671.2499999999998
5465,19956941,2023-02-08,1010.6,2681.85
3165,19956941,2023-02-08,-133.65,2548.2
6381,19956941,2023-02-09,-69.39,2478.81
6957,19956941,2023-02-14,-69.01,2409.7999999999997
313,19980716,2023-01-31,,432.98
3323,19980716,2023-02-02,1774.7,2207.6800000000003
6859,19980716,2023-02-02,-114.87,2092.81
8225,19980716,2023-02-03,-159.69,1933.1200000000001
4819,19980716,2023-02-07,20.07,1953.19
7849,19980716,2023-02-09,125.68,2078.87
8032,19980716,2023-02-09,114.01,2192.88
1091,19980716,2023-02-10,-682.2,1510.68
3667,19980716,2023-02-11,75.65,1586.3300000000002
314,20015298,2023-01-31,,953.82
7377,20015298,2023-02-01,158.51,1112.33
2019,20015298,2023-02-08,42.88,1155.21
2982,20015298,2023-02-08,-128.42,1026.79
6025,20015298,2023-02-11,-590.6,436.19000000000005
3462,20015298,2023-02-13,-50.67,385.52000000000004
315,20067958,2023-01-31,,38.05
8520,20067958,2023-02-07,122.02,160.07
8483,20067958,2023-02-07,85.23,245.3
4537,20067958,2023-02-08,974.3,1219.6
5769,20067958,2023-02-11,102.26,1321.86
2820,20067958,2023-02-12,94.36,1416.2199999999998
316,20090784,2023-01-31,,482.62
570,20090784,2023-02-03,12.53,495.15
2481,20090784,2023-02-04,1263.9,1759.0500000000002
8590,20090784,2023-02-09,85.8,1844.8500000000001
2577,20090784,2023-02-10,-8.29,1836.5600000000002
3500,20090784,2023-02-13,710.9,2547.46
317,20117480,2023-01-31,,70.97
5854,20117480,2023-02-01,-86.68,-15.710000000000008
1207,20117480,2023-02-06,186.65,170.94
4985,20117480,2023-02-07,188.36,359.3
5484,20117480,2023-02-08,-154.2,205.10000000000002
553,20117480,2023-02-11,75.16,280.26
318,20129535,2023-01-31,,446.41
7938,20129535,2023-02-01,143.85,590.26
5656,20129535,2023-02-05,172.62,762.88
3775,20129535,2023-02-06,45.01,807.89
4397,20129535,2023-02-07,6.03,813.9200000000001
8507,20129535,2023-02-10,-99.74,714.1800000000001
1940,20129535,2023-02-11,-30.14,684.04
2717,20129535,2023-02-13,113.24,797.28
319,20176338,2023-01-31,,289.57
7712,20176338,2023-02-01,-100.02,189.55
706,20176338,2023-02-04,-186.95,2.6000000000000227
3584,20176338,2023-02-05,108.33,110.93000000000002
6850,20176338,2023-02-05,62.88,173.81000000000003
2780,20176338,2023-02-08,96.42,270.23
3238,20176338,2023-02-09,188.14,458.37
4988,20176338,2023-02-10,-121.7,336.67
320,20242626,2023-01-31,,701.08
3586,20242626,2023-02-03,85.48,786.5600000000001
8161,20242626,2023-02-09,82.05,868.61
321,20248053,2023-01-31,,565.28
8119,20248053,2023-02-02,-77.43,487.84999999999997
8176,20248053,2023-02-03,127.48,615.3299999999999
2623,20248053,2023-02-04,110.05,725.38
559,20248053,2023-02-11,-179.27,546.1099999999999
8430,20248053,2023-02-14,-114.98,431.12999999999994
322,20263437,2023-01-31,,789.09
863,20263437,2023-02-04,141.31,930.4000000000001
221,20263437,2023-02-05,-41.33,889.07
5592,20263437,2023-02-05,-99.42,789.6500000000001
2592,20263437,2023-02-08,107.41,897.0600000000001
3150,20263437,2023-02-12,48.67,945.73
323,20280759,2023-01-31,,838.7
1959,20280759,2023-02-03,-66.37,772.33
4248,20280759,2023-02-04,-110.37,661.96
5288,20280759,2023-02-12,118.8,780.76
6990,20280759,2023-02-12,-66.4,714.36
8624,20280759,2023-02-12,-110.26,604.1
6546,20280759,2023-02-13,110.74,714.84
324,20287993,2023-01-31,,616.17
5510,20287993,2023-02-03,125.34,741.51
7003,20287993,2023-02-04,614.0,1355.51
8030,20287993,2023-02-06,876.5,2232.01
3881,20287993,2023-02-07,-756.5,1475.51
187,20287993,2023-02-09,81.5,1557.01
2767,20287993,2023-02-13,203.37,1760.38
3748,20287993,2023-02-13,-91.78,1668.6
325,20316429,2023-01-31,,697.84
4903,20316429,2023-02-02,-94.92,602.9200000000001
3378,20316429,2023-02-09,-166.7,436.22
326,20345467,2023-01-31,,852.5
2608,20345467,2023-02-01,-72.35,780.15
6788,20345467,2023-02-02,-100.36,679.79
6271,20345467,2023-02-05,115.08,794.87
3061,20345467,2023-02-08,154.63,949.5
1693,20345467,2023-02-09,-154.98,794.52
7957,20345467,2023-02-14,102.53,897.05
327,20369153,2023-01-31,,293.78
2919,20369153,2023-02-01,387.9,681.68
2946,20369153,2023-02-03,142.86,824.54
7692,20369153,2023-02-04,-111.47,713.0699999999999
8617,20369153,2023-02-05,-144.17,568.9
6844,20369153,2023-02-07,605.2,1174.1
7731,20369153,2023-02-07,-979.3,194.80000000000007
6877,20369153,2023-02-11,-59.3,135.50000000000006
2938,20369153,2023-02-11,-132.19,3.310000000000059
6128,20369153,2023-02-11,-146.56,-143.24999999999994
328,20372310,2023-01-31,,366.41
359,20372310,2023-02-02,-123.8,242.61
3175,20372310,2023-02-05,142.33,384.94000000000005
5080,20372310,2023-02-05,-104.74,280.20000000000005
6104,20372310,2023-02-10,-26.87,253.33000000000007
5846,20372310,2023-02-10,-74.87,178.46000000000004
7018,20372310,2023-02-10,-144.36,34.10000000000002
7390,20372310,2023-02-11,123.03,157.13000000000002
4188,20372310,2023-02-11,-1293.9,-1136.77
329,20413037,2023-01-31,,235.79
8662,20413037,2023-02-02,98.09,333.88
1780,20413037,2023-02-02,-93.56,240.32
4612,20413037,2023-02-02,-119.55,120.77
563,20413037,2023-02-07,65.9,186.67000000000002
6406,20413037,2023-02-11,121.47,308.14
6181,20413037,2023-02-11,-48.78,259.36
7139,20413037,2023-02-14,-56.12,203.24
330,20425065,2023-01-31,,866.77
1546,20425065,2023-02-02,-62.78,803.99
4208,20425065,2023-02-04,-165.75,638.24
3575,20425065,2023-02-14,-2134.6,-1496.36
331,20464830,2023-01-31,,181.25
6510,20464830,2023-02-03,-166.13,15.120000000000005
4873,20464830,2023-02-04,121.04,136.16000000000003
2270,20464830,2023-02-08,159.45,295.61
332,20632572,2023-01-31,,286.44
7391,20632572,2023-02-02,-20.11,266.33
6934,20632572,2023-02-06,16.08,282.40999999999997
4681,20632572,2023-02-12,175.32,457.73
333,20704613,2023-01-31,,71.59
4540,20704613,2023-02-01,97.11,168.7
7685,20704613,2023-02-06,-11.61,157.09
2266,20704613,2023-02-07,93.91,251.0
7784,20704613,2023-02-08,30.57,281.57
5928,20704613,2023-02-09,130.36,411.93
3310,20704613,2023-02-10,-200.96,210.97
2520,20704613,2023-02-11,20.99,231.96
2204,20704613,2023-02-13,-154.81,77.15
334,20705548,2023-01-31,,184.81
6937,20705548,2023-02-02,2269.2,2454.0099999999998
3594,20705548,2023-02-03,208.56,2662.5699999999997
5423,20705548,2023-02-04,-125.11,2537.4599999999996
8167,20705548,2023-02-14,67.36,2604.8199999999997
1173,20705548,2023-02-14,46.61,2651.43
3571,20705548,2023-02-14,-30.74,2620.6899999999996
335,20720894,2023-01-31,,243.42
2744,20720894,2023-02-06,462.2,705.62
2801,20720894,2023-02-06,179.82,885.4399999999999
8531,20720894,2023-02-11,-107.81,777.6299999999999
336,20838578,2023-01-31,,620.7
1515,20838578,2023-02-09,-55.87,564.83
8257,20838578,2023-02-10,-96.87,467.96000000000004
6469,20838578,2023-02-12,56.96,524.9200000000001
337,20849721,2023-01-31,,740.52
5143,20849721,2023-02-06,70.55,811.0699999999999
7473,20849721,2023-02-06,19.45,830.52
1467,20849721,2023-02-07,197.62,1028.1399999999999
5410,20849721,2023-02-08,-71.98,956.16
6355,20849721,2023-02-13,117.42,1073.58
338,20851460,2023-01-31,,931.67
5319,20851460,2023-02-03,124.8,1056.47
2279,20851460,2023-02-10,-147.03,909.4399999999999
339,20878023,2023-01-31,,648.19
2872,20878023,2023-02-04,-149.2,498.99000000000007
4330,20878023,2023-02-06,-103.53,395.46000000000004
645,20878023,2023-02-06,-125.2,270.26000000000005
1369,20878023,2023-02-08,124.5,394.76000000000005
7743,20878023,2023-02-08,-107.64,287.12000000000006
6108,20878023,2023-02-10,-63.58,223.54000000000008
1576,20878023,2023-02-13,-26.71,196.83000000000007
340,20908067,2023-01-31,,607.53
756,20908067,2023-02-05,179.9,787.43
8205,20908067,2023-02-06,-202.05,585.38
4029,20908067,2023-02-11,-119.75,465.63
2158,20908067,2023-02-14,-2138.0,-1672.37
341,20991411,2023-01-31,,572.64
372,20991411,2023-02-06,-111.33,461.31
8543,20991411,2023-02-09,41.77,503.08
5082,20991411,2023-02-10,-114.86,388.22
342,20992354,2023-01-31,,87.26
1816,20992354,2023-02-01,-82.18,5.079999999999998
2423,20992354,2023-02-03,-5.14,-0.060000000000001386
5322,20992354,2023-02-04,129.11,129.05
5798,20992354,2023-02-08,-191.5,-62.44999999999999
276,20992354,2023-02-09,-35.39,-97.83999999999999
8263,20992354,2023-02-12,52.16,-45.67999999999999
8609,20992354,2023-02-13,157.55,111.87000000000002
2407,20992354,2023-02-13,-99.13,12.740000000000023
343,21001872,2023-01-31,,31.76
6754,21001872,2023-02-09,12.23,43.99
3350,21001872,2023-02-10,-106.72,-62.73
1997,21001872,2023-02-12,-98.65,-161.38
8220,21001872,2023-02-14,101.69,-59.69
344,21032760,2023-01-31,,541.33
1028,21032760,2023-02-01,-637.1,-95.76999999999998
4320,21032760,2023-02-03,94.5,-1.2699999999999818
8024,21032760,2023-02-03,-51.58,-52.84999999999998
6299,21032760,2023-02-04,127.8,74.95000000000002
3089,21032760,2023-02-09,78.9,153.85000000000002
718,21032760,2023-02-09,-993.4,-839.55
2599,21032760,2023-02-10,-932.3,-1771.85
4424,21032760,2023-02-11,33.32,-1738.53
1660,21032760,2023-02-11,-1161.1,-2899.63
7405,21032760,2023-02-13,161.21,-2738.42
345,21047777,2023-01-31,,699.12
3483,21047777,2023-02-03,40.55,739.67
8616,21047777,2023-02-04,31.07,770.74
7704,21047777,2023-02-05,-128.94,641.8
4409,21047777,2023-02-06,92.39,734.19
4645,21047777,2023-02-07,137.57,871.76
6794,21047777,2023-02-08,163.05,1034.81
5225,21047777,2023-02-08,-14.52,1020.29
3693,21047777,2023-02-12,-90.28,930.01
346,21142911,2023-01-31,,714.89
7883,21142911,2023-02-01,-103.99,610.9
5505,21142911,2023-02-02,-156.5,454.4
6145,21142911,2023-02-06,80.92,535.3199999999999
2017,21142911,2023-02-10,160.6,695.92
2759,21142911,2023-02-10,-52.02,643.9
3389,21142911,2023-02-10,-86.61,557.29
347,21293955,2023-01-31,,232.88
951,21293955,2023-02-05,1110.7,1343.58
4769,21293955,2023-02-08,85.9,1429.4800000000002
1481,21293955,2023-02-10,624.8,2054.28
348,21314767,2023-01-31,,438.19
6618,21314767,2023-02-01,-33.36,404.83
2093,21314767,2023-02-01,-130.93,273.9
1126,21314767,2023-02-07,-143.04,130.85999999999999
2738,21314767,2023-02-11,-134.72,-3.8600000000000136
3914,21314767,2023-02-12,-103.79,-107.65000000000002
987,21314767,2023-02-12,-1486.8,-1594.45
349,21368735,2023-01-31,,281.87
7694,21368735,2023-02-01,-145.77,136.1
228,21368735,2023-02-02,-786.6,-650.5
8038,21368735,2023-02-03,40.33,-610.17
682,21368735,2023-02-04,-73.7,-683.87
4708,21368735,2023-02-05,-49.85,-733.72
4048,21368735,2023-02-06,63.43,-670.29
3344,21368735,2023-02-13,118.83,-551.46
350,21392412,2023-01-31,,708.46
2075,21392412,2023-02-02,117.9,826.36
1873,21392412,2023-02-02,-192.68,633.6800000000001
2702,21392412,2023-02-04,1367.4,2001.0800000000002
4191,21392412,2023-02-04,-101.75,1899.3300000000002
3512,21392412,2023-02-12,122.81,2022.14
4013,21392412,2023-02-14,-120.31,1901.8300000000002
351,21464772,2023-01-31,,719.8
6111,21464772,2023-02-04,81.91,801.7099999999999
6366,21464772,2023-02-08,52.3,854.01
3051,21464772,2023-02-12,181.41,1035.42
3530,21464772,2023-02-12,125.47,1160.8899999999999
352,21475060,2023-01-31,,354.98
2995,21475060,2023-02-06,39.83,394.81
3411,21475060,2023-02-06,-431.9,-37.089999999999975
3161,21475060,2023-02-10,-117.25,-154.33999999999997
1822,21475060,2023-02-12,-1061.5,-1215.84
3725,21475060,2023-02-13,158.29,-1057.55
827,21475060,2023-02-14,25.28,-1032.27
353,21515934,2023-01-31,,543.38
8546,21515934,2023-02-01,-126.75,416.63
7715,21515934,2023-02-02,599.3,1015.93
1610,21515934,2023-02-02,-212.6,803.3299999999999
8229,21515934,2023-02-03,-70.29,733.04
5654,21515934,2023-02-11,-100.88,632.16
3107,21515934,2023-02-14,77.69,709.8499999999999
354,21550631,2023-01-31,,84.96
4233,21550631,2023-02-03,-182.35,-97.39
1690,21550631,2023-02-04,119.53,22.14
4686,21550631,2023-02-08,-88.85,-66.71
3640,21550631,2023-02-11,110.41,43.7
355,21558805,2023-01-31,,586.63
952,21558805,2023-02-02,68.41,655.04
7452,21558805,2023-02-05,2160.7,2815.74
1513,21558805,2023-02-07,1434.3,4250.04
4129,21558805,2023-02-10,113.82,4363.86
2902,21558805,2023-02-12,934.0,5297.86
2283,21558805,2023-02-13,126.07,5423.929999999999
6355,21558805,2023-02-13,-117.42,5306.509999999999
356,21601747,2023-01-31,,410.62
3254,21601747,2023-02-01,-58.18,352.44
6008,21601747,2023-02-06,22.99,375.43
152,21601747,2023-02-08,597.4,972.8299999999999
75,21601747,2023-02-10,103.91,1076.74
7880,21601747,2023-02-14,-140.0,936.74
357,21618665,2023-01-31,,291.59
2139,21618665,2023-02-01,-223.94,67.64999999999998
742,21618665,2023-02-02,89.87,157.51999999999998
6641,21618665,2023-02-02,-175.73,-18.210000000000008
8103,21618665,2023-02-04,101.39,83.17999999999999
8535,21618665,2023-02-05,63.96,147.14
3175,21618665,2023-02-05,-142.33,4.809999999999974
6667,21618665,2023-02-06,184.01,188.81999999999996
5180,21618665,2023-02-06,-65.05,123.76999999999997
4098,21618665,2023-02-07,-171.64,-47.87000000000002
1076,21618665,2023-02-09,96.36,48.48999999999998
3535,21618665,2023-02-13,-104.51,-56.020000000000024
6652,21618665,2023-02-13,-148.17,-204.19
358,21646418,2023-01-31,,909.55
3367,21646418,2023-02-04,123.43,1032.98
4092,21646418,2023-02-06,-74.78,958.1999999999999
6620,21646418,2023-02-09,64.47,1022.67
359,21655728,2023-01-31,,761.31
7707,21655728,2023-02-11,56.37,817.68
3713,21655728,2023-02-11,-106.02,711.66
360,21675999,2023-01-31,,893.27
108,21675999,2023-02-01,109.32,1002.5899999999999
8175,21675999,2023-02-04,-598.4,404.19000000000005
7750,21675999,2023-02-09,158.66,562.85
1140,21675999,2023-02-10,-32.99,529.86
7053,21675999,2023-02-11,65.4,595.26
4951,21675999,2023-02-11,56.7,651.96
361,21694967,2023-01-31,,90.13
23,21694967,2023-02-02,1019.5,1109.63
4986,21694967,2023-02-02,133.67,1243.3
3252,21694967,2023-02-02,-616.7,626.5999999999999
6357,21694967,2023-02-03,-33.4,593.1999999999999
6853,21694967,2023-02-06,-1042.0,-448.80000000000007
1710,21694967,2023-02-07,1808.5,1359.6999999999998
2270,21694967,2023-02-08,-159.45,1200.2499999999998
5752,21694967,2023-02-09,12.69,1212.9399999999998
362,21705004,2023-01-31,,496.88
5223,21705004,2023-02-08,103.7,600.58
1112,21705004,2023-02-13,124.45,725.03
8625,21705004,2023-02-13,-48.19,676.84
363,21711501,2023-01-31,,126.63
6623,21711501,2023-02-01,126.36,252.99
7319,21711501,2023-02-03,-1882.4,-1629.41
8148,21711501,2023-02-04,-126.27,-1755.68
364,21716351,2023-01-31,,800.95
5648,21716351,2023-02-02,111.91,912.86
2416,21716351,2023-02-05,219.27,1132.13
4113,21716351,2023-02-08,33.32,1165.45
8060,21716351,2023-02-12,1499.6,2665.05
365,21719977,2023-01-31,,758.81
6785,21719977,2023-02-05,138.9,897.7099999999999
4848,21719977,2023-02-06,-155.92,741.79
5651,21719977,2023-02-06,-180.89,560.9
818,21719977,2023-02-10,739.5,1300.4
4076,21719977,2023-02-12,39.77,1340.17
541,21719977,2023-02-13,-1121.3,218.87000000000012
366,21728352,2023-01-31,,733.87
2657,21728352,2023-02-02,-91.84,642.03
1915,21728352,2023-02-04,120.38,762.41
1773,21728352,2023-02-08,-117.08,645.33
1374,21728352,2023-02-10,66.94,712.27
6840,21728352,2023-02-12,151.06,863.3299999999999
6383,21728352,2023-02-12,-103.32,760.01
6427,21728352,2023-02-13,51.57,811.58
367,21749252,2023-01-31,,646.27
2706,21749252,2023-02-01,50.95,697.22
5753,21749252,2023-02-02,-165.3,531.92
5198,21749252,2023-02-03,126.76,658.68
8298,21749252,2023-02-07,144.5,803.18
2545,21749252,2023-02-08,-110.15,693.03
5014,21749252,2023-02-10,-156.28,536.75
3752,21749252,2023-02-10,-1098.2,-561.45
5899,21749252,2023-02-13,53.28,-508.1700000000001
368,21750371,2023-01-31,,329.19
1328,21750371,2023-02-05,-88.55,240.64
8530,21750371,2023-02-06,131.96,372.6
1319,21750371,2023-02-10,72.23,444.83000000000004
369,21816770,2023-01-31,,693.8
4233,21816770,2023-02-03,182.35,876.15
1015,21816770,2023-02-03,141.05,1017.1999999999999
7430,21816770,2023-02-03,-56.86,960.3399999999999
297,21816770,2023-02-05,74.16,1034.5
7071,21816770,2023-02-09,-144.14,890.3599999999999
3916,21816770,2023-02-10,114.24,1004.5999999999999
370,21844169,2023-01-31,,463.51
8076,21844169,2023-02-01,-3.04,460.46999999999997
8524,21844169,2023-02-04,-139.28,321.19
4634,21844169,2023-02-06,104.66,425.85
7251,21844169,2023-02-06,-103.37,322.48
5800,21844169,2023-02-07,-89.6,232.88
8163,21844169,2023-02-08,103.37,336.25
1048,21844169,2023-02-09,67.11,403.36
8194,21844169,2023-02-11,-124.08,279.28
2044,21844169,2023-02-12,-108.81,170.47
371,21844651,2023-01-31,,525.16
7627,21844651,2023-02-03,104.89,630.05
7376,21844651,2023-02-03,-37.02,593.03
3955,21844651,2023-02-04,73.5,666.53
5631,21844651,2023-02-04,45.51,712.04
6976,21844651,2023-02-13,43.53,755.5699999999999
372,21881168,2023-01-31,,950.62
8282,21881168,2023-02-04,27.77,978.39
5612,21881168,2023-02-04,-78.39,900.0
4059,21881168,2023-02-04,-153.28,746.72
5237,21881168,2023-02-06,31.91,778.63
8262,21881168,2023-02-06,-185.73,592.9
6693,21881168,2023-02-10,121.44,714.34
8185,21881168,2023-02-10,-882.0,-167.65999999999997
1000,21881168,2023-02-14,-78.92,-246.57999999999998
373,21898016,2023-01-31,,117.42
4647,21898016,2023-02-09,113.15,230.57
374,21918195,2023-01-31,,510.33
1681,21918195,2023-02-02,-120.93,389.4
4693,21918195,2023-02-08,-105.35,284.04999999999995
2562,21918195,2023-02-14,-150.77,133.27999999999997
375,21966927,2023-01-31,,511.1
1545,21966927,2023-02-02,88.29,599.39
4023,21966927,2023-02-05,75.94,675.33
6465,21966927,2023-02-06,-27.72,647.61
4561,21966927,2023-02-10,69.88,717.49
376,22027757,2023-01-31,,438.85
7501,22027757,2023-02-01,-20.11,418.74
8673,22027757,2023-02-01,-102.21,316.53000000000003
5238,22027757,2023-02-01,-215.02,101.51000000000002
671,22027757,2023-02-05,-505.0,-403.49
4908,22027757,2023-02-06,13.61,-389.88
377,22035411,2023-01-31,,9.55
156,22035411,2023-02-02,1028.8,1038.35
4881,22035411,2023-02-02,122.21,1160.56
385,22035411,2023-02-02,37.84,1198.3999999999999
6219,22035411,2023-02-06,47.53,1245.9299999999998
3127,22035411,2023-02-07,-132.14,1113.79
3216,22035411,2023-02-09,-15.37,1098.4199999999998
8350,22035411,2023-02-10,97.29,1195.7099999999998
564,22035411,2023-02-11,-85.02,1110.6899999999998
378,22054113,2023-01-31,,364.66
6618,22054113,2023-02-01,33.36,398.02000000000004
7,22054113,2023-02-03,-66.09,331.93
3299,22054113,2023-02-04,57.96,389.89000000000004
3637,22054113,2023-02-09,137.79,527.6800000000001
6164,22054113,2023-02-11,43.78,571.46
5712,22054113,2023-02-11,-109.76,461.7
379,22063978,2023-01-31,,387.01
4742,22063978,2023-02-01,95.21,482.21999999999997
693,22063978,2023-02-01,-989.3,-507.08
3337,22063978,2023-02-02,50.71,-456.37
1306,22063978,2023-02-02,39.13,-417.24
5657,22063978,2023-02-10,108.81,-308.42999999999995
380,22099256,2023-01-31,,523.78
8592,22099256,2023-02-02,-131.8,391.97999999999996
6634,22099256,2023-02-04,-87.13,304.84999999999997
7069,22099256,2023-02-06,-127.87,176.97999999999996
6936,22099256,2023-02-06,-1003.2,-826.22
4608,22099256,2023-02-09,85.88,-740.34
2782,22099256,2023-02-14,1401.8,661.4599999999999
381,22137086,2023-01-31,,410.35
8299,22137086,2023-02-04,2122.7,2533.0499999999997
1183,22137086,2023-02-05,-115.53,2417.5199999999995
2404,22137086,2023-02-07,-32.26,2385.2599999999998
1311,22137086,2023-02-08,83.33,2468.5899999999997
2271,22137086,2023-02-08,-69.06,2399.5299999999997
166,22137086,2023-02-08,-1368.6,1030.9299999999998
3469,22137086,2023-02-09,-1288.6,-257.6700000000001
3806,22137086,2023-02-11,41.86,-215.81000000000006
382,22268314,2023-01-31,,153.05
5786,22268314,2023-02-01,-160.38,-7.329999999999984
554,22268314,2023-02-05,-65.31,-72.63999999999999
1022,22268314,2023-02-09,-155.69,-228.32999999999998
8500,22268314,2023-02-10,13.9,-214.42999999999998
3308,22268314,2023-02-11,-37.8,-252.23
508,22268314,2023-02-13,-14.32,-266.54999999999995
383,22292682,2023-01-31,,874.32
1579,22292682,2023-02-01,-130.44,743.8800000000001
6951,22292682,2023-02-05,159.07,902.95
27,22292682,2023-02-05,-201.75,701.2
7577,22292682,2023-02-06,122.96,824.1600000000001
5669,22292682,2023-02-07,103.74,927.9000000000001
5622,22292682,2023-02-11,23.58,951.48
8450,22292682,2023-02-12,66.05,1017.53
384,22298371,2023-01-31,,891.16
4564,22298371,2023-02-01,-107.18,783.98
2416,22298371,2023-02-05,-219.27,564.7099999999999
6283,22298371,2023-02-07,86.22,650.93
86,22298371,2023-02-12,-151.34,499.5899999999999
385,22341160,2023-01-31,,61.07
7602,22341160,2023-02-02,-699.9,-638.8299999999999
386,22374612,2023-01-31,,554.31
8307,22374612,2023-02-03,46.33,600.64
951,22374612,2023-02-05,-1110.7,-510.06000000000006
95,22374612,2023-02-07,-134.55,-644.6100000000001
3193,22374612,2023-02-08,-189.92,-834.5300000000001
2284,22374612,2023-02-11,1742.7,908.17
7585,22374612,2023-02-12,-91.9,816.27
7492,22374612,2023-02-14,-735.5,80.76999999999998
387,22391508,2023-01-31,,91.32
6239,22391508,2023-02-01,12.31,103.63
5179,22391508,2023-02-02,94.69,198.32
2979,22391508,2023-02-07,-71.61,126.71
388,22393008,2023-01-31,,753.5
2985,22393008,2023-02-07,-1806.9,-1053.4
2678,22393008,2023-02-09,1260.0,206.5999999999999
8446,22393008,2023-02-09,-146.1,60.499999999999915
4345,22393008,2023-02-10,1526.7,1587.2
6660,22393008,2023-02-13,-99.8,1487.4
389,22403299,2023-01-31,,702.95
7455,22403299,2023-02-03,774.8,1477.75
1049,22403299,2023-02-03,-101.53,1376.22
8408,22403299,2023-02-04,90.13,1466.35
6726,22403299,2023-02-04,-95.64,1370.71
1462,22403299,2023-02-05,-57.79,1312.92
1238,22403299,2023-02-08,167.11,1480.03
2536,22403299,2023-02-09,735.1,2215.13
5463,22403299,2023-02-09,142.44,2357.57
7449,22403299,2023-02-09,-88.39,2269.18
390,22404690,2023-01-31,,726.06
1172,22404690,2023-02-08,-13.32,712.7399999999999
4701,22404690,2023-02-12,934.7,1647.44
8596,22404690,2023-02-14,-126.71,1520.73
391,22412680,2023-01-31,,637.99
5514,22412680,2023-02-02,-82.9,555.09
4296,22412680,2023-02-03,-84.5,470.59000000000003
7978,22412680,2023-02-08,154.46,625.05
6659,22412680,2023-02-09,119.51,744.5600000000001
2602,22412680,2023-02-09,35.39,779.95
2045,22412680,2023-02-09,-167.25,612.7
2359,22412680,2023-02-10,85.16,697.86
3769,22412680,2023-02-10,77.1,774.96
6955,22412680,2023-02-14,104.53,879.49
5388,22412680,2023-02-14,-38.12,841.37
4646,22412680,2023-02-14,-68.51,772.86
392,22483300,2023-01-31,,763.23
3373,22483300,2023-02-05,-52.34,710.89
5013,22483300,2023-02-07,-140.12,570.77
543,22483300,2023-02-09,-112.76,458.01
5694,22483300,2023-02-10,85.13,543.14
393,22683382,2023-01-31,,987.13
746,22683382,2023-02-01,-92.35,894.78
820,22683382,2023-02-02,31.64,926.42
7847,22683382,2023-02-06,-110.76,815.66
3855,22683382,2023-02-07,-104.64,711.02
6012,22683382,2023-02-09,-142.61,568.41
394,22696687,2023-01-31,,133.52
2785,22696687,2023-02-03,153.0,286.52
3799,22696687,2023-02-08,-79.86,206.66000000000003
2709,22696687,2023-02-10,-62.31,144.35000000000002
2141,22696687,2023-02-10,-89.12,55.230000000000004
1822,22696687,2023-02-12,1061.5,1116.73
3228,22696687,2023-02-12,61.36,1178.09
4660,22696687,2023-02-12,-38.42,1139.67
4703,22696687,2023-02-14,-61.16,1078.51
395,22730750,2023-01-31,,473.56
7501,22730750,2023-02-01,20.11,493.67
2607,22730750,2023-02-01,13.37,507.04
5222,22730750,2023-02-04,-95.05,411.99
5796,22730750,2023-02-05,128.78,540.77
446,22730750,2023-02-07,-104.16,436.61
7962,22730750,2023-02-11,132.96,569.57
2013,22730750,2023-02-12,195.95,765.52
8476,22730750,2023-02-12,-198.2,567.32
396,22799719,2023-01-31,,481.26
8024,22799719,2023-02-03,51.58,532.84
1211,22799719,2023-02-03,-133.85,398.99
5836,22799719,2023-02-06,170.43,569.4200000000001
8449,22799719,2023-02-06,75.9,645.32
6498,22799719,2023-02-07,-44.02,601.3000000000001
8027,22799719,2023-02-11,26.87,628.1700000000001
4827,22799719,2023-02-12,-57.33,570.84
4867,22799719,2023-02-13,38.78,609.62
2358,22799719,2023-02-13,-180.81,428.81
6721,22799719,2023-02-14,53.79,482.6
397,22830156,2023-01-31,,596.06
6940,22830156,2023-02-02,634.2,1230.26
3358,22830156,2023-02-04,-109.5,1120.76
1666,22830156,2023-02-10,1987.3,3108.06
3885,22830156,2023-02-12,-1153.9,1954.1599999999999
2144,22830156,2023-02-13,-30.92,1923.2399999999998
1802,22830156,2023-02-14,-170.57,1752.6699999999998
398,22833010,2023-01-31,,645.79
7014,22833010,2023-02-01,-58.0,587.79
5825,22833010,2023-02-03,-132.53,455.26
5842,22833010,2023-02-04,-139.7,315.55999999999995
7847,22833010,2023-02-06,110.76,426.32
5894,22833010,2023-02-08,-163.93,262.39
399,22846221,2023-01-31,,868.2
3800,22846221,2023-02-01,-179.6,688.6
6362,22846221,2023-02-02,1106.9,1795.5
6430,22846221,2023-02-06,126.83,1922.33
4363,22846221,2023-02-09,12.71,1935.04
8419,22846221,2023-02-10,-144.27,1790.77
400,22884864,2023-01-31,,521.87
2357,22884864,2023-02-02,108.51,630.38
884,22884864,2023-02-05,-122.01,508.37
1967,22884864,2023-02-06,-137.14,371.23
1476,22884864,2023-02-06,-182.28,188.95000000000002
401,22888798,2023-01-31,,326.4
3280,22888798,2023-02-05,39.31,365.71
6422,22888798,2023-02-06,75.81,441.52
832,22888798,2023-02-07,71.14,512.66
7743,22888798,2023-02-08,107.64,620.3
2825,22888798,2023-02-08,-53.66,566.64
402,22951653,2023-01-31,,414.64
6453,22951653,2023-02-01,17.61,432.25
8053,22951653,2023-02-02,181.62,613.87
213,22951653,2023-02-08,-13.16,600.71
8033,22951653,2023-02-12,-14.26,586.45
1020,22951653,2023-02-12,-111.6,474.85
4100,22951653,2023-02-13,84.66,559.51
403,23030554,2023-01-31,,196.97
257,23030554,2023-02-03,148.95,345.91999999999996
1699,23030554,2023-02-06,-147.34,198.57999999999998
8058,23030554,2023-02-10,-67.6,130.98
7117,23030554,2023-02-11,-87.57,43.41
404,23032852,2023-01-31,,475.21
7332,23032852,2023-02-02,832.5,1307.71
6487,23032852,2023-02-04,75.94,1383.65
6756,23032852,2023-02-07,140.72,1524.3700000000001
4609,23032852,2023-02-09,780.7,2305.07
4231,23032852,2023-02-09,-155.34,2149.73
5550,23032852,2023-02-10,-156.63,1993.1000000000001
405,23045208,2023-01-31,,359.49
7109,23045208,2023-02-02,62.04,421.53000000000003
1653,23045208,2023-02-02,-794.9,-373.36999999999995
5507,23045208,2023-02-02,-1157.4,-1530.77
7548,23045208,2023-02-13,-118.67,-1649.44
406,23093541,2023-01-31,,326.05
5305,23093541,2023-02-04,-55.7,270.35
3975,23093541,2023-02-05,-96.95,173.4
3962,23093541,2023-02-05,-110.12,63.28
141,23093541,2023-02-10,86.54,149.82
407,23124345,2023-01-31,,595.61
6572,23124345,2023-02-03,215.09,810.7
8148,23124345,2023-02-04,126.27,936.97
3874,23124345,2023-02-12,130.79,1067.76
408,23141588,2023-01-31,,281.28
5042,23141588,2023-02-02,-1824.3,-1543.02
3186,23141588,2023-02-14,-64.58,-1607.6
409,23231848,2023-01-31,,27.12
4312,23231848,2023-02-02,-112.23,-85.11
8251,23231848,2023-02-04,-89.51,-174.62
470,23231848,2023-02-04,-292.64,-467.26
133,23231848,2023-02-04,-1454.9,-1922.16
783,23231848,2023-02-06,-97.52,-2019.68
2572,23231848,2023-02-09,140.03,-1879.65
1313,23231848,2023-02-11,-95.68,-1975.3300000000002
7570,23231848,2023-02-12,-481.2,-2456.53
2135,23231848,2023-02-13,-134.36,-2590.8900000000003
7969,23231848,2023-02-14,37.37,-2553.52
410,23269253,2023-01-31,,324.56
1528,23269253,2023-02-01,899.8,1224.36
6056,23269253,2023-02-07,-151.91,1072.4499999999998
101,23269253,2023-02-08,35.48,1107.9299999999998
6743,23269253,2023-02-10,-72.21,1035.7199999999998
3911,23269253,2023-02-13,-34.3,1001.42
5176,23269253,2023-02-14,-98.34,903.0799999999999
411,23271383,2023-01-31,,633.3
6962,23271383,2023-02-03,-101.42,531.88
6833,23271383,2023-02-05,174.13,706.01
3490,23271383,2023-02-06,1176.9,1882.91
3274,23271383,2023-02-07,138.63,2021.54
5724,23271383,2023-02-09,157.69,2179.23
7671,23271383,2023-02-09,4.61,2183.84
5620,23271383,2023-02-09,-134.0,2049.84
5605,23271383,2023-02-11,-11.69,2038.15
4368,23271383,2023-02-14,118.38,2156.53
412,23289647,2023-01-31,,522.8
7430,23289647,2023-02-03,56.86,579.66
3396,23289647,2023-02-07,-87.03,492.62999999999994
5240,23289647,2023-02-07,-125.71,366.91999999999996
5074,23289647,2023-02-10,170.55,537.47
1972,23289647,2023-02-10,-154.12,383.34999999999997
413,23295106,2023-01-31,,340.16
4696,23295106,2023-02-01,89.15,429.31000000000006
1871,23295106,2023-02-02,103.88,533.19
7210,23295106,2023-02-04,72.72,605.9100000000001
1934,23295106,2023-02-06,-106.03,499.88
3308,23295106,2023-02-11,37.8,537.6800000000001
657,23295106,2023-02-13,-110.4,427.28000000000003
7929,23295106,2023-02-14,1338.4,1765.68
414,23310842,2023-01-31,,78.85
2417,23310842,2023-02-02,91.54,170.39
729,23310842,2023-02-02,-176.64,-6.25
2923,23310842,2023-02-05,12.08,5.83
1414,23310842,2023-02-05,-135.39,-129.55999999999997
6410,23310842,2023-02-06,-90.98,-220.53999999999996
4552,23310842,2023-02-06,-878.3,-1098.84
4036,23310842,2023-02-09,103.84,-994.9999999999999
707,23310842,2023-02-12,-128.4,-1123.3999999999999
415,23321929,2023-01-31,,408.3
8064,23321929,2023-02-04,123.51,531.8100000000001
6079,23321929,2023-02-11,-114.34,417.47
6611,23321929,2023-02-13,47.15,464.62
6814,23321929,2023-02-13,-214.61,250.01
416,23325248,2023-01-31,,49.31
8112,23325248,2023-02-02,-137.59,-88.28
5563,23325248,2023-02-09,-182.37,-270.65
417,23333877,2023-01-31,,648.46
8688,23333877,2023-02-01,-123.23,525.23
4330,23333877,2023-02-06,103.53,628.76
3883,23333877,2023-02-06,78.08,706.84
4571,23333877,2023-02-09,166.64,873.48
7622,23333877,2023-02-10,386.8,1260.28
564,23333877,2023-02-11,85.02,1345.3
1939,23333877,2023-02-12,-93.16,1252.14
65,23333877,2023-02-14,-153.66,1098.48
418,23369902,2023-01-31,,716.79
4982,23369902,2023-02-01,129.91,846.6999999999999
2216,23369902,2023-02-05,165.04,1011.74
4667,23369902,2023-02-05,118.28,1130.02
6404,23369902,2023-02-08,-124.8,1005.2199999999999
7609,23369902,2023-02-11,-111.88,893.3399999999999
3493,23369902,2023-02-13,144.46,1037.8
5617,23369902,2023-02-13,-183.79,854.01
419,23415061,2023-01-31,,71.2
2956,23415061,2023-02-01,-102.1,-30.89999999999999
7560,23415061,2023-02-03,90.48,59.58000000000001
7690,23415061,2023-02-04,1702.7,1762.28
8064,23415061,2023-02-04,-123.51,1638.77
2530,23415061,2023-02-10,1220.5,2859.27
420,23445508,2023-01-31,,373.43
7095,23445508,2023-02-04,54.57,428.0
5488,23445508,2023-02-07,-85.73,342.27
602,23445508,2023-02-09,-652.0,-309.73
4560,23445508,2023-02-11,-82.15,-391.88
3886,23445508,2023-02-13,169.23,-222.65000000000003
4690,23445508,2023-02-13,23.17,-199.48000000000002
6195,23445508,2023-02-13,-48.38,-247.86000000000004
421,23479459,2023-01-31,,176.23
7246,23479459,2023-02-02,121.53,297.76
6747,23479459,2023-02-02,-117.71,180.05
265,23479459,2023-02-05,128.65,308.7
3125,23479459,2023-02-05,-133.57,175.13
2588,23479459,2023-02-06,50.86,225.99
1883,23479459,2023-02-09,43.87,269.86
422,23490922,2023-01-31,,934.35
7700,23490922,2023-02-06,-76.95,857.4
3804,23490922,2023-02-06,-132.91,724.49
7314,23490922,2023-02-07,78.1,802.59
474,23490922,2023-02-10,75.99,878.58
423,23498368,2023-01-31,,474.93
2386,23498368,2023-02-01,101.12,576.05
3730,23498368,2023-02-06,107.32,683.37
8472,23498368,2023-02-06,-159.06,524.31
7410,23498368,2023-02-07,109.39,633.7
1557,23498368,2023-02-11,92.54,726.24
517,23498368,2023-02-12,98.68,824.9200000000001
4387,23498368,2023-02-12,11.42,836.34
7030,23498368,2023-02-13,-90.8,745.54
424,23501735,2023-01-31,,562.17
1244,23501735,2023-02-06,107.54,669.7099999999999
3049,23501735,2023-02-08,-150.5,519.21
5456,23501735,2023-02-09,-42.25,476.96
7059,23501735,2023-02-10,-48.91,428.04999999999995
5628,23501735,2023-02-11,-75.76,352.28999999999996
5168,23501735,2023-02-12,142.78,495.07
7885,23501735,2023-02-12,-89.44,405.63
5171,23501735,2023-02-12,-124.17,281.46
425,23580422,2023-01-31,,716.05
8115,23580422,2023-02-12,-67.25,648.8
426,23698615,2023-01-31,,316.68
3591,23698615,2023-02-02,89.17,405.85
4332,23698615,2023-02-05,114.48,520.33
517,23698615,2023-02-12,-98.68,421.65
427,23736501,2023-01-31,,831.27
7689,23736501,2023-02-04,192.0,1023.27
7500,23736501,2023-02-04,-157.68,865.5899999999999
7563,23736501,2023-02-07,-74.77,790.8199999999999
5563,23736501,2023-02-09,182.37,973.19
6284,23736501,2023-02-09,57.19,1030.38
8542,23736501,2023-02-09,-36.06,994.3199999999999
2175,23736501,2023-02-10,-206.97,787.35
7357,23736501,2023-02-11,-42.47,744.88
4813,23736501,2023-02-14,85.48,830.36
428,23775829,2023-01-31,,771.57
8074,23775829,2023-02-02,91.57,863.1400000000001
2541,23775829,2023-02-02,65.53,928.6700000000001
6622,23775829,2023-02-03,-28.47,900.2
4593,23775829,2023-02-03,-65.94,834.26
2099,23775829,2023-02-12,-104.51,729.75
8678,23775829,2023-02-13,101.49,831.24
429,23815822,2023-01-31,,835.0
7319,23815822,2023-02-03,1882.4,2717.4
7023,23815822,2023-02-03,-96.94,2620.46
5527,23815822,2023-02-05,-110.97,2509.4900000000002
4360,23815822,2023-02-13,-17.83,2491.6600000000003
430,23865100,2023-01-31,,201.44
3440,23865100,2023-02-02,-52.86,148.57999999999998
8097,23865100,2023-02-05,-140.22,8.360000000000014
5180,23865100,2023-02-06,65.05,73.41000000000001
2658,23865100,2023-02-07,86.46,159.87
3194,23865100,2023-02-08,134.88,294.75
3711,23865100,2023-02-08,83.2,377.95
7820,23865100,2023-02-09,64.55,442.5
4431,23865100,2023-02-13,17.92,460.42
5625,23865100,2023-02-14,67.55,527.97
431,23920423,2023-01-31,,221.15
4294,23920423,2023-02-03,-48.23,172.92000000000002
6423,23920423,2023-02-03,-72.77,100.15
6018,23920423,2023-02-05,96.05,196.2
8384,23920423,2023-02-05,-63.21,132.99
1053,23920423,2023-02-08,38.77,171.76
7845,23920423,2023-02-08,12.95,184.71
3832,23920423,2023-02-08,-161.43,23.28
6032,23920423,2023-02-11,141.71,164.99
432,23931414,2023-01-31,,126.7
2584,23931414,2023-02-03,-32.07,94.63
8385,23931414,2023-02-10,-123.72,-29.090000000000003
4200,23931414,2023-02-14,101.76,72.67
433,23932793,2023-01-31,,962.8
1366,23932793,2023-02-13,-510.4,452.4
1440,23932793,2023-02-14,-34.96,417.44
434,23935849,2023-01-31,,888.11
4099,23935849,2023-02-11,103.93,992.04
5601,23935849,2023-02-12,191.46,1183.5
3546,23935849,2023-02-14,42.9,1226.4
435,23942646,2023-01-31,,517.93
3811,23942646,2023-02-01,82.42,600.3499999999999
4173,23942646,2023-02-04,-104.07,496.28
2953,23942646,2023-02-06,-102.01,394.27
2505,23942646,2023-02-07,105.09,499.35999999999996
8217,23942646,2023-02-09,57.45,556.81
436,23959928,2023-01-31,,878.83
876,23959928,2023-02-03,1569.4,2448.23
6696,23959928,2023-02-04,-3.48,2444.75
7313,23959928,2023-02-07,-69.6,2375.15
172,23959928,2023-02-14,41.12,2416.27
437,23962863,2023-01-31,,307.07
8676,23962863,2023-02-01,-599.8,-292.72999999999996
578,23962863,2023-02-03,-43.61,-336.34
7244,23962863,2023-02-04,-535.8,-872.1399999999999
1684,23962863,2023-02-05,171.75,-700.3899999999999
5764,23962863,2023-02-07,-1676.4,-2376.79
801,23962863,2023-02-11,84.36,-2292.43
1098,23962863,2023-02-13,123.27,-2169.16
5018,23962863,2023-02-13,-92.64,-2261.8
438,23971753,2023-01-31,,170.77
4223,23971753,2023-02-02,-169.64,1.1300000000000239
2078,23971753,2023-02-03,110.05,111.18000000000002
2187,23971753,2023-02-08,175.97,287.15000000000003
7684,23971753,2023-02-08,-37.07,250.08
5972,23971753,2023-02-08,-120.67,129.41
868,23971753,2023-02-09,-142.67,-13.259999999999991
8178,23971753,2023-02-09,-1658.0,-1671.26
1392,23971753,2023-02-10,-48.54,-1719.8
8025,23971753,2023-02-14,123.69,-1596.11
4126,23971753,2023-02-14,-194.38,-1790.49
439,24010877,2023-01-31,,652.95
1482,24010877,2023-02-01,107.29,760.24
3591,24010877,2023-02-02,-89.17,671.07
2338,24010877,2023-02-05,-154.98,516.09
4513,24010877,2023-02-10,139.65,655.74
7421,24010877,2023-02-10,12.48,668.22
422,24010877,2023-02-10,-25.31,642.9100000000001
3565,24010877,2023-02-11,122.96,765.8700000000001
1024,24010877,2023-02-12,-110.81,655.0600000000001
440,24051672,2023-01-31,,429.37
7503,24051672,2023-02-02,-111.58,317.79
5130,24051672,2023-02-03,-122.53,195.26
590,24051672,2023-02-03,-208.28,-13.019999999999982
2002,24051672,2023-02-06,50.67,37.65000000000002
3988,24051672,2023-02-06,-1069.9,-1032.25
4147,24051672,2023-02-08,122.65,-909.6
213,24051672,2023-02-08,13.16,-896.4399999999999
441,24076677,2023-01-31,,494.74
3592,24076677,2023-02-04,142.92,637.66
1961,24076677,2023-02-04,-162.79,474.87
461,24076677,2023-02-09,59.74,534.61
4517,24076677,2023-02-12,120.78,655.39
442,24085667,2023-01-31,,249.1
8202,24085667,2023-02-01,78.1,327.2
3143,24085667,2023-02-03,-39.9,287.3
8677,24085667,2023-02-07,97.64,384.94
7519,24085667,2023-02-11,72.76,457.7
5437,24085667,2023-02-12,140.52,598.22
2529,24085667,2023-02-13,-102.35,495.87
1068,24085667,2023-02-14,130.66,626.53
443,24113784,2023-01-31,,47.67
7959,24113784,2023-02-03,-965.4,-917.73
113,24113784,2023-02-04,175.99,-741.74
2537,24113784,2023-02-04,-1026.7,-1768.44
2611,24113784,2023-02-09,37.53,-1730.91
3835,24113784,2023-02-10,131.38,-1599.53
5820,24113784,2023-02-10,98.69,-1500.8400000000001
6159,24113784,2023-02-10,-55.38,-1556.22
8224,24113784,2023-02-11,-666.5,-2222.7200000000003
3322,24113784,2023-02-13,77.23,-2145.4900000000002
7674,24113784,2023-02-13,-0.22,-2145.71
5256,24113784,2023-02-13,-76.07,-2221.78
444,24122572,2023-01-31,,924.02
8383,24122572,2023-02-03,-78.28,845.74
3726,24122572,2023-02-04,362.7,1208.44
2405,24122572,2023-02-04,160.27,1368.71
7173,24122572,2023-02-06,149.41,1518.12
305,24122572,2023-02-09,-168.03,1350.09
167,24122572,2023-02-11,86.77,1436.86
2593,24122572,2023-02-11,-141.75,1295.11
3313,24122572,2023-02-13,118.46,1413.57
1776,24122572,2023-02-13,97.77,1511.34
445,24123707,2023-01-31,,327.69
1092,24123707,2023-02-02,120.26,447.95
6802,24123707,2023-02-09,1386.8,1834.75
446,24125563,2023-01-31,,908.28
3192,24125563,2023-02-01,98.33,1006.61
3006,24125563,2023-02-06,-73.5,933.11
907,24125563,2023-02-10,124.46,1057.57
5370,24125563,2023-02-11,89.5,1147.07
4360,24125563,2023-02-13,17.83,1164.8999999999999
447,24149353,2023-01-31,,487.27
2437,24149353,2023-02-03,108.5,595.77
7491,24149353,2023-02-06,163.65,759.42
3902,24149353,2023-02-06,38.61,798.03
5085,24149353,2023-02-06,-1201.1,-403.06999999999994
448,24150990,2023-01-31,,365.31
7503,24150990,2023-02-02,111.58,476.89
4534,24150990,2023-02-04,134.81,611.7
1893,24150990,2023-02-04,-47.39,564.31
2769,24150990,2023-02-05,-84.05,480.26
6033,24150990,2023-02-06,82.1,562.36
2011,24150990,2023-02-13,-185.87,376.49
1647,24150990,2023-02-14,91.7,468.19
449,24178466,2023-01-31,,330.91
655,24178466,2023-02-06,79.47,410.38
3226,24178466,2023-02-06,-114.81,295.57000000000005
5116,24178466,2023-02-08,-87.59,207.98000000000002
6584,24178466,2023-02-14,-96.17,111.81000000000002
450,24184530,2023-01-31,,37.87
317,24184530,2023-02-02,-83.33,-45.46
5384,24184530,2023-02-08,-1360.9,-1406.3600000000001
4230,24184530,2023-02-11,-175.16,-1581.5200000000002
136,24184530,2023-02-12,143.0,-1438.5200000000002
451,24198488,2023-01-31,,578.35
338,24198488,2023-02-02,-168.98,409.37
3125,24198488,2023-02-05,133.57,542.94
7223,24198488,2023-02-05,94.38,637.32
222,24198488,2023-02-05,83.59,720.9100000000001
930,24198488,2023-02-09,-86.86,634.0500000000001
2737,24198488,2023-02-13,134.6,768.6500000000001
452,24250015,2023-01-31,,592.59
3144,24250015,2023-02-01,132.46,725.0500000000001
7283,24250015,2023-02-10,84.84,809.8900000000001
8679,24250015,2023-02-10,-871.2,-61.309999999999945
5848,24250015,2023-02-11,107.86,46.550000000000054
977,24250015,2023-02-11,-115.25,-68.69999999999995
3562,24250015,2023-02-12,1354.4,1285.7
453,24285988,2023-01-31,,783.9
2603,24285988,2023-02-02,158.28,942.18
8556,24285988,2023-02-04,-58.09,884.0899999999999
1161,24285988,2023-02-05,963.3,1847.3899999999999
483,24285988,2023-02-06,99.14,1946.53
4953,24285988,2023-02-06,-149.08,1797.4499999999998
2907,24285988,2023-02-14,-114.54,1682.9099999999999
365,24285988,2023-02-14,-178.04,1504.87
454,24298516,2023-01-31,,768.69
5002,24298516,2023-02-01,-74.43,694.26
7774,24298516,2023-02-03,177.23,871.49
8446,24298516,2023-02-09,146.1,1017.59
3890,24298516,2023-02-09,63.75,1081.3400000000001
455,24299977,2023-01-31,,199.33
2607,24299977,2023-02-01,-13.37,185.96
2636,24299977,2023-02-01,-62.95,123.01000000000002
5201,24299977,2023-02-01,-88.99,34.02000000000001
2148,24299977,2023-02-01,-218.14,-184.11999999999998
4731,24299977,2023-02-02,114.88,-69.23999999999998
3603,24299977,2023-02-04,78.83,9.590000000000018
7403,24299977,2023-02-06,-177.63,-168.03999999999996
3303,24299977,2023-02-08,-88.44,-256.47999999999996
6189,24299977,2023-02-10,-139.51,-395.98999999999995
2302,24299977,2023-02-11,-102.84,-498.8299999999999
856,24299977,2023-02-13,118.4,-380.42999999999995
7600,24299977,2023-02-13,-168.68,-549.1099999999999
456,24308337,2023-01-31,,764.57
2713,24308337,2023-02-02,-79.25,685.32
404,24308337,2023-02-03,-123.6,561.72
5063,24308337,2023-02-03,-886.6,-324.88
445,24308337,2023-02-07,-1653.3,-1978.1799999999998
7415,24308337,2023-02-09,148.45,-1829.73
3961,24308337,2023-02-11,148.81,-1680.92
1284,24308337,2023-02-12,-146.05,-1826.97
339,24308337,2023-02-13,959.6,-867.3700000000001
457,24370240,2023-01-31,,608.64
4167,24370240,2023-02-01,-45.7,562.9399999999999
509,24370240,2023-02-02,113.03,675.97
6797,24370240,2023-02-06,-137.34,538.63
3641,24370240,2023-02-07,-39.54,499.09
7656,24370240,2023-02-08,1245.5,1744.59
435,24370240,2023-02-09,88.73,1833.32
4010,24370240,2023-02-13,153.62,1986.94
7057,24370240,2023-02-13,136.9,2123.84
7895,24370240,2023-02-14,63.74,2187.58
458,24382889,2023-01-31,,14.23
4510,24382889,2023-02-04,68.76,82.99000000000001
6548,24382889,2023-02-06,69.68,152.67000000000002
4118,24382889,2023-02-12,68.37,221.04000000000002
7874,24382889,2023-02-13,-46.32,174.72000000000003
459,24406166,2023-01-31,,746.97
6281,24406166,2023-02-09,132.48,879.45
5482,24406166,2023-02-09,96.52,975.97
5214,24406166,2023-02-10,149.61,1125.58
4187,24406166,2023-02-11,-103.18,1022.4000000000001
460,24434457,2023-01-31,,385.3
4572,24434457,2023-02-03,2128.4,2513.7000000000003
2830,24434457,2023-02-10,-129.11,2384.59
461,24462859,2023-01-31,,646.0
7105,24462859,2023-02-03,91.66,737.66
7910,24462859,2023-02-04,100.94,838.6
6429,24462859,2023-02-06,43.35,881.95
933,24462859,2023-02-07,-120.64,761.31
6767,24462859,2023-02-08,136.38,897.69
7521,24462859,2023-02-09,-1855.5,-957.81
4890,24462859,2023-02-12,-20.21,-978.02
462,24510213,2023-01-31,,142.59
3613,24510213,2023-02-10,-133.0,9.590000000000003
7139,24510213,2023-02-14,56.12,65.71000000000001
463,24513968,2023-01-31,,306.35
2311,24513968,2023-02-01,1277.2,1583.5500000000002
5244,24513968,2023-02-03,-110.56,1472.99
2316,24513968,2023-02-07,-111.37,1361.62
8212,24513968,2023-02-13,80.72,1442.34
464,24516638,2023-01-31,,426.16
2672,24516638,2023-02-04,-80.86,345.3
6910,24516638,2023-02-09,121.34,466.64000000000004
5284,24516638,2023-02-11,-26.95,439.69000000000005
5627,24516638,2023-02-14,124.79,564.48
2600,24516638,2023-02-14,117.24,681.72
465,24519138,2023-01-31,,58.15
6778,24519138,2023-02-01,-123.96,-65.81
530,24519138,2023-02-04,119.74,53.93000000000001
2167,24519138,2023-02-06,-742.3,-688.3699999999999
8137,24519138,2023-02-10,39.7,-648.6699999999998
6035,24519138,2023-02-11,887.8,239.1300000000001
7002,24519138,2023-02-13,166.98,406.1100000000001
6600,24519138,2023-02-13,-52.77,353.3400000000001
2527,24519138,2023-02-13,-139.83,213.51000000000008
8484,24519138,2023-02-14,126.36,339.87000000000006
3892,24519138,2023-02-14,-156.38,183.49000000000007
466,24529850,2023-01-31,,800.79
5474,24529850,2023-02-03,105.07,905.8599999999999
4325,24529850,2023-02-07,-103.43,802.43
5266,24529850,2023-02-08,135.88,938.31
8572,24529850,2023-02-08,-2283.2,-1344.8899999999999
8035,24529850,2023-02-09,-62.59,-1407.4799999999998
6370,24529850,2023-02-09,-103.19,-1510.6699999999998
3196,24529850,2023-02-09,-136.3,-1646.9699999999998
4940,24529850,2023-02-09,-196.64,-1843.61
7841,24529850,2023-02-11,-122.71,-1966.32
6220,24529850,2023-02-14,665.3,-1301.02
3639,24529850,2023-02-14,-79.12,-1380.1399999999999
467,24531428,2023-01-31,,565.21
6424,24531428,2023-02-03,-80.5,484.71000000000004
3369,24531428,2023-02-11,49.15,533.86
5512,24531428,2023-02-12,-89.04,444.82000000000005
468,24533829,2023-01-31,,190.8
5958,24533829,2023-02-01,118.62,309.42
7088,24533829,2023-02-02,-180.4,129.02
4476,24533829,2023-02-09,-105.21,23.810000000000016
2036,24533829,2023-02-11,-56.69,-32.87999999999998
638,24533829,2023-02-14,-52.36,-85.23999999999998
469,24533935,2023-01-31,,808.99
3875,24533935,2023-02-02,-13.68,795.3100000000001
7779,24533935,2023-02-06,59.42,854.73
414,24533935,2023-02-06,-114.86,739.87
2110,24533935,2023-02-07,118.19,858.06
1903,24533935,2023-02-11,95.27,953.33
7144,24533935,2023-02-12,-37.35,915.98
4392,24533935,2023-02-14,139.74,1055.72
8219,24533935,2023-02-14,85.15,1140.87
470,24539679,2023-01-31,,768.68
1687,24539679,2023-02-02,950.2,1718.88
8289,24539679,2023-02-02,-22.39,1696.49
2149,24539679,2023-02-05,58.5,1754.99
4082,24539679,2023-02-07,1151.1,2906.09
8395,24539679,2023-02-09,-127.72,2778.37
2137,24539679,2023-02-10,-114.72,2663.65
7939,24539679,2023-02-11,-35.03,2628.62
4283,24539679,2023-02-14,104.91,2733.5299999999997
2814,24539679,2023-02-14,-68.67,2664.86
4402,24539679,2023-02-14,-125.94,2538.92
471,24577383,2023-01-31,,911.96
3803,24577383,2023-02-02,88.1,1000.0600000000001
7813,24577383,2023-02-08,-152.99,847.07
5090,24577383,2023-02-11,120.57,967.64
4845,24577383,2023-02-11,49.94,1017.58
8238,24577383,2023-02-14,131.53,1149.1100000000001
6904,24577383,2023-02-14,-1191.7,-42.590000000000146
472,24638469,2023-01-31,,968.27
4836,24638469,2023-02-01,-209.89,758.38
8536,24638469,2023-02-11,-127.49,630.89
473,24669065,2023-01-31,,574.3
1870,24669065,2023-02-09,87.21,661.51
5108,24669065,2023-02-11,-65.05,596.4599999999999
3232,24669065,2023-02-11,-74.61,521.8499999999999
961,24669065,2023-02-14,-162.09,359.75999999999993
474,24715803,2023-01-31,,684.75
2669,24715803,2023-02-06,131.6,816.35
1332,24715803,2023-02-10,88.61,904.96
126,24715803,2023-02-10,-85.88,819.08
2422,24715803,2023-02-13,-117.96,701.12
6062,24715803,2023-02-14,-80.46,620.66
475,24725325,2023-01-31,,567.17
8282,24725325,2023-02-04,-27.77,539.4
1409,24725325,2023-02-06,-78.29,461.10999999999996
5064,24725325,2023-02-06,-143.3,317.80999999999995
1141,24725325,2023-02-08,-150.55,167.25999999999993
1561,24725325,2023-02-09,129.85,297.1099999999999
4387,24725325,2023-02-12,-11.42,285.68999999999994
5880,24725325,2023-02-12,-139.56,146.12999999999994
476,24796881,2023-01-31,,943.93
372,24796881,2023-02-06,111.33,1055.26
6389,24796881,2023-02-08,89.09,1144.35
5249,24796881,2023-02-09,125.13,1269.48
8344,24796881,2023-02-10,-89.61,1179.87
3306,24796881,2023-02-14,142.18,1322.05
8294,24796881,2023-02-14,122.9,1444.95
632,24796881,2023-02-14,-52.73,1392.22
477,24826358,2023-01-31,,923.46
4139,24826358,2023-02-06,-113.2,810.26
3949,24826358,2023-02-08,123.43,933.69
393,24826358,2023-02-08,-151.47,782.22
3776,24826358,2023-02-09,-107.86,674.36
1,24826358,2023-02-09,-170.19,504.17
5640,24826358,2023-02-10,355.2,859.37
2542,24826358,2023-02-14,72.61,931.98
478,24849103,2023-01-31,,381.36
3566,24849103,2023-02-01,-83.41,297.95000000000005
1255,24849103,2023-02-02,-104.28,193.67000000000002
6833,24849103,2023-02-05,-174.13,19.54000000000002
7051,24849103,2023-02-10,143.73,163.27
1054,24849103,2023-02-11,-185.47,-22.19999999999999
2336,24849103,2023-02-12,-77.02,-99.21999999999998
7805,24849103,2023-02-13,125.61,26.390000000000015
7091,24849103,2023-02-13,-142.2,-115.80999999999997
4177,24849103,2023-02-14,18.23,-97.57999999999997
479,24859951,2023-01-31,,950.69
7423,24859951,2023-02-08,-204.91,745.7800000000001
875,24859951,2023-02-09,-58.69,687.09
6551,24859951,2023-02-13,-74.74,612.35
480,24860683,2023-01-31,,982.97
1538,24860683,2023-02-01,-114.22,868.75
7787,24860683,2023-02-06,163.9,1032.65
7961,24860683,2023-02-06,-8.35,1024.3
8620,24860683,2023-02-08,-941.0,83.30000000000007
7058,24860683,2023-02-09,108.36,191.66000000000008
8644,24860683,2023-02-10,92.9,284.56000000000006
5570,24860683,2023-02-10,83.94,368.50000000000006
481,24976861,2023-01-31,,982.53
6273,24976861,2023-02-01,91.95,1074.48
1142,24976861,2023-02-02,190.68,1265.1599999999999
1219,24976861,2023-02-04,-64.92,1200.24
7848,24976861,2023-02-04,-133.05,1067.19
4000,24976861,2023-02-06,110.9,1178.09
4109,24976861,2023-02-06,104.1,1282.19
8641,24976861,2023-02-10,145.54,1427.73
6523,24976861,2023-02-11,105.42,1533.1499999999999
6158,24976861,2023-02-14,34.07,1567.22
482,24999129,2023-01-31,,750.61
898,24999129,2023-02-03,-179.75,570.86
4364,24999129,2023-02-05,173.68,744.54
7947,24999129,2023-02-09,-38.13,706.41
996,24999129,2023-02-09,-75.79,630.62
7454,24999129,2023-02-13,70.3,700.92
4494,24999129,2023-02-13,-731.4,-30.480000000000018
483,25004339,2023-01-31,,120.44
6166,25004339,2023-02-03,79.25,199.69
5028,25004339,2023-02-03,-131.18,68.50999999999999
7373,25004339,2023-02-05,102.38,170.89
4946,25004339,2023-02-05,56.51,227.39999999999998
7134,25004339,2023-02-07,92.13,319.53
4858,25004339,2023-02-14,79.28,398.80999999999995
6628,25004339,2023-02-14,-89.42,309.39
484,25006771,2023-01-31,,600.16
6409,25006771,2023-02-01,2027.7,2627.86
6265,25006771,2023-02-01,143.83,2771.69
512,25006771,2023-02-01,-94.29,2677.4
1423,25006771,2023-02-03,119.1,2796.5
6408,25006771,2023-02-04,105.81,2902.31
6726,25006771,2023-02-04,95.64,2997.95
5887,25006771,2023-02-12,2147.9,5145.85
485,25033680,2023-01-31,,639.47
5849,25033680,2023-02-01,-615.8,23.670000000000073
3719,25033680,2023-02-02,82.11,105.78000000000007
8272,25033680,2023-02-02,-412.3,-306.5199999999999
5271,25033680,2023-02-07,-78.73,-385.24999999999994
7840,25033680,2023-02-08,-169.4,-554.6499999999999
2425,25033680,2023-02-09,-120.08,-674.7299999999999
947,25033680,2023-02-10,142.57,-532.1599999999999
486,25099734,2023-01-31,,872.31
177,25099734,2023-02-02,-177.88,694.43
6775,25099734,2023-02-03,-117.86,576.5699999999999
7701,25099734,2023-02-03,-124.18,452.38999999999993
418,25099734,2023-02-04,-39.71,412.67999999999995
5859,25099734,2023-02-05,193.92,606.5999999999999
2457,25099734,2023-02-09,-155.22,451.37999999999994
8588,25099734,2023-02-14,-38.18,413.19999999999993
487,25110012,2023-01-31,,300.03
6001,25110012,2023-02-01,103.35,403.38
2480,25110012,2023-02-06,-104.85,298.53
8291,25110012,2023-02-08,-129.86,168.66999999999996
107,25110012,2023-02-09,6.19,174.85999999999996
8669,25110012,2023-02-09,-118.7,56.159999999999954
3146,25110012,2023-02-13,-53.93,2.2299999999999542
1733,25110012,2023-02-13,-104.02,-101.79000000000005
488,25133996,2023-01-31,,419.22
1227,25133996,2023-02-04,130.57,549.79
6150,25133996,2023-02-04,-103.33,446.46000000000004
6759,25133996,2023-02-07,-174.77,271.69
798,25133996,2023-02-08,-34.38,237.31
2015,25133996,2023-02-11,107.4,344.71000000000004
2703,25133996,2023-02-12,-68.8,275.91
974,25133996,2023-02-14,-42.13,233.78
489,25146667,2023-01-31,,534.11
4137,25146667,2023-02-01,-830.7,-296.59000000000003
5566,25146667,2023-02-10,99.46,-197.13000000000005
5701,25146667,2023-02-11,41.23,-155.90000000000003
3728,25146667,2023-02-12,105.79,-50.11000000000004
3311,25146667,2023-02-13,229.21,179.09999999999997
2763,25146667,2023-02-14,129.18,308.28
2904,25146667,2023-02-14,0.73,309.01
7907,25146667,2023-02-14,-201.77,107.23999999999995
490,25240031,2023-01-31,,520.29
7297,25240031,2023-02-02,140.31,660.5999999999999
6792,25240031,2023-02-03,125.77,786.37
2009,25240031,2023-02-08,-57.72,728.65
6782,25240031,2023-02-09,-175.48,553.17
491,25269707,2023-01-31,,770.38
4248,25269707,2023-02-04,110.37,880.75
3188,25269707,2023-02-04,-88.89,791.86
2377,25269707,2023-02-04,-131.28,660.5799999999999
1739,25269707,2023-02-08,67.93,728.51
5870,25269707,2023-02-13,97.59,826.1
492,25281513,2023-01-31,,618.78
2238,25281513,2023-02-02,78.21,696.99
2994,25281513,2023-02-05,-99.57,597.42
493,25310962,2023-01-31,,376.9
5878,25310962,2023-02-01,98.74,475.64
2451,25310962,2023-02-02,-58.7,416.93999999999994
8023,25310962,2023-02-05,-134.95,281.99
2951,25310962,2023-02-06,-222.12,59.869999999999976
494,25318205,2023-01-31,,582.9
6685,25318205,2023-02-03,-140.51,442.39
597,25318205,2023-02-07,-97.67,344.71999999999997
7464,25318205,2023-02-07,-161.73,182.99
4711,25318205,2023-02-10,90.09,273.08000000000004
5346,25318205,2023-02-13,105.4,378.48
495,25406407,2023-01-31,,394.05
7572,25406407,2023-02-01,56.06,450.11
2016,25406407,2023-02-03,-158.72,291.39
6635,25406407,2023-02-05,-226.81,64.58000000000001
255,25406407,2023-02-06,140.67,205.25
5251,25406407,2023-02-07,120.62,325.87
5306,25406407,2023-02-09,165.96,491.83000000000004
5817,25406407,2023-02-10,-29.92,461.91
1516,25406407,2023-02-10,-174.95,286.96000000000004
2959,25406407,2023-02-11,66.62,353.58000000000004
5260,25406407,2023-02-11,-218.81,134.77000000000004
496,25412464,2023-01-31,,203.46
3910,25412464,2023-02-02,107.62,311.08000000000004
8017,25412464,2023-02-03,-87.6,223.48000000000002
6442,25412464,2023-02-04,191.64,415.12
1969,25412464,2023-02-04,82.87,497.99
4108,25412464,2023-02-05,-90.59,407.4
7039,25412464,2023-02-07,96.86,504.26
2453,25412464,2023-02-09,-38.42,465.84000000000003
5006,25412464,2023-02-13,-106.97,358.87
497,25439304,2023-01-31,,890.08
3891,25439304,2023-02-01,-126.4,763.6800000000001
825,25439304,2023-02-05,-159.54,604.1400000000001
498,25504032,2023-01-31,,838.81
453,25504032,2023-02-02,-89.88,748.93
2942,25504032,2023-02-02,-147.42,601.51
6818,25504032,2023-02-06,-133.47,468.03999999999996
499,25510430,2023-01-31,,110.66
3717,25510430,2023-02-03,159.23,269.89
6267,25510430,2023-02-04,-74.75,195.14
7625,25510430,2023-02-06,1359.0,1554.1399999999999
655,25510430,2023-02-06,-79.47,1474.6699999999998
8338,25510430,2023-02-09,145.58,1620.25
1870,25510430,2023-02-09,-87.21,1533.04
1305,25510430,2023-02-09,-143.27,1389.77
3099,25510430,2023-02-10,92.86,1482.6299999999999
8359,25510430,2023-02-11,59.3,1541.9299999999998
500,25522226,2023-01-31,,428.21
8160,25522226,2023-02-02,92.61,520.8199999999999
7640,25522226,2023-02-04,1410.9,1931.72
5991,25522226,2023-02-06,-161.37,1770.35
3328,25522226,2023-02-07,70.76,1841.1100000000001
4805,25522226,2023-02-10,111.11,1952.22
1248,25522226,2023-02-11,158.64,2110.86
4947,25522226,2023-02-11,99.57,2210.43
501,25584693,2023-01-31,,793.42
5932,25584693,2023-02-06,308.7,1102.12
2136,25584693,2023-02-06,96.19,1198.31
3484,25584693,2023-02-07,142.6,1340.9099999999999
2471,25584693,2023-02-08,693.4,2034.31
2428,25584693,2023-02-09,-184.91,1849.3999999999999
8287,25584693,2023-02-13,193.1,2042.5
3139,25584693,2023-02-13,145.19,2187.69
1367,25584693,2023-02-13,-98.45,2089.24
1527,25584693,2023-02-14,117.12,2206.36
502,25596483,2023-01-31,,595.87
2164,25596483,2023-02-02,-160.62,435.25
6407,25596483,2023-02-05,80.23,515.48
4098,25596483,2023-02-07,171.64,687.12
6926,25596483,2023-02-10,105.35,792.47
503,25628234,2023-01-31,,808.37
496,25628234,2023-02-02,57.66,866.03
4195,25628234,2023-02-02,-92.36,773.67
6031,25628234,2023-02-07,43.31,816.98
4557,25628234,2023-02-09,68.25,885.23
2758,25628234,2023-02-09,-159.54,725.69
1589,25628234,2023-02-12,140.22,865.91
725,25628234,2023-02-12,67.6,933.51
504,25636885,2023-01-31,,755.58
8272,25636885,2023-02-02,412.3,1167.88
7391,25636885,2023-02-02,20.11,1187.99
3779,25636885,2023-02-08,93.01,1281.0
7647,25636885,2023-02-08,92.86,1373.8600000000001
5400,25636885,2023-02-10,151.75,1525.6100000000001
8048,25636885,2023-02-10,-1048.2,477.4100000000001
6397,25636885,2023-02-12,-77.54,399.87000000000006
1990,25636885,2023-02-13,-140.3,259.57000000000005
505,25677428,2023-01-31,,307.44
6865,25677428,2023-02-03,-56.35,251.09
398,25677428,2023-02-07,114.28,365.37
3715,25677428,2023-02-12,-1601.3,-1235.9299999999998
506,25678043,2023-01-31,,49.06
1803,25678043,2023-02-06,-71.4,-22.340000000000003
7834,25678043,2023-02-06,-133.66,-156.0
8572,25678043,2023-02-08,2283.2,2127.2
3418,25678043,2023-02-10,-34.35,2092.85
182,25678043,2023-02-11,-110.5,1982.35
7853,25678043,2023-02-12,-180.46,1801.8899999999999
985,25678043,2023-02-13,-384.8,1417.0899999999997
507,25698177,2023-01-31,,923.38
5028,25698177,2023-02-03,131.18,1054.56
7542,25698177,2023-02-04,81.16,1135.72
199,25698177,2023-02-04,55.58,1191.3
2273,25698177,2023-02-04,-124.06,1067.24
5111,25698177,2023-02-06,1524.9,2592.1400000000003
8397,25698177,2023-02-08,150.64,2742.78
3478,25698177,2023-02-09,892.4,3635.1800000000003
7688,25698177,2023-02-11,-182.11,3453.07
4768,25698177,2023-02-12,791.8,4244.87
5171,25698177,2023-02-12,124.17,4369.04
508,25710768,2023-01-31,,968.16
509,25737886,2023-01-31,,410.76
5311,25737886,2023-02-04,121.97,532.73
1899,25737886,2023-02-05,196.0,728.73
5853,25737886,2023-02-10,196.24,924.97
3476,25737886,2023-02-11,143.94,1068.91
5108,25737886,2023-02-11,65.05,1133.96
3565,25737886,2023-02-11,-122.96,1011.0
5549,25737886,2023-02-12,107.09,1118.09
3402,25737886,2023-02-12,-78.26,1039.83
3831,25737886,2023-02-14,119.1,1158.93
510,25746852,2023-01-31,,320.7
7096,25746852,2023-02-01,-86.44,234.26
3084,25746852,2023-02-04,-91.22,143.04
7072,25746852,2023-02-08,49.64,192.68
1498,25746852,2023-02-10,-1524.4,-1331.72
7349,25746852,2023-02-12,156.13,-1175.5900000000001
938,25746852,2023-02-13,77.91,-1097.68
3466,25746852,2023-02-14,-1485.7,-2583.38
511,25768265,2023-01-31,,702.22
7100,25768265,2023-02-02,-1902.2,-1199.98
3259,25768265,2023-02-06,121.72,-1078.26
5882,25768265,2023-02-06,-1502.6,-2580.8599999999997
4512,25768265,2023-02-08,72.17,-2508.69
6,25768265,2023-02-09,113.82,-2394.87
5579,25768265,2023-02-10,-82.0,-2476.87
4185,25768265,2023-02-14,-145.06,-2621.93
512,25779398,2023-01-31,,967.13
3380,25779398,2023-02-02,-134.24,832.89
4254,25779398,2023-02-04,66.32,899.21
6514,25779398,2023-02-05,-100.05,799.16
2255,25779398,2023-02-11,1104.5,1903.6599999999999
120,25779398,2023-02-11,-161.33,1742.33
513,25787771,2023-01-31,,494.02
2779,25787771,2023-02-02,127.28,621.3
4451,25787771,2023-02-06,154.47,775.77
1678,25787771,2023-02-06,143.42,919.1899999999999
2062,25787771,2023-02-07,64.41,983.5999999999999
5297,25787771,2023-02-07,48.04,1031.6399999999999
6191,25787771,2023-02-07,-742.8,288.84000000000003
2342,25787771,2023-02-08,-117.36,171.48000000000002
2926,25787771,2023-02-09,74.98,246.46000000000004
4465,25787771,2023-02-10,1662.6,1909.06
4457,25787771,2023-02-10,150.3,2059.36
1480,25787771,2023-02-10,-128.96,1930.3999999999999
3559,25787771,2023-02-11,126.14,2056.54
2204,25787771,2023-02-13,154.81,2211.35
7986,25787771,2023-02-13,61.53,2272.88
514,25807378,2023-01-31,,25.32
4828,25807378,2023-02-04,-120.85,-95.53
593,25807378,2023-02-10,51.27,-44.26
515,25893329,2023-01-31,,211.58
7262,25893329,2023-02-08,-218.9,-7.319999999999993
4817,25893329,2023-02-12,-176.03,-183.35
516,25931435,2023-01-31,,127.08
8416,25931435,2023-02-01,-69.52,57.56
5835,25931435,2023-02-07,199.86,257.42
6964,25931435,2023-02-08,-111.03,146.39000000000001
517,25939481,2023-01-31,,502.59
6670,25939481,2023-02-01,106.3,608.89
1465,25939481,2023-02-05,-101.46,507.42999999999995
2759,25939481,2023-02-10,52.02,559.4499999999999
518,25941557,2023-01-31,,656.34
8619,25941557,2023-02-01,-61.87,594.47
3815,25941557,2023-02-01,-818.4,-223.92999999999995
376,25941557,2023-02-02,34.56,-189.36999999999995
8438,25941557,2023-02-03,-96.63,-285.99999999999994
7445,25941557,2023-02-05,-37.99,-323.98999999999995
1327,25941557,2023-02-06,-100.34,-424.3299999999999
4961,25941557,2023-02-08,-130.43,-554.76
3152,25941557,2023-02-10,175.95,-378.80999999999995
2032,25941557,2023-02-10,69.68,-309.13
3715,25941557,2023-02-12,1601.3,1292.17
4097,25941557,2023-02-13,149.9,1442.07
519,26008806,2023-01-31,,553.23
2955,26008806,2023-02-02,205.49,758.72
6983,26008806,2023-02-03,105.92,864.64
1447,26008806,2023-02-05,121.03,985.6700000000001
6657,26008806,2023-02-05,-168.21,817.46
8120,26008806,2023-02-06,72.35,889.8100000000001
520,26023976,2023-01-31,,681.17
1985,26023976,2023-02-03,90.66,771.8299999999999
8009,26023976,2023-02-06,885.9,1657.73
521,26070761,2023-01-31,,641.67
8605,26070761,2023-02-07,1076.8,1718.4699999999998
2722,26070761,2023-02-11,93.32,1811.79
7793,26070761,2023-02-13,105.17,1916.96
5885,26070761,2023-02-14,-103.89,1813.07
522,26087369,2023-01-31,,653.2
2080,26087369,2023-02-01,-47.33,605.87
7447,26087369,2023-02-02,-130.93,474.94000000000005
3552,26087369,2023-02-10,-67.07,407.87000000000006
643,26087369,2023-02-14,-72.4,335.47
523,26101648,2023-01-31,,9.84
573,26101648,2023-02-03,76.87,86.71000000000001
4613,26101648,2023-02-04,97.94,184.65
524,26102798,2023-01-31,,104.08
7234,26102798,2023-02-03,-144.82,-40.739999999999995
2889,26102798,2023-02-04,-182.66,-223.39999999999998
3903,26102798,2023-02-05,-113.1,-336.5
4219,26102798,2023-02-07,-162.11,-498.61
134,26102798,2023-02-09,-108.34,-606.95
2362,26102798,2023-02-10,-158.38,-765.33
8138,26102798,2023-02-12,108.99,-656.34
7493,26102798,2023-02-14,-58.63,-714.97
17,26102798,2023-02-14,-63.34,-778.3100000000001
1843,26102798,2023-02-14,-156.56,-934.87
525,26109213,2023-01-31,,698.97
7050,26109213,2023-02-02,-1586.6,-887.6299999999999
5523,26109213,2023-02-05,1315.1,427.47
2892,26109213,2023-02-05,-26.93,400.54
1162,26109213,2023-02-06,55.84,456.38000000000005
4277,26109213,2023-02-06,-73.4,382.98
1756,26109213,2023-02-08,104.18,487.16
7953,26109213,2023-02-09,109.32,596.48
7891,26109213,2023-02-09,-105.79,490.69
6094,26109213,2023-02-12,81.37,572.0600000000001
8287,26109213,2023-02-13,-193.1,378.96000000000004
526,26115121,2023-01-31,,466.67
982,26115121,2023-02-03,144.61,611.28
7322,26115121,2023-02-03,-84.79,526.49
3357,26115121,2023-02-14,97.12,623.61
527,26118463,2023-01-31,,981.0
6396,26118463,2023-02-01,127.46,1108.46
1658,26118463,2023-02-03,-104.95,1003.51
7087,26118463,2023-02-12,-96.4,907.11
528,26248782,2023-01-31,,70.58
2178,26248782,2023-02-02,-130.23,-59.64999999999999
2430,26248782,2023-02-06,71.52,11.870000000000005
6317,26248782,2023-02-11,-28.34,-16.469999999999995
7770,26248782,2023-02-13,-138.97,-155.44
529,26375186,2023-01-31,,804.02
1270,26375186,2023-02-06,168.93,972.95
2950,26375186,2023-02-06,97.54,1070.49
4143,26375186,2023-02-06,46.31,1116.8
3168,26375186,2023-02-06,-154.75,962.05
4176,26375186,2023-02-07,125.96,1088.01
7343,26375186,2023-02-08,167.59,1255.6
5081,26375186,2023-02-10,-73.99,1181.6100000000001
8081,26375186,2023-02-11,-135.38,1046.23
6327,26375186,2023-02-14,1650.9,2697.13
530,26432558,2023-01-31,,465.32
870,26432558,2023-02-01,189.07,654.39
1552,26432558,2023-02-01,28.95,683.34
1299,26432558,2023-02-01,27.36,710.6999999999999
6361,26432558,2023-02-01,-32.75,677.95
676,26432558,2023-02-03,169.95,847.9
6058,26432558,2023-02-04,-139.51,708.39
1007,26432558,2023-02-06,1543.0,2251.39
205,26432558,2023-02-06,25.86,2277.25
646,26432558,2023-02-07,-1121.9,1155.3499999999997
531,26506201,2023-01-31,,592.7
825,26506201,2023-02-05,159.54,752.24
47,26506201,2023-02-05,-43.28,708.96
532,26506201,2023-02-07,135.69,844.6500000000001
4333,26506201,2023-02-09,8.38,853.0300000000001
3039,26506201,2023-02-11,-1215.8,-362.76999999999987
532,26522255,2023-01-31,,283.67
2355,26522255,2023-02-02,-56.84,226.83
3421,26522255,2023-02-08,-1127.1,-900.2699999999999
5556,26522255,2023-02-13,-1085.6,-1985.87
6192,26522255,2023-02-14,-120.06,-2105.93
4907,26522255,2023-02-14,-129.25,-2235.18
533,26528251,2023-01-31,,539.97
3543,26528251,2023-02-11,-108.59,431.38
5055,26528251,2023-02-13,-155.36,276.02
3541,26528251,2023-02-14,102.55,378.57
534,26632358,2023-01-31,,384.64
189,26632358,2023-02-01,182.19,566.8299999999999
3029,26632358,2023-02-01,180.83,747.66
7936,26632358,2023-02-02,61.7,809.36
5646,26632358,2023-02-07,1029.9,1839.2600000000002
5453,26632358,2023-02-09,82.99,1922.2500000000002
7652,26632358,2023-02-11,-24.9,1897.3500000000001
843,26632358,2023-02-13,1487.7,3385.05
535,26643616,2023-01-31,,260.1
3249,26643616,2023-02-01,90.79,350.89000000000004
6724,26643616,2023-02-01,-137.72,213.17000000000002
3638,26643616,2023-02-05,-160.91,52.26000000000002
6124,26643616,2023-02-09,74.6,126.86000000000001
1929,26643616,2023-02-11,170.89,297.75
2754,26643616,2023-02-12,-121.86,175.89
1572,26643616,2023-02-14,129.29,305.18
536,26669001,2023-01-31,,70.04
2438,26669001,2023-02-03,56.31,126.35000000000001
6244,26669001,2023-02-03,21.03,147.38
7842,26669001,2023-02-11,-142.29,5.090000000000032
2710,26669001,2023-02-11,-1318.1,-1313.0099999999998
6722,26669001,2023-02-14,-94.21,-1407.2199999999998
8093,26669001,2023-02-14,-634.0,-2041.2199999999998
537,26675311,2023-01-31,,989.13
4731,26675311,2023-02-02,-114.88,874.25
5424,26675311,2023-02-07,-15.66,858.59
7129,26675311,2023-02-09,27.53,886.12
6922,26675311,2023-02-09,-155.29,730.83
5149,26675311,2023-02-11,-22.62,708.21
3806,26675311,2023-02-11,-41.86,666.35
6772,26675311,2023-02-11,-181.25,485.1
1179,26675311,2023-02-13,-124.33,360.77000000000004
5542,26675311,2023-02-14,-64.87,295.90000000000003
538,26751921,2023-01-31,,800.07
8301,26751921,2023-02-14,132.36,932.4300000000001
3491,26751921,2023-02-14,127.34,1059.77
539,26791907,2023-01-31,,266.27
7832,26791907,2023-02-01,-126.46,139.81
1729,26791907,2023-02-09,-624.2,-484.39000000000004
5726,26791907,2023-02-12,79.75,-404.64000000000004
3399,26791907,2023-02-13,-181.54,-586.1800000000001
540,26793058,2023-01-31,,384.98
7428,26793058,2023-02-03,44.59,429.57000000000005
2053,26793058,2023-02-05,20.17,449.74
5816,26793058,2023-02-06,687.1,1136.8400000000001
2267,26793058,2023-02-08,-70.15,1066.69
541,26863880,2023-01-31,,818.47
2640,26863880,2023-02-05,-88.7,729.77
711,26863880,2023-02-05,-115.12,614.65
7747,26863880,2023-02-07,-102.54,512.11
6795,26863880,2023-02-08,946.2,1458.31
5376,26863880,2023-02-09,-107.47,1350.8400000000001
4915,26863880,2023-02-14,101.53,1452.3700000000001
6639,26863880,2023-02-14,76.32,1528.69
542,26874415,2023-01-31,,19.62
6937,26874415,2023-02-02,-2269.2,-2249.58
994,26874415,2023-02-03,-111.84,-2361.42
4840,26874415,2023-02-04,523.6,-1837.82
5881,26874415,2023-02-04,86.74,-1751.08
7811,26874415,2023-02-05,121.41,-1629.6699999999998
3836,26874415,2023-02-05,95.35,-1534.32
7231,26874415,2023-02-08,-52.99,-1587.31
4754,26874415,2023-02-11,99.56,-1487.75
543,26884718,2023-01-31,,573.65
4614,26884718,2023-02-01,114.47,688.12
4617,26884718,2023-02-02,482.7,1170.82
4314,26884718,2023-02-03,-20.42,1150.3999999999999
7726,26884718,2023-02-03,-118.63,1031.77
5811,26884718,2023-02-04,150.38,1182.1499999999999
7661,26884718,2023-02-08,149.83,1331.98
7607,26884718,2023-02-10,-47.01,1284.97
6128,26884718,2023-02-11,146.56,1431.53
544,26888158,2023-01-31,,473.02
8323,26888158,2023-02-02,70.88,543.9
6046,26888158,2023-02-02,-15.77,528.13
6369,26888158,2023-02-05,-1022.3,-494.16999999999996
8235,26888158,2023-02-12,179.93,-314.23999999999995
545,26893181,2023-01-31,,957.43
1879,26893181,2023-02-01,116.66,1074.09
2526,26893181,2023-02-01,-65.9,1008.1899999999999
721,26893181,2023-02-01,-169.18,839.01
1004,26893181,2023-02-03,-613.0,226.01
1844,26893181,2023-02-10,89.11,315.12
546,26906533,2023-01-31,,312.58
5080,26906533,2023-02-05,104.74,417.32
2149,26906533,2023-02-05,-58.5,358.82
6400,26906533,2023-02-07,-34.65,324.16999999999996
1172,26906533,2023-02-08,13.32,337.49
4159,26906533,2023-02-10,-75.71,261.78
7595,26906533,2023-02-12,89.48,351.26
4408,26906533,2023-02-14,50.82,402.08
547,26907311,2023-01-31,,842.69
1111,26907311,2023-02-05,103.21,945.9000000000001
3246,26907311,2023-02-05,-1195.0,-249.0999999999999
8354,26907311,2023-02-07,125.73,-123.3699999999999
318,26907311,2023-02-07,-93.19,-216.5599999999999
7367,26907311,2023-02-09,-160.54,-377.0999999999999
6200,26907311,2023-02-10,61.2,-315.8999999999999
6296,26907311,2023-02-13,74.01,-241.8899999999999
548,26953669,2023-01-31,,813.21
7170,26953669,2023-02-01,81.22,894.4300000000001
3140,26953669,2023-02-02,528.9,1423.33
7273,26953669,2023-02-03,-100.42,1322.91
996,26953669,2023-02-09,75.79,1398.7
1006,26953669,2023-02-11,137.86,1536.56
549,26958171,2023-01-31,,837.04
7527,26958171,2023-02-02,-116.1,720.9399999999999
7987,26958171,2023-02-05,9.05,729.99
4275,26958171,2023-02-07,-114.74,615.25
7474,26958171,2023-02-11,19.24,634.49
5904,26958171,2023-02-11,-23.0,611.49
550,26964507,2023-01-31,,358.72
551,26979446,2023-01-31,,149.65
1933,26979446,2023-02-01,18.27,167.92000000000002
7724,26979446,2023-02-03,214.53,382.45000000000005
7336,26979446,2023-02-07,133.96,516.4100000000001
8582,26979446,2023-02-11,-34.89,481.52000000000004
785,26979446,2023-02-14,-70.4,411.12
552,26985042,2023-01-31,,248.7
7725,26985042,2023-02-02,-116.25,132.45
1343,26985042,2023-02-03,228.59,361.03999999999996
7311,26985042,2023-02-03,-104.82,256.22
868,26985042,2023-02-09,142.67,398.89
7044,26985042,2023-02-12,-54.1,344.78999999999996
8463,26985042,2023-02-14,124.19,468.98
553,27010847,2023-01-31,,272.04
143,27010847,2023-02-01,-249.75,22.29000000000002
7818,27010847,2023-02-02,126.94,149.23000000000002
2280,27010847,2023-02-02,20.72,169.95000000000002
3778,27010847,2023-02-02,-131.53,38.420000000000016
3663,27010847,2023-02-02,-182.71,-144.29
2876,27010847,2023-02-05,-298.3,-442.59000000000003
8303,27010847,2023-02-07,856.5,413.90999999999997
6231,27010847,2023-02-07,100.4,514.31
1825,27010847,2023-02-08,135.91,650.22
7888,27010847,2023-02-13,-163.33,486.89
701,27010847,2023-02-14,133.67,620.56
3357,27010847,2023-02-14,-97.12,523.4399999999999
554,27108454,2023-01-31,,423.96
6289,27108454,2023-02-02,106.6,530.56
5707,27108454,2023-02-03,15.35,545.91
5449,27108454,2023-02-08,98.0,643.91
909,27108454,2023-02-09,1324.2,1968.1100000000001
4954,27108454,2023-02-14,69.99,2038.1
555,27117946,2023-01-31,,342.03
7843,27117946,2023-02-05,20.31,362.34
2701,27117946,2023-02-07,-135.32,227.01999999999998
866,27117946,2023-02-08,137.97,364.99
2490,27117946,2023-02-13,-91.43,273.55999999999995
556,27170424,2023-01-31,,211.66
5442,27170424,2023-02-04,-150.79,60.870000000000005
5777,27170424,2023-02-09,-111.55,-50.67999999999999
8638,27170424,2023-02-10,140.57,89.89
2324,27170424,2023-02-10,-835.9,-746.01
557,27193025,2023-01-31,,187.57
7213,27193025,2023-02-01,54.7,242.26999999999998
1991,27193025,2023-02-03,19.83,262.1
2900,27193025,2023-02-04,-104.24,157.86
6371,27193025,2023-02-05,118.39,276.25
8568,27193025,2023-02-06,-155.37,120.88
4034,27193025,2023-02-07,-166.29,-45.41
5677,27193025,2023-02-08,67.49,22.08
6269,27193025,2023-02-10,47.75,69.83
2500,27193025,2023-02-10,44.74,114.57
2036,27193025,2023-02-11,56.69,171.26
2054,27193025,2023-02-13,25.57,196.82999999999998
558,27193470,2023-01-31,,479.57
952,27193470,2023-02-02,-68.41,411.15999999999997
7575,27193470,2023-02-03,-82.41,328.75
4820,27193470,2023-02-04,105.89,434.64
7479,27193470,2023-02-06,1486.9,1921.54
8670,27193470,2023-02-06,-78.77,1842.77
3460,27193470,2023-02-07,480.0,2322.77
6337,27193470,2023-02-07,-116.86,2205.91
4058,27193470,2023-02-08,-117.53,2088.38
4642,27193470,2023-02-08,-139.22,1949.1599999999999
3611,27193470,2023-02-09,-118.46,1830.7
4531,27193470,2023-02-12,-142.98,1687.72
559,27203821,2023-01-31,,256.57
2202,27203821,2023-02-03,-866.1,-609.53
8334,27203821,2023-02-07,1679.8,1070.2699999999998
8098,27203821,2023-02-07,152.23,1222.4999999999998
6254,27203821,2023-02-09,-177.2,1045.2999999999997
560,27264533,2023-01-31,,254.28
4115,27264533,2023-02-03,95.29,349.57
1558,27264533,2023-02-07,64.08,413.65
702,27264533,2023-02-08,85.29,498.94
561,27305999,2023-01-31,,17.22
5213,27305999,2023-02-03,-117.17,-99.95
5867,27305999,2023-02-03,-185.02,-284.97
562,27334998,2023-01-31,,817.28
1916,27334998,2023-02-05,100.57,917.8499999999999
751,27334998,2023-02-05,-1.11,916.74
4717,27334998,2023-02-06,99.03,1015.77
4270,27334998,2023-02-07,-170.65,845.1199999999999
5378,27334998,2023-02-08,-130.38,714.74
563,27356852,2023-01-31,,414.82
7101,27356852,2023-02-01,160.76,575.5799999999999
0,27356852,2023-02-01,128.78,704.36
5019,27356852,2023-02-03,-99.42,604.9399999999999
3471,27356852,2023-02-04,381.6,986.54
3299,27356852,2023-02-04,-57.96,928.58
6354,27356852,2023-02-05,-116.94,811.64
5177,27356852,2023-02-10,1271.5,2083.14
6849,27356852,2023-02-12,-41.2,2041.9399999999998
5288,27356852,2023-02-12,-118.8,1923.1399999999999
564,27357010,2023-01-31,,579.29
1092,27357010,2023-02-02,-120.26,459.03
7307,27357010,2023-02-06,90.59,549.62
7307,27357010,2023-02-06,-90.59,459.03
7478,27357010,2023-02-09,101.24,560.27
124,27357010,2023-02-13,48.01,608.28
2896,27357010,2023-02-14,-122.47,485.80999999999995
565,27382109,2023-01-31,,174.95
2226,27382109,2023-02-01,63.48,238.42999999999998
6683,27382109,2023-02-05,-858.4,-619.97
654,27382109,2023-02-07,-45.83,-665.8000000000001
5907,27382109,2023-02-07,-60.4,-726.2
2849,27382109,2023-02-07,-136.09,-862.29
7651,27382109,2023-02-13,1188.4,326.1100000000001
6491,27382109,2023-02-14,-188.72,137.39000000000013
566,27388260,2023-01-31,,39.64
636,27388260,2023-02-04,137.7,177.33999999999997
8551,27388260,2023-02-07,135.14,312.47999999999996
5547,27388260,2023-02-07,-107.54,204.93999999999994
744,27388260,2023-02-08,-107.42,97.51999999999995
8062,27388260,2023-02-09,30.61,128.12999999999994
5501,27388260,2023-02-11,-6.54,121.58999999999995
8040,27388260,2023-02-12,109.89,231.47999999999996
3105,27388260,2023-02-12,49.38,280.85999999999996
5126,27388260,2023-02-14,123.36,404.2199999999999
567,27389680,2023-01-31,,815.68
4272,27389680,2023-02-02,327.6,1143.28
6448,27389680,2023-02-05,18.13,1161.41
3011,27389680,2023-02-08,-57.93,1103.48
7281,27389680,2023-02-08,-156.86,946.6199999999999
1354,27389680,2023-02-14,-82.48,864.14
568,27415805,2023-01-31,,902.28
5307,27415805,2023-02-02,-94.5,807.78
2741,27415805,2023-02-03,43.72,851.5
5411,27415805,2023-02-06,-1107.9,-256.4000000000001
6973,27415805,2023-02-07,36.73,-219.6700000000001
5008,27415805,2023-02-09,125.11,-94.56000000000009
8062,27415805,2023-02-09,-30.61,-125.17000000000009
3123,27415805,2023-02-11,-172.32,-297.49000000000007
569,27430568,2023-01-31,,450.45
3325,27430568,2023-02-01,-100.12,350.33
4246,27430568,2023-02-01,-186.45,163.88
7332,27430568,2023-02-02,-832.5,-668.62
1307,27430568,2023-02-03,173.67,-494.95000000000005
4164,27430568,2023-02-03,-107.8,-602.75
492,27430568,2023-02-06,91.5,-511.25
8587,27430568,2023-02-09,230.97,-280.28000000000003
2993,27430568,2023-02-10,86.27,-194.01000000000005
1155,27430568,2023-02-11,-84.59,-278.6
3554,27430568,2023-02-11,-90.65,-369.25000000000006
1806,27430568,2023-02-12,-1025.1,-1394.35
570,27580272,2023-01-31,,352.81
6041,27580272,2023-02-03,115.75,468.56
5232,27580272,2023-02-07,91.56,560.12
5966,27580272,2023-02-09,-64.46,495.66
571,27582893,2023-01-31,,639.21
8662,27582893,2023-02-02,-98.09,541.12
6738,27582893,2023-02-03,-129.73,411.39000000000004
5088,27582893,2023-02-03,-146.33,265.06000000000006
6490,27582893,2023-02-05,-105.33,159.73000000000002
1553,27582893,2023-02-14,-66.56,93.17000000000003
572,27585212,2023-01-31,,150.57
635,27585212,2023-02-03,-101.07,49.5
2258,27585212,2023-02-08,76.59,126.09
573,27589482,2023-01-31,,494.03
1324,27589482,2023-02-01,129.54,623.5699999999999
5944,27589482,2023-02-04,-24.15,599.42
4941,27589482,2023-02-06,102.35,701.77
6745,27589482,2023-02-09,-129.57,572.1999999999999
4675,27589482,2023-02-13,14.56,586.76
3059,27589482,2023-02-13,-81.27,505.48999999999995
574,27596004,2023-01-31,,505.73
693,27596004,2023-02-01,989.3,1495.03
3573,27596004,2023-02-01,172.77,1667.8
1079,27596004,2023-02-01,36.3,1704.1
5154,27596004,2023-02-06,193.24,1897.34
586,27596004,2023-02-09,-88.16,1809.18
1597,27596004,2023-02-12,-1255.7,553.48
2655,27596004,2023-02-14,0.43,553.91
7687,27596004,2023-02-14,-259.3,294.61
575,27600956,2023-01-31,,84.39
1375,27600956,2023-02-04,33.69,118.08
5606,27600956,2023-02-05,-104.27,13.810000000000002
4693,27600956,2023-02-08,105.35,119.16
234,27600956,2023-02-10,109.1,228.26
241,27600956,2023-02-12,197.29,425.54999999999995
2989,27600956,2023-02-12,16.56,442.10999999999996
7299,27600956,2023-02-12,-1268.1,-825.99
286,27600956,2023-02-14,135.36,-690.63
576,27625709,2023-01-31,,616.45
3904,27625709,2023-02-01,-77.61,538.84
5429,27625709,2023-02-04,-32.88,505.96000000000004
6701,27625709,2023-02-10,-4.42,501.54
2690,27625709,2023-02-11,131.8,633.34
6473,27625709,2023-02-14,128.39,761.73
7386,27625709,2023-02-14,-153.23,608.5
577,27628187,2023-01-31,,344.63
4514,27628187,2023-02-02,-109.57,235.06
704,27628187,2023-02-02,-148.04,87.02000000000001
8176,27628187,2023-02-03,-127.48,-40.459999999999994
6426,27628187,2023-02-07,87.52,47.06
578,27713909,2023-01-31,,199.77
2713,27713909,2023-02-02,79.25,279.02
3056,27713909,2023-02-06,7.07,286.09000000000003
5200,27713909,2023-02-09,1160.0,1446.0900000000001
579,27806002,2023-01-31,,565.08
3952,27806002,2023-02-07,27.75,592.83
7803,27806002,2023-02-08,233.36,826.19
3841,27806002,2023-02-14,-479.9,346.2900000000001
580,27821800,2023-01-31,,322.23
1616,27821800,2023-02-06,-394.5,-72.26999999999998
1110,27821800,2023-02-10,-76.32,-148.58999999999997
6303,27821800,2023-02-13,58.62,-89.96999999999997
366,27821800,2023-02-14,151.02,61.05000000000004
581,27845045,2023-01-31,,136.91
5771,27845045,2023-02-01,80.9,217.81
1773,27845045,2023-02-08,117.08,334.89
5448,27845045,2023-02-14,-130.09,204.8
582,27870202,2023-01-31,,286.17
6304,27870202,2023-02-03,111.04,397.21000000000004
2824,27870202,2023-02-07,1613.2,2010.41
273,27870202,2023-02-08,13.55,2023.96
7257,27870202,2023-02-11,-17.89,2006.0700000000002
5087,27870202,2023-02-14,99.23,2105.3
583,27985160,2023-01-31,,446.21
2952,27985160,2023-02-02,-744.2,-297.99000000000007
2935,27985160,2023-02-08,-132.6,-430.59000000000003
8518,27985160,2023-02-09,107.22,-323.37000000000006
584,28053942,2023-01-31,,70.94
2241,28053942,2023-02-01,-1821.2,-1750.26
8193,28053942,2023-02-02,-132.84,-1883.1
6280,28053942,2023-02-05,-119.28,-2002.38
4795,28053942,2023-02-05,-841.2,-2843.58
2970,28053942,2023-02-06,-75.16,-2918.7400000000002
585,28063272,2023-01-31,,252.41
8155,28063272,2023-02-04,155.57,407.98
8205,28063272,2023-02-06,202.05,610.03
2070,28063272,2023-02-07,194.01,804.04
617,28063272,2023-02-08,967.3,1771.34
2681,28063272,2023-02-08,-125.91,1645.4299999999998
1413,28063272,2023-02-09,-105.86,1539.57
7598,28063272,2023-02-10,149.81,1689.3799999999999
3906,28063272,2023-02-10,-82.97,1606.4099999999999
3078,28063272,2023-02-10,-165.63,1440.78
3784,28063272,2023-02-14,-58.88,1381.8999999999999
586,28142099,2023-01-31,,420.86
5333,28142099,2023-02-10,-1134.6,-713.7399999999999
587,28222331,2023-01-31,,137.74
3053,28222331,2023-02-01,140.1,277.84000000000003
8226,28222331,2023-02-01,102.76,380.6
6136,28222331,2023-02-04,30.36,410.96000000000004
416,28222331,2023-02-04,-67.93,343.03
8227,28222331,2023-02-07,49.81,392.84000000000003
588,28240243,2023-01-31,,850.7
7556,28240243,2023-02-01,-122.07,728.6300000000001
3779,28240243,2023-02-08,-93.01,635.62
3138,28240243,2023-02-13,-175.32,460.30000000000007
589,28247818,2023-01-31,,150.24
8244,28247818,2023-02-01,75.52,225.76
919,28247818,2023-02-05,65.92,291.68
1955,28247818,2023-02-07,126.45,418.13
1419,28247818,2023-02-07,102.9,521.03
1845,28247818,2023-02-09,77.58,598.61
6883,28247818,2023-02-10,-107.08,491.53000000000003
7981,28247818,2023-02-11,65.22,556.75
8215,28247818,2023-02-11,29.76,586.51
3849,28247818,2023-02-12,119.93,706.44
725,28247818,2023-02-12,-67.6,638.84
5148,28247818,2023-02-12,-127.0,511.84000000000003
590,28251857,2023-01-31,,431.6
6770,28251857,2023-02-01,85.99,517.59
2170,28251857,2023-02-02,1501.3,2018.8899999999999
4083,28251857,2023-02-02,-90.38,1928.5100000000002
1774,28251857,2023-02-05,0.49,1929.0
5075,28251857,2023-02-05,-117.78,1811.22
5651,28251857,2023-02-06,180.89,1992.1100000000001
6074,28251857,2023-02-10,20.93,2013.04
1104,28251857,2023-02-10,-104.53,1908.51
591,28254911,2023-01-31,,697.78
900,28254911,2023-02-03,-16.2,681.5799999999999
2775,28254911,2023-02-04,888.9,1570.48
153,28254911,2023-02-06,165.67,1736.1499999999999
2768,28254911,2023-02-06,-131.6,1604.55
4786,28254911,2023-02-07,-139.63,1464.9199999999998
2802,28254911,2023-02-08,90.88,1555.8
5985,28254911,2023-02-09,68.62,1624.4199999999998
2315,28254911,2023-02-11,633.2,2257.62
479,28254911,2023-02-11,-89.22,2168.4
3787,28254911,2023-02-11,-122.35,2046.05
5071,28254911,2023-02-12,92.53,2138.58
2853,28254911,2023-02-12,-147.01,1991.57
4368,28254911,2023-02-14,-118.38,1873.1899999999998
592,28362321,2023-01-31,,849.34
1638,28362321,2023-02-03,-77.07,772.27
2914,28362321,2023-02-05,76.11,848.38
4018,28362321,2023-02-07,59.08,907.46
6950,28362321,2023-02-08,44.34,951.8000000000001
5718,28362321,2023-02-10,849.7,1801.5
1193,28362321,2023-02-10,17.18,1818.68
7243,28362321,2023-02-10,-69.69,1748.9900000000002
6825,28362321,2023-02-12,-614.4,1134.5900000000001
593,28380949,2023-01-31,,937.24
4545,28380949,2023-02-01,-131.58,805.66
4235,28380949,2023-02-04,-58.38,747.28
8341,28380949,2023-02-04,-1412.5,-665.22
4339,28380949,2023-02-05,-141.36,-806.58
8180,28380949,2023-02-07,17.39,-789.19
4237,28380949,2023-02-11,573.2,-215.99
594,28429440,2023-01-31,,538.15
2055,28429440,2023-02-01,-57.95,480.2
6178,28429440,2023-02-03,-85.06,395.14
9,28429440,2023-02-05,-471.4,-76.25999999999999
6283,28429440,2023-02-07,-86.22,-162.48
1798,28429440,2023-02-10,59.31,-103.16999999999999
6908,28429440,2023-02-11,-1096.1,-1199.27
7513,28429440,2023-02-12,180.17,-1019.1
595,28548067,2023-01-31,,499.29
1344,28548067,2023-02-03,32.08,531.37
954,28548067,2023-02-05,100.87,632.24
7304,28548067,2023-02-12,36.02,668.26
596,28553155,2023-01-31,,147.09
4070,28553155,2023-02-01,-131.36,15.72999999999999
1491,28553155,2023-02-03,-106.67,-90.94000000000001
8023,28553155,2023-02-05,134.95,44.00999999999998
8337,28553155,2023-02-08,124.98,168.98999999999998
5215,28553155,2023-02-09,102.41,271.4
5696,28553155,2023-02-10,-76.15,195.24999999999997
4675,28553155,2023-02-13,-14.56,180.68999999999997
4217,28553155,2023-02-14,112.72,293.40999999999997
597,28572979,2023-01-31,,156.38
2178,28572979,2023-02-02,130.23,286.61
5475,28572979,2023-02-02,-190.92,95.69
2537,28572979,2023-02-04,1026.7,1122.39
4806,28572979,2023-02-06,-210.36,912.0300000000001
2201,28572979,2023-02-09,-48.05,863.9800000000001
2138,28572979,2023-02-11,-168.92,695.0600000000002
6990,28572979,2023-02-12,66.4,761.4600000000002
598,28595197,2023-01-31,,897.68
2805,28595197,2023-02-02,68.18,965.8599999999999
2945,28595197,2023-02-03,108.32,1074.1799999999998
1237,28595197,2023-02-04,-809.4,264.78
3763,28595197,2023-02-06,-34.09,230.68999999999997
3122,28595197,2023-02-07,-993.9,-763.21
1351,28595197,2023-02-09,-1606.6,-2369.81
599,28606808,2023-01-31,,1.71
8380,28606808,2023-02-02,-41.88,-40.17
4018,28606808,2023-02-07,-59.08,-99.25
2568,28606808,2023-02-07,-71.01,-170.26
2534,28606808,2023-02-08,957.8,787.54
5406,28606808,2023-02-09,-139.7,647.8399999999999
600,28629966,2023-01-31,,60.86
7215,28629966,2023-02-02,52.11,112.97
2858,28629966,2023-02-03,-55.02,57.949999999999996
1122,28629966,2023-02-04,72.49,130.44
8581,28629966,2023-02-04,8.63,139.07
5197,28629966,2023-02-05,108.31,247.38
6071,28629966,2023-02-07,-186.23,61.14999999999998
114,28629966,2023-02-09,103.88,165.02999999999997
8359,28629966,2023-02-11,-59.3,105.72999999999998
2708,28629966,2023-02-12,98.2,203.92999999999998
191,28629966,2023-02-13,126.46,330.39
5137,28629966,2023-02-13,-148.89,181.5
601,28640713,2023-01-31,,204.33
3716,28640713,2023-02-01,-53.43,150.9
6676,28640713,2023-02-03,-111.46,39.440000000000026
265,28640713,2023-02-05,-128.65,-89.20999999999998
7971,28640713,2023-02-06,157.18,67.97000000000003
8429,28640713,2023-02-06,93.75,161.72000000000003
8513,28640713,2023-02-06,27.94,189.66000000000003
3430,28640713,2023-02-06,-97.36,92.30000000000003
5321,28640713,2023-02-07,9.52,101.82000000000002
1720,28640713,2023-02-09,-86.0,15.820000000000022
2458,28640713,2023-02-13,-117.35,-101.52999999999997
602,28652960,2023-01-31,,140.6
3286,28652960,2023-02-04,134.34,274.94
6517,28652960,2023-02-04,129.92,404.86
7553,28652960,2023-02-06,-91.86,313.0
2795,28652960,2023-02-09,214.76,527.76
7256,28652960,2023-02-09,-116.34,411.41999999999996
5993,28652960,2023-02-10,197.72,609.14
1688,28652960,2023-02-10,-30.02,579.12
3283,28652960,2023-02-11,130.89,710.01
5272,28652960,2023-02-12,66.67,776.68
6133,28652960,2023-02-13,96.41,873.0899999999999
6966,28652960,2023-02-13,-89.23,783.8599999999999
603,28659160,2023-01-31,,115.6
3573,28659160,2023-02-01,-172.77,-57.170000000000016
4272,28659160,2023-02-02,-327.6,-384.77000000000004
2664,28659160,2023-02-06,-134.68,-519.45
2649,28659160,2023-02-07,98.93,-420.52000000000004
604,28680375,2023-01-31,,337.2
4,28680375,2023-02-02,84.65,421.85
8295,28680375,2023-02-13,-25.85,396.0
3473,28680375,2023-02-13,-152.92,243.08
668,28680375,2023-02-14,-106.21,136.87
605,28696496,2023-01-31,,150.57
4149,28696496,2023-02-02,58.23,208.79999999999998
1615,28696496,2023-02-08,-120.55,88.25
6524,28696496,2023-02-09,82.54,170.79000000000002
8186,28696496,2023-02-13,-93.53,77.26
4909,28696496,2023-02-13,-123.86,-46.599999999999994
7481,28696496,2023-02-14,148.05,101.45000000000002
606,28738041,2023-01-31,,907.31
1190,28738041,2023-02-02,-48.35,858.9599999999999
2985,28738041,2023-02-07,1806.9,2665.86
835,28738041,2023-02-09,96.94,2762.8
2810,28738041,2023-02-11,190.18,2952.98
8450,28738041,2023-02-12,-66.05,2886.9300000000003
4980,28738041,2023-02-13,-56.68,2830.25
4945,28738041,2023-02-14,-69.79,2760.46
607,28743137,2023-01-31,,781.13
6761,28743137,2023-02-02,-118.55,662.58
5621,28743137,2023-02-13,111.36,773.94
2509,28743137,2023-02-13,-64.85,709.09
608,28745450,2023-01-31,,157.38
13,28745450,2023-02-01,163.82,321.2
1963,28745450,2023-02-06,-77.81,243.39
4715,28745450,2023-02-09,113.5,356.89
373,28745450,2023-02-09,47.96,404.84999999999997
8278,28745450,2023-02-12,-180.44,224.41
609,28754062,2023-01-31,,16.41
610,28781155,2023-01-31,,555.55
2734,28781155,2023-02-02,99.34,654.89
3996,28781155,2023-02-06,105.25,760.14
5607,28781155,2023-02-10,-67.41,692.73
5053,28781155,2023-02-11,34.81,727.54
1221,28781155,2023-02-11,-109.94,617.5999999999999
611,28811285,2023-01-31,,813.63
1247,28811285,2023-02-03,-227.05,586.5799999999999
8577,28811285,2023-02-04,-86.15,500.42999999999995
5264,28811285,2023-02-08,-110.78,389.65
5745,28811285,2023-02-12,1534.6,1924.25
612,28819175,2023-01-31,,414.48
4414,28819175,2023-02-01,-44.29,370.19
7621,28819175,2023-02-02,20.57,390.76
6571,28819175,2023-02-03,63.29,454.05
4430,28819175,2023-02-06,-178.95,275.1
4455,28819175,2023-02-09,-91.82,183.28000000000003
1266,28819175,2023-02-09,-363.8,-180.51999999999998
2089,28819175,2023-02-11,-155.49,-336.01
613,28822117,2023-01-31,,204.79
5878,28822117,2023-02-01,-98.74,106.05
6369,28822117,2023-02-05,1022.3,1128.35
8276,28822117,2023-02-07,-43.86,1084.49
614,28909144,2023-01-31,,263.97
5429,28909144,2023-02-04,32.88,296.85
8659,28909144,2023-02-04,32.51,329.36
6925,28909144,2023-02-05,-66.8,262.56000000000006
1682,28909144,2023-02-08,165.79,428.35
2631,28909144,2023-02-14,-30.0,398.35
615,28911002,2023-01-31,,858.06
235,28911002,2023-02-01,1139.7,1997.76
3413,28911002,2023-02-02,-137.03,1860.73
6083,28911002,2023-02-06,-122.69,1738.04
6681,28911002,2023-02-11,50.13,1788.17
7723,28911002,2023-02-11,-75.03,1713.1399999999999
616,28969443,2023-01-31,,12.77
145,28969443,2023-02-07,-485.9,-473.13
3267,28969443,2023-02-08,-79.06,-552.19
477,28969443,2023-02-09,29.71,-522.48
1864,28969443,2023-02-14,-111.2,-633.6800000000001
617,28976546,2023-01-31,,454.25
3333,28976546,2023-02-01,-128.83,325.41999999999996
7571,28976546,2023-02-05,59.2,384.62
3957,28976546,2023-02-06,-71.54,313.08
3511,28976546,2023-02-09,-48.6,264.47999999999996
618,29000698,2023-01-31,,954.02
2950,29000698,2023-02-06,-97.54,856.48
5739,29000698,2023-02-07,44.98,901.4599999999999
2166,29000698,2023-02-11,16.59,918.05
5930,29000698,2023-02-12,191.61,1109.66
619,29017229,2023-01-31,,950.07
3820,29017229,2023-02-02,95.2,1045.27
1045,29017229,2023-02-03,179.54,1224.81
5740,29017229,2023-02-03,-183.44,1041.3700000000001
4215,29017229,2023-02-04,1246.9,2288.2700000000004
6801,29017229,2023-02-06,-189.84,2098.4300000000003
5673,29017229,2023-02-14,71.88,2170.3100000000004
620,29039134,2023-01-31,,218.26
4423,29039134,2023-02-05,115.1,333.36
6625,29039134,2023-02-08,245.8,579.16
3272,29039134,2023-02-11,82.76,661.92
5616,29039134,2023-02-12,1411.1,2073.02
3679,29039134,2023-02-12,97.82,2170.84
5508,29039134,2023-02-14,558.8,2729.64
1261,29039134,2023-02-14,104.64,2834.2799999999997
621,29043142,2023-01-31,,210.89
180,29043142,2023-02-09,-110.51,100.37999999999998
8632,29043142,2023-02-11,-114.61,-14.230000000000018
8115,29043142,2023-02-12,67.25,53.01999999999998
5603,29043142,2023-02-12,-141.01,-87.99000000000001
622,29052260,2023-01-31,,639.05
2260,29052260,2023-02-03,132.95,772.0
2039,29052260,2023-02-05,89.52,861.52
3161,29052260,2023-02-10,117.25,978.77
623,29061354,2023-01-31,,180.47
2724,29061354,2023-02-05,2.25,182.72
426,29061354,2023-02-07,92.81,275.53
5270,29061354,2023-02-11,667.1,942.63
7389,29061354,2023-02-11,-54.28,888.35
624,29074095,2023-01-31,,512.38
667,29074095,2023-02-01,86.91,599.29
3871,29074095,2023-02-02,-924.0,-324.71000000000004
826,29074095,2023-02-07,-164.85,-489.56000000000006
7148,29074095,2023-02-11,-87.14,-576.7
4549,29074095,2023-02-12,-110.14,-686.84
2511,29074095,2023-02-13,184.92,-501.9200000000001
2445,29074095,2023-02-13,-65.54,-567.46
625,29222005,2023-01-31,,0.34
4273,29222005,2023-02-03,98.53,98.87
7008,29222005,2023-02-05,-109.63,-10.759999999999991
4856,29222005,2023-02-05,-119.42,-130.18
3102,29222005,2023-02-07,80.36,-49.81999999999999
6461,29222005,2023-02-12,94.0,44.18000000000001
626,29238925,2023-01-31,,574.82
730,29238925,2023-02-04,2.44,577.2600000000001
1968,29238925,2023-02-09,47.07,624.33
6035,29238925,2023-02-11,-887.8,-263.4699999999999
872,29238925,2023-02-14,-956.2,-1219.67
627,29288598,2023-01-31,,386.76
5221,29288598,2023-02-03,201.14,587.9
738,29288598,2023-02-04,-84.15,503.75
2726,29288598,2023-02-06,74.62,578.37
5219,29288598,2023-02-07,109.13,687.5
4498,29288598,2023-02-08,265.04,952.54
5397,29288598,2023-02-11,-142.47,810.0699999999999
4916,29288598,2023-02-13,-137.35,672.72
2127,29288598,2023-02-14,1295.6,1968.32
4042,29288598,2023-02-14,143.6,2111.92
628,29303323,2023-01-31,,525.6
1918,29303323,2023-02-02,-103.75,421.85
6615,29303323,2023-02-02,-143.82,278.03000000000003
1628,29303323,2023-02-03,136.61,414.64000000000004
6233,29303323,2023-02-04,136.51,551.1500000000001
6815,29303323,2023-02-09,1301.5,1852.65
4039,29303323,2023-02-09,-142.5,1710.15
2011,29303323,2023-02-13,185.87,1896.02
3834,29303323,2023-02-13,126.86,2022.88
629,29358670,2023-01-31,,874.94
4157,29358670,2023-02-01,92.86,967.8000000000001
687,29358670,2023-02-06,173.92,1141.72
5040,29358670,2023-02-08,-50.38,1091.34
8022,29358670,2023-02-08,-120.57,970.77
5615,29358670,2023-02-09,105.57,1076.3400000000001
4001,29358670,2023-02-09,-83.38,992.96
7080,29358670,2023-02-11,121.51,1114.47
1008,29358670,2023-02-11,86.69,1201.16
8550,29358670,2023-02-12,-1183.8,17.360000000000127
5778,29358670,2023-02-13,-56.85,-39.489999999999874
630,29422349,2023-01-31,,623.61
6982,29422349,2023-02-08,91.11,714.72
8419,29422349,2023-02-10,144.27,858.99
60,29422349,2023-02-13,-145.83,713.16
631,29464742,2023-01-31,,557.11
552,29464742,2023-02-02,86.31,643.4200000000001
323,29464742,2023-02-07,211.77,855.19
6434,29464742,2023-02-08,-92.83,762.36
5691,29464742,2023-02-14,-147.24,615.12
632,29473763,2023-01-31,,724.82
7347,29473763,2023-02-05,-80.66,644.1600000000001
247,29473763,2023-02-08,144.06,788.22
2565,29473763,2023-02-14,-141.21,647.01
633,29489865,2023-01-31,,854.53
3487,29489865,2023-02-03,-109.66,744.87
327,29489865,2023-02-06,114.3,859.17
8663,29489865,2023-02-10,-169.47,689.7
3790,29489865,2023-02-11,29.25,718.95
5043,29489865,2023-02-11,-82.38,636.5699999999999
5978,29489865,2023-02-14,122.97,759.54
634,29523226,2023-01-31,,807.56
1858,29523226,2023-02-01,102.6,910.16
6938,29523226,2023-02-03,68.85,979.01
3427,29523226,2023-02-03,-48.79,930.2199999999999
2361,29523226,2023-02-05,191.47,1121.69
309,29523226,2023-02-05,-73.99,1047.7
2731,29523226,2023-02-05,-90.06,957.64
1853,29523226,2023-02-06,58.71,1016.3499999999999
6131,29523226,2023-02-06,-134.96,881.3899999999999
1311,29523226,2023-02-08,-83.33,798.06
545,29523226,2023-02-09,254.92,1052.98
5570,29523226,2023-02-10,-83.94,969.04
6129,29523226,2023-02-13,63.08,1032.12
8295,29523226,2023-02-13,25.85,1057.9699999999998
635,29527534,2023-01-31,,355.57
2209,29527534,2023-02-03,-122.97,232.6
5879,29527534,2023-02-04,99.39,331.99
2668,29527534,2023-02-10,-148.63,183.36
3845,29527534,2023-02-11,86.28,269.64
636,29608056,2023-01-31,,248.43
6069,29608056,2023-02-03,61.91,310.34000000000003
6983,29608056,2023-02-03,-105.92,204.42000000000002
3106,29608056,2023-02-06,86.9,291.32
710,29608056,2023-02-06,-115.19,176.13
2699,29608056,2023-02-07,-1610.4,-1434.27
2690,29608056,2023-02-11,-131.8,-1566.07
4413,29608056,2023-02-12,134.36,-1431.71
1954,29608056,2023-02-12,126.97,-1304.74
838,29608056,2023-02-12,96.87,-1207.87
5666,29608056,2023-02-12,51.66,-1156.21
637,29631870,2023-01-31,,694.99
6460,29631870,2023-02-02,1138.0,1832.99
8105,29631870,2023-02-02,78.61,1911.6
4596,29631870,2023-02-04,68.54,1980.14
1668,29631870,2023-02-04,-74.21,1905.93
8065,29631870,2023-02-12,113.45,2019.38
5122,29631870,2023-02-14,-90.07,1929.31
638,29638033,2023-01-31,,537.95
2472,29638033,2023-02-01,-129.52,408.43000000000006
3596,29638033,2023-02-01,-1775.6,-1367.1699999999998
7558,29638033,2023-02-02,-1890.0,-3257.17
4244,29638033,2023-02-03,-103.79,-3360.96
5895,29638033,2023-02-08,-40.08,-3401.04
5370,29638033,2023-02-11,-89.5,-3490.54
2535,29638033,2023-02-12,122.32,-3368.22
5541,29638033,2023-02-14,-134.42,-3502.64
639,29639626,2023-01-31,,985.7
4868,29639626,2023-02-04,-112.65,873.0500000000001
3486,29639626,2023-02-05,135.88,1008.9300000000001
6152,29639626,2023-02-06,-58.79,950.14
3618,29639626,2023-02-10,103.67,1053.81
5152,29639626,2023-02-10,-15.25,1038.56
2454,29639626,2023-02-13,41.85,1080.41
1709,29639626,2023-02-13,-163.71,916.7
640,29705419,2023-01-31,,799.07
453,29705419,2023-02-02,89.88,888.95
5580,29705419,2023-02-03,62.89,951.84
2198,29705419,2023-02-03,-749.7,202.14
4953,29705419,2023-02-06,149.08,351.22
5722,29705419,2023-02-08,133.54,484.76
6809,29705419,2023-02-09,-99.59,385.16999999999996
3942,29705419,2023-02-13,-105.96,279.21
641,29878790,2023-01-31,,360.74
5470,29878790,2023-02-13,-94.19,266.55
642,29887258,2023-01-31,,392.91
4122,29887258,2023-02-05,103.8,496.71000000000004
5416,29887258,2023-02-08,-17.63,479.08000000000004
2440,29887258,2023-02-13,-157.09,321.99
4913,29887258,2023-02-14,175.07,497.06
2896,29887258,2023-02-14,122.47,619.53
643,29920698,2023-01-31,,922.07
883,29920698,2023-02-02,-108.09,813.98
4864,29920698,2023-02-04,47.33,861.3100000000001
5109,29920698,2023-02-04,45.53,906.84
2964,29920698,2023-02-05,-1475.4,-568.5600000000001
110,29920698,2023-02-08,77.84,-490.72
2186,29920698,2023-02-13,86.2,-404.52000000000004
644,29958061,2023-01-31,,17.43
7303,29958061,2023-02-01,93.28,110.71000000000001
5827,29958061,2023-02-02,103.39,214.10000000000002
6714,29958061,2023-02-02,-28.3,185.8
4606,29958061,2023-02-03,167.61,353.41
5170,29958061,2023-02-04,115.56,468.97
7616,29958061,2023-02-07,183.11,652.08
935,29958061,2023-02-08,-104.32,547.76
6825,29958061,2023-02-12,614.4,1162.16
645,30030650,2023-01-31,,414.27
7269,30030650,2023-02-06,96.15,510.41999999999996
6587,30030650,2023-02-07,-99.74,410.68
56,30030650,2023-02-08,140.45,551.13
3464,30030650,2023-02-08,79.57,630.7
4989,30030650,2023-02-13,-23.8,606.9
646,30058030,2023-01-31,,39.21
2805,30058030,2023-02-02,-68.18,-28.970000000000006
2861,30058030,2023-02-03,106.54,77.57
4297,30058030,2023-02-12,89.64,167.21
7004,30058030,2023-02-12,37.7,204.91000000000003
5869,30058030,2023-02-14,69.27,274.18
3723,30058030,2023-02-14,-823.0,-548.8199999999999
647,30093672,2023-01-31,,939.77
2614,30093672,2023-02-04,121.83,1061.6
5262,30093672,2023-02-05,62.74,1124.34
3763,30093672,2023-02-06,34.09,1158.43
3182,30093672,2023-02-06,-79.32,1079.11
8448,30093672,2023-02-08,-1002.0,77.11000000000001
1974,30093672,2023-02-09,7.12,84.23000000000002
1326,30093672,2023-02-10,-142.07,-57.839999999999975
7155,30093672,2023-02-11,108.41,50.57000000000002
7678,30093672,2023-02-12,-129.0,-78.42999999999998
648,30110747,2023-01-31,,949.76
6320,30110747,2023-02-01,98.39,1048.15
4519,30110747,2023-02-03,-158.58,889.5699999999999
1937,30110747,2023-02-03,-225.89,663.6800000000001
841,30110747,2023-02-06,70.1,733.78
7831,30110747,2023-02-07,69.34,803.12
1639,30110747,2023-02-10,-37.83,765.29
42,30110747,2023-02-13,143.14,908.4300000000001
649,30112323,2023-01-31,,519.73
3617,30112323,2023-02-01,99.68,619.4100000000001
1909,30112323,2023-02-01,38.91,658.32
6239,30112323,2023-02-01,-12.31,646.01
6122,30112323,2023-02-04,-136.46,509.55
8509,30112323,2023-02-07,-27.47,482.08000000000004
6262,30112323,2023-02-08,-1379.8,-897.7199999999999
8496,30112323,2023-02-09,1504.7,606.9800000000001
7193,30112323,2023-02-14,-117.3,489.6800000000001
650,30196319,2023-01-31,,721.4
5544,30196319,2023-02-01,-32.39,689.01
645,30196319,2023-02-06,125.2,814.21
1399,30196319,2023-02-09,-118.21,696.0
5937,30196319,2023-02-10,-95.98,600.02
651,30227774,2023-01-31,,546.85
504,30227774,2023-02-01,-99.3,447.55
606,30227774,2023-02-05,46.86,494.41
6336,30227774,2023-02-09,89.75,584.1600000000001
4887,30227774,2023-02-11,-146.03,438.13
652,30235398,2023-01-31,,973.95
7550,30235398,2023-02-02,54.94,1028.89
5003,30235398,2023-02-02,-122.38,906.51
6129,30235398,2023-02-13,-63.08,843.4300000000001
653,30237685,2023-01-31,,751.93
8425,30237685,2023-02-06,-189.18,562.75
6889,30237685,2023-02-10,831.4,1394.1499999999999
390,30237685,2023-02-12,95.25,1489.3999999999999
654,30279114,2023-01-31,,951.13
4140,30279114,2023-02-01,144.31,1095.44
1085,30279114,2023-02-02,-231.9,863.54
4261,30279114,2023-02-08,-66.97,796.5699999999999
3905,30279114,2023-02-09,-210.8,585.77
655,30312615,2023-01-31,,659.36
2638,30312615,2023-02-05,-1852.7,-1193.3400000000001
2375,30312615,2023-02-06,77.23,-1116.11
6511,30312615,2023-02-07,-116.04,-1232.1499999999999
8141,30312615,2023-02-12,443.1,-789.05
747,30312615,2023-02-12,-158.57,-947.6199999999999
7057,30312615,2023-02-13,-136.9,-1084.52
656,30324819,2023-01-31,,823.45
7242,30324819,2023-02-02,469.3,1292.75
6279,30324819,2023-02-03,157.15,1449.9
3687,30324819,2023-02-05,-130.7,1319.2
5851,30324819,2023-02-05,-141.51,1177.69
657,30340808,2023-01-31,,895.41
7295,30340808,2023-02-03,-123.39,772.02
2564,30340808,2023-02-06,-64.83,707.1899999999999
1526,30340808,2023-02-07,-121.9,585.29
5705,30340808,2023-02-14,-1660.2,-1074.91
658,30372316,2023-01-31,,189.39
5048,30372316,2023-02-02,-179.4,9.98999999999998
138,30372316,2023-02-08,151.99,161.98
3443,30372316,2023-02-08,-78.98,82.99999999999999
897,30372316,2023-02-09,1216.6,1299.6
2755,30372316,2023-02-09,-953.9,345.69999999999993
8088,30372316,2023-02-11,40.81,386.50999999999993
2291,30372316,2023-02-13,-102.23,284.2799999999999
2655,30372316,2023-02-14,-0.43,283.8499999999999
659,30374840,2023-01-31,,564.42
1618,30374840,2023-02-03,-96.42,467.99999999999994
1759,30374840,2023-02-03,-1278.2,-810.2
348,30374840,2023-02-07,204.81,-605.3900000000001
4005,30374840,2023-02-07,143.62,-461.77000000000004
3297,30374840,2023-02-08,107.7,-354.07000000000005
3356,30374840,2023-02-08,-38.13,-392.20000000000005
204,30374840,2023-02-10,-1585.0,-1977.2
660,30396291,2023-01-31,,803.37
1957,30396291,2023-02-03,199.09,1002.46
8067,30396291,2023-02-03,-610.8,391.6600000000001
5263,30396291,2023-02-06,-99.42,292.24000000000007
677,30396291,2023-02-06,-100.05,192.19000000000008
661,30409599,2023-01-31,,117.47
5586,30409599,2023-02-03,174.62,292.09000000000003
4101,30409599,2023-02-05,51.26,343.35
6811,30409599,2023-02-07,180.63,523.98
1264,30409599,2023-02-08,109.72,633.7
5699,30409599,2023-02-10,-28.25,605.45
1683,30409599,2023-02-14,867.5,1472.95
662,30428666,2023-01-31,,393.33
3070,30428666,2023-02-04,-150.02,243.30999999999997
5292,30428666,2023-02-05,-29.05,214.25999999999996
1427,30428666,2023-02-07,-66.67,147.58999999999997
4266,30428666,2023-02-11,40.71,188.29999999999998
663,30484027,2023-01-31,,272.71
5749,30484027,2023-02-01,127.65,400.36
6376,30484027,2023-02-03,-116.69,283.66999999999996
582,30484027,2023-02-05,78.67,362.34
6365,30484027,2023-02-09,-10.45,351.89
6321,30484027,2023-02-12,-76.6,275.28999999999996
1334,30484027,2023-02-12,-127.83,147.45999999999998
664,30511779,2023-01-31,,772.02
7450,30511779,2023-02-02,179.94,951.96
2933,30511779,2023-02-07,71.18,1023.14
4251,30511779,2023-02-08,106.87,1130.01
5607,30511779,2023-02-10,67.41,1197.42
4595,30511779,2023-02-11,114.77,1312.19
6501,30511779,2023-02-11,58.01,1370.2
665,30518350,2023-01-31,,490.85
210,30518350,2023-02-06,1498.3,1989.15
7474,30518350,2023-02-11,-19.24,1969.9099999999999
666,30557885,2023-01-31,,615.82
6568,30557885,2023-02-05,-678.7,-62.879999999999995
667,30565855,2023-01-31,,982.05
662,30565855,2023-02-05,1292.8,2274.85
1359,30565855,2023-02-09,-51.68,2223.17
4700,30565855,2023-02-11,-121.33,2101.84
2463,30565855,2023-02-13,70.54,2172.38
5196,30565855,2023-02-14,483.2,2655.58
668,30623117,2023-01-31,,266.92
2587,30623117,2023-02-04,-125.73,141.19
8465,30623117,2023-02-09,-1169.4,-1028.21
1357,30623117,2023-02-11,-38.74,-1066.95
5016,30623117,2023-02-11,-111.11,-1178.06
3509,30623117,2023-02-14,154.58,-1023.48
8041,30623117,2023-02-14,77.33,-946.15
6017,30623117,2023-02-14,-159.03,-1105.18
669,30647433,2023-01-31,,632.2
4087,30647433,2023-02-02,-224.91,407.2900000000001
8378,30647433,2023-02-03,-474.7,-67.40999999999997
7360,30647433,2023-02-04,-15.32,-82.72999999999996
7706,30647433,2023-02-05,-100.81,-183.53999999999996
36,30647433,2023-02-07,80.19,-103.34999999999997
5358,30647433,2023-02-07,-39.09,-142.43999999999997
1378,30647433,2023-02-10,104.39,-38.04999999999997
670,30657838,2023-01-31,,468.82
2057,30657838,2023-02-01,2239.3,2708.1200000000003
6273,30657838,2023-02-01,-91.95,2616.1700000000005
2834,30657838,2023-02-03,-139.16,2477.01
2273,30657838,2023-02-04,124.06,2601.07
163,30657838,2023-02-05,539.8,3140.8700000000003
991,30657838,2023-02-05,-161.8,2979.07
6410,30657838,2023-02-06,90.98,3070.05
6134,30657838,2023-02-06,-52.94,3017.11
1433,30657838,2023-02-08,84.11,3101.2200000000003
6573,30657838,2023-02-09,69.33,3170.55
6798,30657838,2023-02-11,152.76,3323.3100000000004
671,30671754,2023-01-31,,621.9
6143,30671754,2023-02-04,-133.3,488.59999999999997
8407,30671754,2023-02-07,5.07,493.66999999999996
672,30672740,2023-01-31,,355.33
4766,30672740,2023-02-02,187.4,542.73
4977,30672740,2023-02-06,126.49,669.22
6139,30672740,2023-02-07,46.51,715.73
5772,30672740,2023-02-11,1949.6,2665.33
4991,30672740,2023-02-13,-106.6,2558.73
673,30688447,2023-01-31,,555.31
4429,30688447,2023-02-03,-137.98,417.3299999999999
4456,30688447,2023-02-05,-160.67,256.65999999999997
5590,30688447,2023-02-06,81.99,338.65
5101,30688447,2023-02-10,-162.32,176.32999999999998
4200,30688447,2023-02-14,-101.76,74.56999999999998
674,30718836,2023-01-31,,360.78
4738,30718836,2023-02-01,186.89,547.67
3574,30718836,2023-02-01,-76.9,470.77
3633,30718836,2023-02-03,-133.1,337.66999999999996
8556,30718836,2023-02-04,58.09,395.76
7856,30718836,2023-02-06,-110.26,285.49999999999994
7966,30718836,2023-02-07,-16.27,269.22999999999996
7593,30718836,2023-02-08,-1127.4,-858.1700000000001
1359,30718836,2023-02-09,51.68,-806.4900000000001
2290,30718836,2023-02-11,64.55,-741.94
8474,30718836,2023-02-13,-75.16,-817.1000000000001
675,30723991,2023-01-31,,310.02
3174,30723991,2023-02-02,86.69,396.71
3318,30723991,2023-02-03,138.68,535.39
3628,30723991,2023-02-07,-95.78,439.61
676,30758515,2023-01-31,,35.74
2676,30758515,2023-02-01,102.39,138.13
2343,30758515,2023-02-02,61.09,199.22000000000003
637,30758515,2023-02-13,183.43,382.65000000000003
677,30760024,2023-01-31,,766.43
2150,30760024,2023-02-02,-77.14,689.29
1421,30760024,2023-02-03,-38.61,650.68
1245,30760024,2023-02-09,83.26,733.9399999999999
678,30791105,2023-01-31,,272.5
2589,30791105,2023-02-02,192.77,465.27
3523,30791105,2023-02-04,-113.62,351.65
2953,30791105,2023-02-06,102.01,453.66
5355,30791105,2023-02-06,-112.33,341.33000000000004
16,30791105,2023-02-10,179.95,521.28
2927,30791105,2023-02-11,107.01,628.29
679,30929422,2023-01-31,,161.53
8034,30929422,2023-02-01,-120.93,40.599999999999994
7596,30929422,2023-02-01,-159.64,-119.03999999999999
1530,30929422,2023-02-07,82.91,-36.129999999999995
6793,30929422,2023-02-08,-23.59,-59.72
1061,30929422,2023-02-08,-113.42,-173.14
3947,30929422,2023-02-11,-38.37,-211.51
73,30929422,2023-02-12,-76.48,-287.99
1784,30929422,2023-02-13,-113.91,-401.9
680,30970897,2023-01-31,,57.17
6509,30970897,2023-02-01,-141.6,-84.42999999999999
1813,30970897,2023-02-03,-110.54,-194.97
279,30970897,2023-02-03,-115.62,-310.59000000000003
6060,30970897,2023-02-04,-116.66,-427.25
27,30970897,2023-02-05,201.75,-225.5
567,30970897,2023-02-07,-141.27,-366.77
7227,30970897,2023-02-09,-113.36,-480.13
4427,30970897,2023-02-09,-157.3,-637.4300000000001
970,30970897,2023-02-12,27.9,-609.53
1689,30970897,2023-02-13,100.5,-509.03
681,30977834,2023-01-31,,203.99
6641,30977834,2023-02-02,175.73,379.72
3083,30977834,2023-02-04,686.5,1066.22
113,30977834,2023-02-04,-175.99,890.23
1214,30977834,2023-02-05,-35.3,854.9300000000001
2658,30977834,2023-02-07,-86.46,768.47
8467,30977834,2023-02-07,-87.82,680.6500000000001
8089,30977834,2023-02-10,67.29,747.94
5250,30977834,2023-02-12,45.23,793.1700000000001
682,30979429,2023-01-31,,414.1
6971,30979429,2023-02-01,-70.34,343.76
4407,30979429,2023-02-02,-865.4,-521.64
2202,30979429,2023-02-03,866.1,344.46000000000004
5606,30979429,2023-02-05,104.27,448.73
2327,30979429,2023-02-09,-160.06,288.67
2837,30979429,2023-02-11,35.07,323.74
7696,30979429,2023-02-12,-78.65,245.09
683,30990911,2023-01-31,,997.59
6421,30990911,2023-02-02,-144.05,853.54
1082,30990911,2023-02-04,170.56,1024.1
2245,30990911,2023-02-04,-173.9,850.2
5057,30990911,2023-02-07,-124.86,725.34
5478,30990911,2023-02-08,132.2,857.54
6594,30990911,2023-02-11,-106.4,751.14
684,31026801,2023-01-31,,85.36
686,31026801,2023-02-01,52.99,138.35
483,31026801,2023-02-06,-99.14,39.21000000000001
7460,31026801,2023-02-07,-102.26,-63.05
4163,31026801,2023-02-08,-47.58,-110.63
4619,31026801,2023-02-11,-62.33,-172.95999999999998
685,31131351,2023-01-31,,278.94
1389,31131351,2023-02-04,786.1,1065.04
3948,31131351,2023-02-04,262.0,1327.04
8566,31131351,2023-02-04,98.42,1425.46
2784,31131351,2023-02-06,29.95,1455.41
3620,31131351,2023-02-06,-1124.1,331.3100000000002
6585,31131351,2023-02-08,104.01,435.32000000000016
3989,31131351,2023-02-09,-158.52,276.8000000000002
1584,31131351,2023-02-12,-224.14,52.660000000000196
686,31150830,2023-01-31,,36.16
763,31150830,2023-02-01,-161.85,-125.69
35,31150830,2023-02-02,128.71,3.0200000000000102
6446,31150830,2023-02-02,126.12,129.14000000000001
5466,31150830,2023-02-05,-61.68,67.46000000000001
7772,31150830,2023-02-06,52.31,119.77000000000001
2414,31150830,2023-02-07,-435.8,-316.03
2059,31150830,2023-02-09,-55.88,-371.91
8585,31150830,2023-02-09,-70.29,-442.20000000000005
3833,31150830,2023-02-11,-84.45,-526.6500000000001
687,31158381,2023-01-31,,514.96
2139,31158381,2023-02-01,223.94,738.9000000000001
1942,31158381,2023-02-01,139.18,878.08
5665,31158381,2023-02-07,80.94,959.02
2159,31158381,2023-02-08,-132.45,826.57
8666,31158381,2023-02-13,-131.36,695.21
688,31183587,2023-01-31,,725.0
4532,31183587,2023-02-02,-36.32,688.68
1766,31183587,2023-02-03,-19.31,669.37
4280,31183587,2023-02-05,1152.5,1821.87
7531,31183587,2023-02-08,-952.0,869.8699999999999
5984,31183587,2023-02-12,221.72,1091.59
7698,31183587,2023-02-12,112.63,1204.2199999999998
425,31183587,2023-02-13,-76.49,1127.7299999999998
1459,31183587,2023-02-13,-117.77,1009.9599999999999
689,31187024,2023-01-31,,950.41
2771,31187024,2023-02-02,-105.52,844.89
828,31187024,2023-02-03,-49.39,795.5
2261,31187024,2023-02-04,-125.25,670.25
3829,31187024,2023-02-06,154.42,824.67
7964,31187024,2023-02-08,71.81,896.48
7177,31187024,2023-02-08,-537.9,358.5799999999999
2000,31187024,2023-02-10,782.2,1140.78
4875,31187024,2023-02-10,-163.18,977.5999999999999
690,31263913,2023-01-31,,267.5
421,31263913,2023-02-01,-48.78,218.72
6959,31263913,2023-02-02,-133.38,85.34
6892,31263913,2023-02-06,84.46,169.8
691,31319183,2023-01-31,,407.92
5813,31319183,2023-02-06,-95.11,312.81
4064,31319183,2023-02-08,58.82,371.63
1379,31319183,2023-02-09,-151.22,220.41000000000003
2379,31319183,2023-02-10,60.41,280.82000000000005
7636,31319183,2023-02-12,104.9,385.72
3414,31319183,2023-02-12,-63.33,322.39000000000004
4520,31319183,2023-02-13,126.66,449.05
692,31335654,2023-01-31,,217.33
4760,31335654,2023-02-02,125.99,343.32
6182,31335654,2023-02-07,146.82,490.14
5426,31335654,2023-02-10,88.62,578.76
2944,31335654,2023-02-10,87.63,666.39
8540,31335654,2023-02-12,1192.7,1859.0900000000001
693,31367758,2023-01-31,,536.16
169,31367758,2023-02-01,89.01,625.17
2173,31367758,2023-02-08,96.58,721.75
2324,31367758,2023-02-10,835.9,1557.65
3470,31367758,2023-02-13,107.55,1665.2
694,31392168,2023-01-31,,615.42
4709,31392168,2023-02-05,-177.67,437.75
7000,31392168,2023-02-08,170.98,608.73
1975,31392168,2023-02-10,143.84,752.5699999999999
2968,31392168,2023-02-13,44.2,796.77
695,31525756,2023-01-31,,363.68
5748,31525756,2023-02-01,81.02,444.7
2040,31525756,2023-02-07,146.76,591.46
943,31525756,2023-02-12,-128.32,463.14
2454,31525756,2023-02-13,-41.85,421.28999999999996
225,31525756,2023-02-13,-75.56,345.73
696,31537778,2023-01-31,,335.19
3433,31537778,2023-02-01,-36.43,298.76
6223,31537778,2023-02-14,118.75,417.51
697,31541158,2023-01-31,,215.94
3108,31541158,2023-02-07,-107.79,108.14999999999999
990,31541158,2023-02-09,120.47,228.62
4158,31541158,2023-02-09,73.6,302.21999999999997
8523,31541158,2023-02-13,-110.17,192.04999999999998
698,31557275,2023-01-31,,362.05
1202,31557275,2023-02-02,-162.35,199.70000000000002
74,31557275,2023-02-05,-63.32,136.38000000000002
930,31557275,2023-02-09,86.86,223.24
6217,31557275,2023-02-11,-166.3,56.94
7396,31557275,2023-02-14,59.81,116.75
699,31589468,2023-01-31,,713.44
626,31589468,2023-02-01,-78.07,635.3700000000001
1189,31589468,2023-02-01,-807.2,-171.82999999999993
523,31589468,2023-02-03,117.46,-54.36999999999993
3458,31589468,2023-02-10,142.13,87.76000000000006
3107,31589468,2023-02-14,-77.69,10.070000000000064
700,31594938,2023-01-31,,486.88
8405,31594938,2023-02-02,-72.9,413.98
7320,31594938,2023-02-02,-206.91,207.07
2031,31594938,2023-02-03,49.54,256.61
5737,31594938,2023-02-05,230.5,487.11
8189,31594938,2023-02-06,-77.22,409.89
8530,31594938,2023-02-06,-131.96,277.92999999999995
1805,31594938,2023-02-10,-47.87,230.05999999999997
4406,31594938,2023-02-14,-90.86,139.2
701,31595213,2023-01-31,,418.35
7951,31595213,2023-02-02,184.44,602.79
1293,31595213,2023-02-03,-110.43,492.36
1397,31595213,2023-02-04,128.21,620.57
5828,31595213,2023-02-10,80.77,701.34
7201,31595213,2023-02-12,-122.61,578.73
7594,31595213,2023-02-14,172.38,751.11
702,31661113,2023-01-31,,309.32
2286,31661113,2023-02-02,68.17,377.49
3714,31661113,2023-02-10,102.92,480.40999999999997
2671,31661113,2023-02-10,11.31,491.71999999999997
8123,31661113,2023-02-13,16.59,508.31
703,31670977,2023-01-31,,385.42
4744,31670977,2023-02-02,-1520.8,-1135.3799999999999
6143,31670977,2023-02-04,133.3,-1002.0799999999999
561,31670977,2023-02-08,10.05,-992.0299999999999
6528,31670977,2023-02-14,-87.61,-1079.6399999999999
704,31680976,2023-01-31,,327.79
1168,31680976,2023-02-01,-82.09,245.70000000000002
2257,31680976,2023-02-05,-65.73,179.97000000000003
2612,31680976,2023-02-06,470.6,650.57
589,31680976,2023-02-08,362.6,1013.1700000000001
2032,31680976,2023-02-10,-69.68,943.49
6459,31680976,2023-02-10,-115.98,827.5100000000001
758,31680976,2023-02-11,-1125.0,-297.4899999999999
4901,31680976,2023-02-14,149.9,-147.5899999999999
705,31689747,2023-01-31,,907.21
1156,31689747,2023-02-01,104.57,1011.78
7459,31689747,2023-02-02,-177.5,834.28
4910,31689747,2023-02-04,89.19,923.47
5279,31689747,2023-02-04,19.13,942.6
4053,31689747,2023-02-04,-41.77,900.83
5274,31689747,2023-02-06,-101.84,798.99
6209,31689747,2023-02-07,-107.26,691.73
5460,31689747,2023-02-09,171.71,863.44
706,31693244,2023-01-31,,311.41
7443,31693244,2023-02-02,-145.85,165.56000000000003
264,31693244,2023-02-03,49.16,214.72000000000003
3206,31693244,2023-02-08,-96.95,117.77000000000002
149,31693244,2023-02-08,-710.3,-592.53
3749,31693244,2023-02-10,81.43,-511.09999999999997
1429,31693244,2023-02-13,-126.46,-637.56
1635,31693244,2023-02-13,-155.44,-793.0
2877,31693244,2023-02-14,-73.36,-866.3599999999999
707,31759645,2023-01-31,,43.92
4210,31759645,2023-02-01,162.02,205.94
4617,31759645,2023-02-02,-482.7,-276.75999999999993
6467,31759645,2023-02-04,-104.15,-380.90999999999997
2444,31759645,2023-02-06,123.09,-257.81999999999994
857,31759645,2023-02-06,57.88,-199.93999999999994
2402,31759645,2023-02-07,-169.21,-369.15
3267,31759645,2023-02-08,79.06,-290.0899999999999
1821,31759645,2023-02-08,-163.97,-454.05999999999995
4803,31759645,2023-02-09,-33.72,-487.78
5829,31759645,2023-02-09,-110.83,-598.6099999999999
3499,31759645,2023-02-10,-150.77,-749.3799999999999
708,31770323,2023-01-31,,666.66
4925,31770323,2023-02-07,-74.35,592.31
7149,31770323,2023-02-07,-1002.5,-410.19000000000005
4578,31770323,2023-02-11,60.05,-350.14000000000004
4852,31770323,2023-02-12,147.45,-202.69000000000005
4654,31770323,2023-02-12,73.94,-128.75000000000006
8122,31770323,2023-02-13,109.06,-19.690000000000055
2596,31770323,2023-02-13,-181.51,-201.20000000000005
709,31774984,2023-01-31,,964.57
7928,31774984,2023-02-01,127.57,1092.14
8421,31774984,2023-02-04,121.49,1213.63
1297,31774984,2023-02-08,164.7,1378.33
2275,31774984,2023-02-09,127.38,1505.71
260,31774984,2023-02-09,-139.86,1365.85
8579,31774984,2023-02-11,139.2,1505.05
710,31826534,2023-01-31,,541.64
4576,31826534,2023-02-02,-95.44,446.2
2041,31826534,2023-02-07,155.12,601.3199999999999
6248,31826534,2023-02-10,-104.86,496.46
7458,31826534,2023-02-11,-85.0,411.46
6991,31826534,2023-02-14,615.6,1027.06
711,31830289,2023-01-31,,816.55
4414,31830289,2023-02-01,44.29,860.8399999999999
4451,31830289,2023-02-06,-154.47,706.3699999999999
7907,31830289,2023-02-14,201.77,908.14
712,31873155,2023-01-31,,351.03
10,31873155,2023-02-02,27.44,378.46999999999997
12,31873155,2023-02-02,-123.2,255.26999999999998
5518,31873155,2023-02-04,214.78,470.04999999999995
1244,31873155,2023-02-06,-107.54,362.50999999999993
1321,31873155,2023-02-08,-176.94,185.56999999999994
7609,31873155,2023-02-11,111.88,297.44999999999993
121,31873155,2023-02-12,-9.9,287.54999999999995
713,31957459,2023-01-31,,758.69
1257,31957459,2023-02-01,98.52,857.21
4933,31957459,2023-02-03,89.23,946.44
4756,31957459,2023-02-03,67.03,1013.47
522,31957459,2023-02-03,-113.46,900.0100000000001
4634,31957459,2023-02-06,-104.66,795.35
3636,31957459,2023-02-08,10.58,805.9300000000001
6544,31957459,2023-02-08,-92.54,713.3900000000001
8350,31957459,2023-02-10,-97.29,616.1
714,31978646,2023-01-31,,393.51
5656,31978646,2023-02-05,-172.62,220.89
8425,31978646,2023-02-06,189.18,410.07
1848,31978646,2023-02-09,-50.02,360.05
3230,31978646,2023-02-10,89.99,450.03999999999996
1488,31978646,2023-02-11,112.56,562.6
715,32019304,2023-01-31,,961.49
2878,32019304,2023-02-01,156.79,1118.28
6805,32019304,2023-02-01,-200.4,917.88
7683,32019304,2023-02-02,109.57,1027.45
7457,32019304,2023-02-08,83.96,1111.41
1140,32019304,2023-02-10,32.99,1144.4
1835,32019304,2023-02-11,-109.66,1034.74
7052,32019304,2023-02-13,98.9,1133.6399999999999
716,32084810,2023-01-31,,610.7
660,32084810,2023-02-02,-167.22,443.48
5319,32084810,2023-02-03,-124.8,318.68000000000006
2131,32084810,2023-02-05,-23.02,295.66
8316,32084810,2023-02-06,-16.67,278.99000000000007
2369,32084810,2023-02-08,-67.6,211.39000000000004
7294,32084810,2023-02-12,-67.02,144.37000000000006
717,32092491,2023-01-31,,51.82
4627,32092491,2023-02-01,126.01,177.83
5269,32092491,2023-02-02,101.15,278.98
579,32092491,2023-02-03,48.48,327.46
6071,32092491,2023-02-07,186.23,513.69
1337,32092491,2023-02-09,65.15,578.84
7854,32092491,2023-02-10,400.1,978.94
2628,32092491,2023-02-14,-137.92,841.0200000000001
674,32092491,2023-02-14,-349.1,491.9200000000001
2782,32092491,2023-02-14,-1401.8,-909.8799999999999
718,32109414,2023-01-31,,967.31
4009,32109414,2023-02-01,116.27,1083.58
8152,32109414,2023-02-05,-119.48,964.0999999999999
130,32109414,2023-02-12,62.68,1026.78
8122,32109414,2023-02-13,-109.06,917.7199999999999
719,32131123,2023-01-31,,758.69
1631,32131123,2023-02-04,16.51,775.2
8539,32131123,2023-02-10,-96.17,679.0300000000001
3237,32131123,2023-02-11,-132.94,546.09
720,32192958,2023-01-31,,209.37
1956,32192958,2023-02-02,157.41,366.78
440,32192958,2023-02-05,1625.6,1992.3799999999999
6153,32192958,2023-02-05,-139.75,1852.6299999999999
8276,32192958,2023-02-07,43.86,1896.4899999999998
1105,32192958,2023-02-11,148.04,2044.5299999999997
4074,32192958,2023-02-13,-52.19,1992.34
155,32192958,2023-02-13,-1132.5,859.8399999999999
721,32221529,2023-01-31,,887.75
2693,32221529,2023-02-06,120.6,1008.35
819,32221529,2023-02-06,114.11,1122.46
933,32221529,2023-02-07,120.64,1243.1
3950,32221529,2023-02-08,-48.19,1194.91
355,32221529,2023-02-10,108.57,1303.48
1044,32221529,2023-02-11,45.67,1349.15
2291,32221529,2023-02-13,102.23,1451.38
7454,32221529,2023-02-13,-70.3,1381.08
722,32221652,2023-01-31,,36.96
714,32221652,2023-02-01,-1089.6,-1052.6399999999999
1291,32221652,2023-02-01,-1820.3,-2872.9399999999996
734,32221652,2023-02-06,32.37,-2840.5699999999997
5339,32221652,2023-02-06,-92.29,-2932.8599999999997
5940,32221652,2023-02-07,591.2,-2341.66
2157,32221652,2023-02-08,-178.49,-2520.1499999999996
723,32261620,2023-01-31,,55.43
8392,32261620,2023-02-01,787.2,842.63
5048,32261620,2023-02-02,179.4,1022.03
7672,32261620,2023-02-02,91.97,1114.0
7042,32261620,2023-02-03,126.64,1240.64
161,32261620,2023-02-11,143.78,1384.42
5414,32261620,2023-02-13,-151.84,1232.58
5361,32261620,2023-02-13,-157.9,1074.68
724,32275676,2023-01-31,,889.61
8229,32275676,2023-02-03,70.29,959.9
8211,32275676,2023-02-07,-173.35,786.55
6252,32275676,2023-02-09,119.17,905.72
8150,32275676,2023-02-14,70.03,975.75
725,32308270,2023-01-31,,976.53
1052,32308270,2023-02-03,139.16,1115.69
7915,32308270,2023-02-05,-62.56,1053.1299999999999
4242,32308270,2023-02-09,11.67,1064.8
2929,32308270,2023-02-09,-1060.0,4.7999999999999545
726,32312381,2023-01-31,,742.85
8188,32312381,2023-02-01,-96.77,646.08
539,32312381,2023-02-11,134.09,780.1700000000001
727,32312410,2023-01-31,,817.47
3496,32312410,2023-02-04,-89.58,727.89
728,32370392,2023-01-31,,369.09
416,32370392,2023-02-04,67.93,437.02
1253,32370392,2023-02-05,167.18,604.2
2564,32370392,2023-02-06,64.83,669.03
4758,32370392,2023-02-10,-133.46,535.5699999999999
1239,32370392,2023-02-12,-71.93,463.64
729,32386770,2023-01-31,,639.45
4028,32386770,2023-02-01,-56.55,582.9000000000001
1507,32386770,2023-02-02,101.46,684.36
8342,32386770,2023-02-03,716.6,1400.96
374,32386770,2023-02-03,-3.65,1397.31
2071,32386770,2023-02-05,1131.8,2529.1099999999997
6395,32386770,2023-02-06,72.25,2601.3599999999997
39,32386770,2023-02-07,118.34,2719.7
1265,32386770,2023-02-07,-51.11,2668.5899999999997
2910,32386770,2023-02-11,178.01,2846.6
6114,32386770,2023-02-14,134.52,2981.12
730,32390015,2023-01-31,,529.35
6278,32390015,2023-02-02,-147.44,381.91
4279,32390015,2023-02-04,-117.79,264.12
5062,32390015,2023-02-07,-83.34,180.78000000000003
6306,32390015,2023-02-08,-96.43,84.35000000000001
2864,32390015,2023-02-09,157.13,241.48000000000002
3243,32390015,2023-02-12,88.41,329.89
6288,32390015,2023-02-13,-80.09,249.8
924,32390015,2023-02-13,-173.36,76.44
2863,32390015,2023-02-14,137.37,213.81
731,32400822,2023-01-31,,987.34
8131,32400822,2023-02-08,-1808.4,-821.0600000000001
6916,32400822,2023-02-12,183.41,-637.6500000000001
690,32400822,2023-02-14,-136.49,-774.1400000000001
732,32408166,2023-01-31,,261.63
6438,32408166,2023-02-01,-65.12,196.51
7610,32408166,2023-02-01,-670.1,-473.59000000000003
1546,32408166,2023-02-02,62.78,-410.81000000000006
5021,32408166,2023-02-05,81.05,-329.76000000000005
5344,32408166,2023-02-05,-113.82,-443.58000000000004
7577,32408166,2023-02-06,-122.96,-566.54
5999,32408166,2023-02-11,173.97,-392.57000000000005
5658,32408166,2023-02-13,82.89,-309.68
733,32424424,2023-01-31,,848.04
5077,32424424,2023-02-06,1751.6,2599.64
5674,32424424,2023-02-07,155.69,2755.33
192,32424424,2023-02-08,-53.13,2702.2
684,32424424,2023-02-08,-106.62,2595.58
3022,32424424,2023-02-12,-160.33,2435.25
3748,32424424,2023-02-13,91.78,2527.0299999999997
734,32474004,2023-01-31,,509.41
1301,32474004,2023-02-05,-78.96,430.45000000000005
3142,32474004,2023-02-06,-116.91,313.54
3563,32474004,2023-02-08,4.84,318.38000000000005
2390,32474004,2023-02-09,106.38,424.76000000000005
735,32476086,2023-01-31,,67.66
5216,32476086,2023-02-06,55.3,122.96
3183,32476086,2023-02-09,115.75,238.70999999999998
8400,32476086,2023-02-10,137.56,376.27
861,32476086,2023-02-12,127.6,503.87
2909,32476086,2023-02-14,908.4,1412.27
736,32597705,2023-01-31,,869.89
7860,32597705,2023-02-03,-125.04,744.85
6929,32597705,2023-02-03,-172.24,572.6099999999999
6287,32597705,2023-02-06,-76.6,496.01
4632,32597705,2023-02-08,175.42,671.43
7248,32597705,2023-02-12,-90.34,581.0899999999999
5079,32597705,2023-02-13,-111.43,469.65999999999997
737,32641357,2023-01-31,,12.39
3314,32641357,2023-02-03,-16.93,-4.539999999999999
6861,32641357,2023-02-04,119.25,114.71000000000001
2109,32641357,2023-02-04,-94.62,20.090000000000003
1573,32641357,2023-02-08,-693.0,-672.91
4222,32641357,2023-02-09,-46.37,-719.28
738,32679915,2023-01-31,,841.31
6912,32679915,2023-02-02,-161.91,679.4
6592,32679915,2023-02-03,-109.86,569.54
5242,32679915,2023-02-06,154.3,723.8399999999999
739,32737909,2023-01-31,,744.1
1254,32737909,2023-02-01,99.52,843.62
424,32737909,2023-02-02,140.27,983.8900000000001
7376,32737909,2023-02-03,37.02,1020.9100000000001
6649,32737909,2023-02-04,53.51,1074.42
1002,32737909,2023-02-07,-57.25,1017.1700000000001
1941,32737909,2023-02-09,112.93,1130.1000000000001
6226,32737909,2023-02-10,57.63,1187.73
4284,32737909,2023-02-13,-375.1,812.6300000000001
740,32803222,2023-01-31,,827.92
4886,32803222,2023-02-01,-80.92,747.0
4257,32803222,2023-02-10,63.87,810.87
6679,32803222,2023-02-11,142.41,953.28
121,32803222,2023-02-12,9.9,963.18
5162,32803222,2023-02-13,96.06,1059.24
5996,32803222,2023-02-14,56.66,1115.8999999999999
741,32824719,2023-01-31,,502.37
151,32824719,2023-02-01,-9.8,492.57
7164,32824719,2023-02-10,179.1,671.67
3640,32824719,2023-02-11,-110.41,561.26
742,32888555,2023-01-31,,781.33
6987,32888555,2023-02-03,76.11,857.44
297,32888555,2023-02-05,-74.16,783.2800000000001
6496,32888555,2023-02-06,1161.4,1944.6800000000003
7269,32888555,2023-02-06,-96.15,1848.5300000000002
8456,32888555,2023-02-09,-179.26,1669.2700000000002
2313,32888555,2023-02-11,-42.9,1626.3700000000003
1446,32888555,2023-02-12,169.36,1795.7300000000002
663,32888555,2023-02-14,207.36,2003.0900000000004
743,32930305,2023-01-31,,49.71
4935,32930305,2023-02-05,151.29,201.0
2082,32930305,2023-02-08,-209.73,-8.72999999999999
1857,32930305,2023-02-11,73.61,64.88000000000001
8164,32930305,2023-02-12,-183.73,-118.84999999999998
744,32934183,2023-01-31,,917.81
8136,32934183,2023-02-03,-886.3,31.50999999999999
7872,32934183,2023-02-07,-65.97,-34.46000000000001
2335,32934183,2023-02-11,55.38,20.919999999999995
745,32973728,2023-01-31,,321.03
4463,32973728,2023-02-06,54.71,375.73999999999995
5697,32973728,2023-02-08,-104.18,271.55999999999995
8666,32973728,2023-02-13,131.36,402.91999999999996
746,32991596,2023-01-31,,755.92
7655,32991596,2023-02-01,166.48,922.4
7217,32991596,2023-02-05,65.54,987.9399999999999
4219,32991596,2023-02-07,162.11,1150.05
6059,32991596,2023-02-09,118.82,1268.87
8548,32991596,2023-02-11,1851.4,3120.27
5009,32991596,2023-02-11,-147.54,2972.73
1248,32991596,2023-02-11,-158.64,2814.09
747,33014501,2023-01-31,,454.35
6938,33014501,2023-02-03,-68.85,385.5
3001,33014501,2023-02-03,-84.12,301.38
4496,33014501,2023-02-04,129.64,431.02
7764,33014501,2023-02-04,85.27,516.29
4271,33014501,2023-02-05,-80.26,436.03
1624,33014501,2023-02-09,77.66,513.69
7559,33014501,2023-02-13,152.83,666.52
8398,33014501,2023-02-13,-135.78,530.74
748,33112628,2023-01-31,,879.2
4851,33112628,2023-02-02,196.6,1075.8
2841,33112628,2023-02-04,245.23,1321.03
5703,33112628,2023-02-05,133.1,1454.13
6422,33112628,2023-02-06,-75.81,1378.32
6967,33112628,2023-02-10,99.53,1477.85
2254,33112628,2023-02-11,-123.24,1354.6100000000001
2219,33112628,2023-02-12,84.07,1438.68
2458,33112628,2023-02-13,117.35,1556.03
749,33116647,2023-01-31,,391.76
7131,33116647,2023-02-04,68.44,460.2
5990,33116647,2023-02-05,-60.9,399.3
6137,33116647,2023-02-06,-136.49,262.80999999999995
2745,33116647,2023-02-06,-1095.4,-832.5900000000001
2098,33116647,2023-02-09,78.1,-754.4900000000001
4344,33116647,2023-02-09,-58.09,-812.5800000000002
2125,33116647,2023-02-13,31.07,-781.5100000000001
4822,33116647,2023-02-14,-60.92,-842.4300000000002
750,33159039,2023-01-31,,100.51
7250,33159039,2023-02-01,-240.2,-139.69
7791,33159039,2023-02-05,-126.51,-266.2
1560,33159039,2023-02-05,-143.3,-409.5
2820,33159039,2023-02-12,-94.36,-503.86
751,33168725,2023-01-31,,211.44
3435,33168725,2023-02-01,88.65,300.09000000000003
2078,33168725,2023-02-03,-110.05,190.04000000000002
3948,33168725,2023-02-04,-262.0,-71.95999999999998
6967,33168725,2023-02-10,-99.53,-171.48999999999998
968,33168725,2023-02-14,-123.42,-294.90999999999997
752,33173974,2023-01-31,,94.47
3227,33173974,2023-02-02,88.57,183.04
5572,33173974,2023-02-04,51.84,234.88
6988,33173974,2023-02-05,-106.32,128.56
1730,33173974,2023-02-06,-98.92,29.64
3697,33173974,2023-02-07,134.59,164.23000000000002
836,33173974,2023-02-08,-160.1,4.1299999999999955
6899,33173974,2023-02-10,162.36,166.49
2388,33173974,2023-02-13,69.55,236.04000000000002
2116,33173974,2023-02-13,-201.95,34.09000000000003
753,33202593,2023-01-31,,329.25
5756,33202593,2023-02-09,-191.29,137.96
754,33240853,2023-01-31,,985.46
6202,33240853,2023-02-01,-120.69,864.77
3908,33240853,2023-02-07,1429.1,2293.87
4238,33240853,2023-02-09,-938.3,1355.57
2710,33240853,2023-02-11,1318.1,2673.67
685,33240853,2023-02-13,86.25,2759.92
1013,33240853,2023-02-14,-77.21,2682.71
755,33259781,2023-01-31,,923.18
1287,33259781,2023-02-01,-93.43,829.75
5635,33259781,2023-02-05,65.57,895.3199999999999
3861,33259781,2023-02-07,66.88,962.1999999999999
7955,33259781,2023-02-08,-149.64,812.56
1043,33259781,2023-02-09,912.8,1725.36
8606,33259781,2023-02-10,-150.39,1574.9699999999998
3707,33259781,2023-02-12,841.7,2416.67
7427,33259781,2023-02-12,93.57,2510.24
5267,33259781,2023-02-14,66.29,2576.5299999999997
8091,33259781,2023-02-14,-87.23,2489.3
756,33270307,2023-01-31,,38.51
1120,33270307,2023-02-02,-120.61,-82.1
7729,33270307,2023-02-04,32.62,-49.48000000000001
2142,33270307,2023-02-06,-116.99,-166.47
1024,33270307,2023-02-12,110.81,-55.66000000000001
656,33270307,2023-02-14,1376.0,1320.34
757,33348876,2023-01-31,,267.33
6444,33348876,2023-02-02,-40.94,226.39
5422,33348876,2023-02-05,60.35,286.74
4958,33348876,2023-02-07,111.26,398.0
976,33348876,2023-02-07,99.21,497.21
829,33348876,2023-02-08,-217.58,279.63
1215,33348876,2023-02-09,-153.45,126.18
758,33351056,2023-01-31,,597.06
1533,33351056,2023-02-02,-142.28,454.78
3631,33351056,2023-02-03,769.3,1224.08
590,33351056,2023-02-03,208.28,1432.36
6564,33351056,2023-02-03,179.13,1611.49
6606,33351056,2023-02-07,90.26,1701.75
932,33351056,2023-02-10,-89.98,1611.77
7917,33351056,2023-02-13,84.2,1695.97
759,33381880,2023-01-31,,682.27
2304,33381880,2023-02-04,58.31,740.5799999999999
4929,33381880,2023-02-04,-97.06,643.52
1034,33381880,2023-02-07,75.46,718.98
6194,33381880,2023-02-08,-168.29,550.69
4618,33381880,2023-02-11,-172.57,378.12
2884,33381880,2023-02-12,131.34,509.46000000000004
7658,33381880,2023-02-14,73.4,582.86
760,33403100,2023-01-31,,270.23
3721,33403100,2023-02-11,-110.28,159.95000000000002
761,33414190,2023-01-31,,204.38
5107,33414190,2023-02-04,63.54,267.92
1188,33414190,2023-02-07,-29.79,238.13
3212,33414190,2023-02-11,60.37,298.5
2162,33414190,2023-02-13,-150.38,148.12
762,33424425,2023-01-31,,23.18
7213,33424425,2023-02-01,-54.7,-31.520000000000003
6742,33424425,2023-02-02,108.46,76.94
3261,33424425,2023-02-04,578.6,655.54
6329,33424425,2023-02-04,45.45,700.9900000000001
3222,33424425,2023-02-07,-39.59,661.4000000000001
5073,33424425,2023-02-13,76.04,737.44
763,33470885,2023-01-31,,531.96
7371,33470885,2023-02-02,181.56,713.52
4123,33470885,2023-02-03,-75.66,637.86
3326,33470885,2023-02-03,-107.9,529.96
148,33470885,2023-02-05,-70.44,459.52000000000004
5764,33470885,2023-02-07,1676.4,2135.92
6654,33470885,2023-02-12,-1071.4,1064.52
7045,33470885,2023-02-13,61.95,1126.47
4185,33470885,2023-02-14,145.06,1271.53
764,33505838,2023-01-31,,76.39
2521,33505838,2023-02-05,54.53,130.92000000000002
2293,33505838,2023-02-06,135.81,266.73
224,33505838,2023-02-07,-73.26,193.47000000000003
1184,33505838,2023-02-07,-77.96,115.51000000000002
7681,33505838,2023-02-08,87.34,202.85000000000002
4780,33505838,2023-02-14,-93.12,109.73000000000002
765,33527603,2023-01-31,,413.42
3579,33527603,2023-02-10,-123.66,289.76
6895,33527603,2023-02-10,-504.8,-215.03999999999996
1903,33527603,2023-02-11,-95.27,-310.30999999999995
8424,33527603,2023-02-12,94.05,-216.25999999999996
6774,33527603,2023-02-13,1154.7,938.44
766,33527759,2023-01-31,,245.55
5922,33527759,2023-02-06,-100.9,144.65
2911,33527759,2023-02-11,-792.4,-647.75
767,33561341,2023-01-31,,749.16
337,33561341,2023-02-01,102.31,851.47
5144,33561341,2023-02-05,17.25,868.72
3375,33561341,2023-02-09,114.45,983.17
768,33632099,2023-01-31,,943.81
1456,33632099,2023-02-04,-1398.7,-454.8900000000001
335,33632099,2023-02-05,-34.76,-489.6500000000001
1950,33632099,2023-02-10,88.72,-400.93000000000006
2006,33632099,2023-02-10,-83.51,-484.4400000000001
3135,33632099,2023-02-11,1991.3,1506.86
127,33632099,2023-02-12,1955.6,3462.46
6545,33632099,2023-02-13,54.59,3517.0499999999997
7703,33632099,2023-02-13,-1370.1,2146.95
6312,33632099,2023-02-14,-57.83,2089.12
769,33634912,2023-01-31,,888.99
6870,33634912,2023-02-02,-49.76,839.23
7620,33634912,2023-02-04,26.48,865.71
5486,33634912,2023-02-04,-109.08,756.63
7685,33634912,2023-02-06,11.61,768.24
5205,33634912,2023-02-10,-141.06,627.1800000000001
7161,33634912,2023-02-13,61.34,688.52
3344,33634912,2023-02-13,-118.83,569.69
2867,33634912,2023-02-13,-151.76,417.93
1984,33634912,2023-02-14,-163.34,254.59
770,33749113,2023-01-31,,590.37
524,33749113,2023-02-03,-144.98,445.39
5183,33749113,2023-02-05,-102.17,343.22
8520,33749113,2023-02-07,-122.02,221.20000000000002
918,33749113,2023-02-12,126.93,348.13
3512,33749113,2023-02-12,-122.81,225.32000000000002
771,33749812,2023-01-31,,121.02
5511,33749812,2023-02-02,50.83,171.85
4746,33749812,2023-02-03,-78.92,92.92999999999999
6301,33749812,2023-02-04,-39.76,53.169999999999995
1051,33749812,2023-02-04,-957.5,-904.33
5860,33749812,2023-02-05,110.07,-794.26
5459,33749812,2023-02-06,100.8,-693.46
772,33750944,2023-01-31,,100.44
4399,33750944,2023-02-05,-138.66,-38.22
846,33750944,2023-02-14,120.83,82.61
773,33771855,2023-01-31,,886.78
5409,33771855,2023-02-01,153.65,1040.43
6673,33771855,2023-02-01,-527.1,513.3299999999999
5737,33771855,2023-02-05,-230.5,282.8299999999999
5489,33771855,2023-02-09,26.32,309.1499999999999
1485,33771855,2023-02-11,-203.67,105.47999999999993
6203,33771855,2023-02-13,45.56,151.03999999999994
774,33806253,2023-01-31,,847.44
3170,33806253,2023-02-01,151.18,998.6200000000001
2829,33806253,2023-02-05,-144.63,853.99
6294,33806253,2023-02-06,-110.47,743.5200000000001
5350,33806253,2023-02-09,-87.02,656.5000000000001
1080,33806253,2023-02-10,139.76,796.26
775,33832864,2023-01-31,,46.85
1143,33832864,2023-02-02,-109.28,-62.43
3658,33832864,2023-02-03,-128.62,-191.05
328,33832864,2023-02-06,-1743.5,-1934.55
3549,33832864,2023-02-13,123.05,-1811.5
776,33906740,2023-01-31,,820.46
2344,33906740,2023-02-01,-67.52,752.94
3993,33906740,2023-02-02,-701.1,51.84000000000003
8382,33906740,2023-02-04,-46.49,5.35000000000003
3900,33906740,2023-02-04,-62.69,-57.33999999999997
4936,33906740,2023-02-10,-747.3,-804.6399999999999
7046,33906740,2023-02-11,105.46,-699.1799999999998
1654,33906740,2023-02-12,-24.74,-723.9199999999998
821,33906740,2023-02-14,147.38,-576.5399999999998
777,33914941,2023-01-31,,665.9
5804,33914941,2023-02-01,-160.48,505.41999999999996
5474,33914941,2023-02-03,-105.07,400.35
6637,33914941,2023-02-05,-142.97,257.38
7019,33914941,2023-02-06,-54.05,203.32999999999998
778,33915504,2023-01-31,,742.98
7654,33915504,2023-02-07,134.62,877.6
2854,33915504,2023-02-10,-712.2,165.39999999999998
5664,33915504,2023-02-11,1136.3,1301.6999999999998
3063,33915504,2023-02-11,-78.32,1223.38
6456,33915504,2023-02-12,-108.16,1115.22
5004,33915504,2023-02-13,124.44,1239.66
4408,33915504,2023-02-14,-50.82,1188.8400000000001
1855,33915504,2023-02-14,-2237.0,-1048.1599999999999
779,33967237,2023-01-31,,324.8
2821,33967237,2023-02-01,142.15,466.95000000000005
1936,33967237,2023-02-03,152.86,619.8100000000001
8332,33967237,2023-02-04,108.21,728.02
406,33967237,2023-02-04,-87.08,640.94
6647,33967237,2023-02-07,53.6,694.5400000000001
7529,33967237,2023-02-13,-65.9,628.64
1017,33967237,2023-02-14,-66.68,561.96
780,34017695,2023-01-31,,672.46
428,34017695,2023-02-01,79.2,751.6600000000001
4119,34017695,2023-02-04,-73.93,677.73
8601,34017695,2023-02-05,-36.56,641.1700000000001
8347,34017695,2023-02-07,-218.5,422.67
5677,34017695,2023-02-08,-67.49,355.18
4497,34017695,2023-02-13,148.43,503.61
3493,34017695,2023-02-13,-144.46,359.15
3759,34017695,2023-02-13,-1756.0,-1396.85
2519,34017695,2023-02-14,150.24,-1246.61
2494,34017695,2023-02-14,-2002.7,-3249.31
781,34027487,2023-01-31,,54.87
193,34027487,2023-02-02,-56.02,-1.1500000000000057
5935,34027487,2023-02-07,-192.3,-193.45000000000002
3119,34027487,2023-02-10,123.94,-69.51000000000002
2688,34027487,2023-02-11,-43.17,-112.68000000000002
6338,34027487,2023-02-12,57.16,-55.520000000000024
2629,34027487,2023-02-13,144.25,88.72999999999998
7494,34027487,2023-02-14,101.1,189.82999999999998
782,34112514,2023-01-31,,974.1
6454,34112514,2023-02-12,-123.24,850.86
783,34128127,2023-01-31,,275.83
18,34128127,2023-02-01,88.1,363.92999999999995
4795,34128127,2023-02-05,841.2,1205.13
5393,34128127,2023-02-05,136.6,1341.73
5152,34128127,2023-02-10,15.25,1356.98
2065,34128127,2023-02-11,-45.02,1311.96
784,34158235,2023-01-31,,50.76
5369,34158235,2023-02-02,95.52,146.28
3586,34158235,2023-02-03,-85.48,60.79999999999998
5506,34158235,2023-02-05,65.82,126.61999999999998
7893,34158235,2023-02-06,132.93,259.54999999999995
2014,34158235,2023-02-07,-43.24,216.30999999999997
3288,34158235,2023-02-08,-80.16,136.14999999999998
4501,34158235,2023-02-10,-81.26,54.88999999999997
2739,34158235,2023-02-13,-156.49,-101.60000000000004
3372,34158235,2023-02-14,-159.08,-260.68000000000006
1478,34158235,2023-02-14,-439.8,-700.48
785,34190086,2023-01-31,,890.87
2526,34190086,2023-02-01,65.9,956.77
247,34190086,2023-02-08,-144.06,812.71
3792,34190086,2023-02-13,69.63,882.34
1953,34190086,2023-02-13,-73.96,808.38
7282,34190086,2023-02-14,25.45,833.83
786,34252525,2023-01-31,,107.18
2037,34252525,2023-02-02,-95.27,11.91000000000001
5338,34252525,2023-02-04,113.49,125.4
5891,34252525,2023-02-04,-244.13,-118.72999999999999
5131,34252525,2023-02-07,82.79,-35.93999999999998
4446,34252525,2023-02-08,-85.07,-121.00999999999998
7906,34252525,2023-02-13,1503.4,1382.39
787,34264499,2023-01-31,,864.86
1147,34264499,2023-02-08,105.97,970.83
3018,34264499,2023-02-09,898.1,1868.93
7985,34264499,2023-02-09,135.68,2004.6100000000001
8480,34264499,2023-02-09,25.95,2030.5600000000002
370,34264499,2023-02-12,-77.9,1952.66
5256,34264499,2023-02-13,76.07,2028.73
643,34264499,2023-02-14,72.4,2101.13
788,34275044,2023-01-31,,532.29
3924,34275044,2023-02-07,79.84,612.13
6746,34275044,2023-02-08,144.26,756.39
2881,34275044,2023-02-10,91.66,848.05
1221,34275044,2023-02-11,109.94,957.99
865,34275044,2023-02-13,-156.89,801.0999999999999
789,34284479,2023-01-31,,74.46
2551,34284479,2023-02-04,-25.74,48.72
3145,34284479,2023-02-05,155.64,204.35999999999999
6525,34284479,2023-02-08,-66.05,138.31
3503,34284479,2023-02-08,-203.1,-64.79000000000002
3695,34284479,2023-02-10,63.76,-1.0300000000000225
5235,34284479,2023-02-12,122.48,121.44999999999999
790,34336001,2023-01-31,,396.75
4652,34336001,2023-02-01,-48.39,348.36
7834,34336001,2023-02-06,133.66,482.02
5844,34336001,2023-02-08,186.34,668.36
5826,34336001,2023-02-12,-71.39,596.97
5790,34336001,2023-02-14,72.93,669.9
7721,34336001,2023-02-14,-89.16,580.74
791,34351752,2023-01-31,,30.31
5341,34351752,2023-02-02,-12.65,17.659999999999997
3648,34351752,2023-02-02,-27.52,-9.86
3211,34351752,2023-02-05,-227.66,-237.51999999999998
792,34374766,2023-01-31,,916.09
2948,34374766,2023-02-01,131.53,1047.6200000000001
2198,34374766,2023-02-03,749.7,1797.3200000000002
537,34374766,2023-02-06,-138.24,1659.08
139,34374766,2023-02-08,968.8,2627.88
7803,34374766,2023-02-08,-233.36,2394.52
3981,34374766,2023-02-10,-68.91,2325.61
1703,34374766,2023-02-14,13.43,2339.04
793,34400277,2023-01-31,,207.59
6492,34400277,2023-02-01,-1393.7,-1186.1100000000001
5392,34400277,2023-02-03,68.13,-1117.98
8198,34400277,2023-02-04,150.45,-967.5300000000002
4474,34400277,2023-02-04,76.66,-890.8700000000001
1174,34400277,2023-02-05,6.72,-884.1500000000001
609,34400277,2023-02-06,688.5,-195.6500000000001
4500,34400277,2023-02-10,-54.78,-250.4300000000001
887,34400277,2023-02-14,113.52,-136.91000000000008
183,34400277,2023-02-14,-86.17,-223.0800000000001
794,34403979,2023-01-31,,101.14
2674,34403979,2023-02-01,181.06,282.2
6127,34403979,2023-02-02,-98.37,183.82999999999998
7068,34403979,2023-02-04,77.37,261.2
4477,34403979,2023-02-07,-210.28,50.91999999999999
7357,34403979,2023-02-11,42.47,93.38999999999999
3827,34403979,2023-02-12,-1201.1,-1107.71
5362,34403979,2023-02-14,85.41,-1022.3000000000001
795,34461285,2023-01-31,,149.82
4677,34461285,2023-02-04,83.73,233.55
4067,34461285,2023-02-06,121.6,355.15
234,34461285,2023-02-10,-109.1,246.05
1130,34461285,2023-02-11,143.15,389.2
2692,34461285,2023-02-11,-128.1,261.1
535,34461285,2023-02-13,82.99,344.09
796,34482885,2023-01-31,,359.84
2274,34482885,2023-02-05,-161.46,198.37999999999997
2373,34482885,2023-02-08,358.9,557.28
4632,34482885,2023-02-08,-175.42,381.86
1660,34482885,2023-02-11,1161.1,1542.96
4110,34482885,2023-02-14,-90.48,1452.48
797,34650969,2023-01-31,,177.82
2888,34650969,2023-02-05,-116.94,60.879999999999995
7591,34650969,2023-02-06,-995.2,-934.32
5995,34650969,2023-02-08,69.02,-865.3000000000001
3695,34650969,2023-02-10,-63.76,-929.0600000000001
798,34681193,2023-01-31,,183.13
1088,34681193,2023-02-01,-216.49,-33.360000000000014
6944,34681193,2023-02-04,67.01,33.64999999999999
7255,34681193,2023-02-06,133.12,166.76999999999998
1976,34681193,2023-02-07,-124.56,42.20999999999998
2679,34681193,2023-02-09,73.98,116.18999999999998
2235,34681193,2023-02-13,-115.5,0.6899999999999835
799,34866268,2023-01-31,,516.92
4555,34866268,2023-02-03,-178.47,338.44999999999993
6789,34866268,2023-02-12,1261.7,1600.15
800,34867145,2023-01-31,,212.16
7576,34867145,2023-02-02,-211.27,0.8899999999999864
7646,34867145,2023-02-05,-135.59,-134.70000000000002
5323,34867145,2023-02-10,-41.65,-176.35000000000002
801,34902863,2023-01-31,,31.36
34,34902863,2023-02-01,-89.22,-57.86
4596,34902863,2023-02-04,-68.54,-126.4
1252,34902863,2023-02-06,85.44,-40.96000000000001
3645,34902863,2023-02-07,140.1,99.13999999999999
4055,34902863,2023-02-11,191.93,291.07
802,34908905,2023-01-31,,887.49
5502,34908905,2023-02-04,-102.31,785.1800000000001
3694,34908905,2023-02-05,17.69,802.87
2189,34908905,2023-02-07,-46.81,756.06
6593,34908905,2023-02-08,-155.62,600.44
2716,34908905,2023-02-09,134.21,734.65
1811,34908905,2023-02-09,-134.87,599.78
3682,34908905,2023-02-13,-124.37,475.40999999999997
803,34921262,2023-01-31,,971.82
4547,34921262,2023-02-05,-1917.1,-945.2799999999999
7126,34921262,2023-02-07,71.52,-873.7599999999999
5759,34921262,2023-02-08,-101.87,-975.6299999999999
7283,34921262,2023-02-10,-84.84,-1060.4699999999998
4808,34921262,2023-02-13,49.05,-1011.4199999999998
3968,34921262,2023-02-14,-48.39,-1059.81
804,34960760,2023-01-31,,981.79
3115,34960760,2023-02-02,-190.9,790.89
5124,34960760,2023-02-09,-95.76,695.13
2141,34960760,2023-02-10,89.12,784.25
8317,34960760,2023-02-12,160.14,944.3899999999999
805,35038984,2023-01-31,,566.36
43,35038984,2023-02-07,107.2,673.5600000000001
6196,35038984,2023-02-07,-176.01,497.55
2384,35038984,2023-02-09,94.29,591.84
4947,35038984,2023-02-11,-99.57,492.27000000000004
806,35051369,2023-01-31,,637.18
6590,35051369,2023-02-01,-43.65,593.53
4311,35051369,2023-02-02,112.35,705.8799999999999
1623,35051369,2023-02-04,-198.37,507.50999999999993
4845,35051369,2023-02-11,-49.94,457.56999999999994
807,35082945,2023-01-31,,713.95
201,35082945,2023-02-07,-15.77,698.1800000000001
8075,35082945,2023-02-08,-132.78,565.4000000000001
6730,35082945,2023-02-12,113.6,679.0
6491,35082945,2023-02-14,188.72,867.72
808,35083564,2023-01-31,,599.99
165,35083564,2023-02-05,144.77,744.76
6960,35083564,2023-02-06,-32.2,712.5600000000001
8159,35083564,2023-02-06,-181.24,531.3199999999999
4642,35083564,2023-02-08,139.22,670.54
6978,35083564,2023-02-09,59.54,730.08
809,35126236,2023-01-31,,739.8
1144,35126236,2023-02-02,-379.5,360.29999999999995
8640,35126236,2023-02-04,64.48,424.78
1742,35126236,2023-02-04,-109.21,315.56999999999994
3599,35126236,2023-02-06,995.2,1310.77
2215,35126236,2023-02-08,130.56,1441.33
396,35126236,2023-02-08,103.89,1545.22
2180,35126236,2023-02-10,-34.71,1510.51
4916,35126236,2023-02-13,137.35,1647.86
6843,35126236,2023-02-13,114.39,1762.25
2158,35126236,2023-02-14,2138.0,3900.25
810,35160368,2023-01-31,,53.59
325,35160368,2023-02-01,41.55,95.14
1518,35160368,2023-02-05,163.32,258.46
6644,35160368,2023-02-05,85.08,343.53999999999996
5451,35160368,2023-02-10,155.39,498.92999999999995
7866,35160368,2023-02-12,139.57,638.5
7742,35160368,2023-02-13,-39.15,599.3499999999999
3406,35160368,2023-02-14,87.33,686.68
2310,35160368,2023-02-14,-92.59,594.0899999999999
811,35177782,2023-01-31,,79.03
2798,35177782,2023-02-03,149.54,228.57
4287,35177782,2023-02-08,110.25,338.82
8339,35177782,2023-02-09,-105.82,233.0
7185,35177782,2023-02-10,72.18,305.18
301,35177782,2023-02-10,-123.77,181.41000000000003
2119,35177782,2023-02-11,99.42,280.83000000000004
812,35194218,2023-01-31,,842.34
4577,35194218,2023-02-01,142.2,984.54
6534,35194218,2023-02-04,5.86,990.4
3038,35194218,2023-02-05,-812.6,177.79999999999995
1741,35194218,2023-02-10,70.43,248.22999999999996
3521,35194218,2023-02-11,-134.16,114.06999999999996
7613,35194218,2023-02-12,-76.1,37.96999999999997
813,35197451,2023-01-31,,411.69
3572,35197451,2023-02-01,-96.06,315.63
3615,35197451,2023-02-02,0.91,316.54
6010,35197451,2023-02-03,98.31,414.85
3533,35197451,2023-02-05,141.51,556.36
7316,35197451,2023-02-05,86.14,642.5
352,35197451,2023-02-07,131.84,774.3399999999999
7532,35197451,2023-02-11,-60.22,714.12
2325,35197451,2023-02-11,-148.4,565.72
2977,35197451,2023-02-14,723.4,1289.12
814,35210460,2023-01-31,,185.3
2241,35210460,2023-02-01,1821.2,2006.5
8508,35210460,2023-02-01,-99.63,1906.87
2210,35210460,2023-02-03,117.47,2024.34
5558,35210460,2023-02-08,199.46,2223.8
5334,35210460,2023-02-09,42.5,2266.3
6091,35210460,2023-02-10,68.78,2335.08
815,35293864,2023-01-31,,592.55
850,35293864,2023-02-01,-68.47,524.0799999999999
816,35321469,2023-01-31,,194.57
3425,35321469,2023-02-01,76.26,270.83
443,35321469,2023-02-02,-119.36,151.47
766,35321469,2023-02-07,-113.03,38.44
4905,35321469,2023-02-09,74.96,113.39999999999999
5660,35321469,2023-02-14,-51.78,61.61999999999999
817,35330225,2023-01-31,,717.9
5585,35330225,2023-02-02,38.42,756.3199999999999
7653,35330225,2023-02-04,117.96,874.28
2934,35330225,2023-02-05,72.1,946.38
5377,35330225,2023-02-06,-90.78,855.5999999999999
7211,35330225,2023-02-08,-95.08,760.52
8465,35330225,2023-02-09,1169.4,1929.92
6924,35330225,2023-02-14,-505.6,1424.3200000000002
818,35345678,2023-01-31,,381.43
2030,35345678,2023-02-02,98.51,479.94
7225,35345678,2023-02-03,170.7,650.64
6664,35345678,2023-02-06,153.53,804.17
6725,35345678,2023-02-06,-97.06,707.11
5337,35345678,2023-02-07,-127.56,579.55
819,35379604,2023-01-31,,171.68
851,35379604,2023-02-06,28.36,200.04000000000002
5372,35379604,2023-02-06,-84.79,115.25
1573,35379604,2023-02-08,693.0,808.25
5212,35379604,2023-02-08,14.65,822.9
4129,35379604,2023-02-10,-113.82,709.08
6303,35379604,2023-02-13,-58.62,650.46
820,35391237,2023-01-31,,412.06
1442,35391237,2023-02-01,103.94,516.0
5030,35391237,2023-02-01,-105.94,410.06
1050,35391237,2023-02-01,-126.5,283.56
175,35391237,2023-02-02,-97.9,185.66
992,35391237,2023-02-03,-147.6,38.06
1016,35391237,2023-02-04,-163.03,-124.97
7348,35391237,2023-02-07,-153.96,-278.93
4662,35391237,2023-02-11,58.36,-220.57
6735,35391237,2023-02-13,-134.72,-355.29
3671,35391237,2023-02-14,135.7,-219.59000000000003
821,35391340,2023-01-31,,886.56
2540,35391340,2023-02-01,-119.2,767.3599999999999
350,35391340,2023-02-04,125.41,892.77
7263,35391340,2023-02-04,-100.63,792.14
3550,35391340,2023-02-08,-77.26,714.8799999999999
3452,35391340,2023-02-09,156.67,871.55
1402,35391340,2023-02-09,64.44,935.9899999999999
5712,35391340,2023-02-11,109.76,1045.75
5191,35391340,2023-02-11,-87.63,958.1199999999999
1151,35391340,2023-02-12,-115.04,843.0799999999999
822,35405748,2023-01-31,,19.49
5843,35405748,2023-02-02,1666.0,1685.49
3507,35405748,2023-02-03,-171.99,1513.5
4148,35405748,2023-02-06,-60.39,1453.11
6519,35405748,2023-02-09,-63.99,1389.12
823,35445202,2023-01-31,,972.48
2410,35445202,2023-02-04,138.34,1110.82
4939,35445202,2023-02-04,-95.01,1015.8100000000001
8668,35445202,2023-02-05,42.25,1058.06
889,35445202,2023-02-07,71.12,1129.18
3462,35445202,2023-02-13,50.67,1179.85
8212,35445202,2023-02-13,-80.72,1099.13
8652,35445202,2023-02-14,128.56,1227.69
824,35506101,2023-01-31,,713.65
984,35506101,2023-02-04,-143.83,569.8199999999999
1095,35506101,2023-02-06,-368.9,200.91999999999996
1303,35506101,2023-02-07,26.09,227.00999999999996
201,35506101,2023-02-07,15.77,242.77999999999997
5943,35506101,2023-02-08,70.92,313.69999999999993
5350,35506101,2023-02-09,87.02,400.71999999999997
6802,35506101,2023-02-09,-1386.8,-986.0799999999999
6264,35506101,2023-02-11,-107.95,-1094.03
825,35510004,2023-01-31,,723.62
533,35510004,2023-02-07,-53.14,670.48
2572,35510004,2023-02-09,-140.03,530.45
6736,35510004,2023-02-14,122.94,653.39
826,35539408,2023-01-31,,469.13
6290,35539408,2023-02-08,66.58,535.71
6342,35539408,2023-02-12,20.96,556.67
5784,35539408,2023-02-12,-60.3,496.37
827,35540836,2023-01-31,,17.91
6202,35540836,2023-02-01,120.69,138.6
5971,35540836,2023-02-04,162.1,300.7
2290,35540836,2023-02-11,-64.55,236.14999999999998
4420,35540836,2023-02-12,850.1,1086.25
828,35549277,2023-01-31,,505.72
732,35549277,2023-02-03,164.14,669.86
874,35549277,2023-02-04,143.95,813.81
7876,35549277,2023-02-06,54.21,868.02
923,35549277,2023-02-08,-65.82,802.2
4473,35549277,2023-02-09,79.33,881.53
557,35549277,2023-02-14,135.72,1017.25
829,35555120,2023-01-31,,598.72
6055,35555120,2023-02-05,-112.03,486.69000000000005
6636,35555120,2023-02-06,-155.04,331.65000000000003
3210,35555120,2023-02-09,-75.39,256.26000000000005
830,35564578,2023-01-31,,621.37
6695,35564578,2023-02-01,156.88,778.25
5548,35564578,2023-02-01,101.68,879.9300000000001
1793,35564578,2023-02-05,-33.32,846.61
164,35564578,2023-02-06,140.83,987.44
6287,35564578,2023-02-06,76.6,1064.04
7801,35564578,2023-02-07,-93.89,970.15
3770,35564578,2023-02-09,93.14,1063.29
1785,35564578,2023-02-11,-909.1,154.19000000000005
1992,35564578,2023-02-12,-95.71,58.48000000000006
6494,35564578,2023-02-14,153.48,211.96000000000004
831,35574156,2023-01-31,,471.05
3263,35574156,2023-02-02,81.2,552.25
509,35574156,2023-02-02,-113.03,439.22
2434,35574156,2023-02-04,-98.27,340.95000000000005
5005,35574156,2023-02-10,117.79,458.74
2072,35574156,2023-02-12,-71.65,387.09000000000003
832,35614465,2023-01-31,,276.17
1393,35614465,2023-02-01,106.89,383.06
8451,35614465,2023-02-01,75.62,458.68
5528,35614465,2023-02-01,-111.48,347.20000000000005
3936,35614465,2023-02-02,68.58,415.78000000000003
1852,35614465,2023-02-04,238.96,654.74
4740,35614465,2023-02-04,82.25,736.99
6196,35614465,2023-02-07,176.01,913.0
187,35614465,2023-02-09,-81.5,831.5
2230,35614465,2023-02-12,-41.61,789.89
6266,35614465,2023-02-14,52.1,841.99
5650,35614465,2023-02-14,-69.51,772.48
833,35616763,2023-01-31,,279.43
524,35616763,2023-02-03,144.98,424.40999999999997
4091,35616763,2023-02-04,91.88,516.29
2736,35616763,2023-02-04,90.91,607.2
8013,35616763,2023-02-05,98.9,706.1
7659,35616763,2023-02-09,-94.78,611.3199999999999
4610,35616763,2023-02-10,-133.89,477.43
834,35633136,2023-01-31,,603.11
6756,35633136,2023-02-07,-140.72,462.39
3742,35633136,2023-02-08,-1589.0,-1126.6100000000001
7521,35633136,2023-02-09,1855.5,728.8899999999999
2359,35633136,2023-02-10,-85.16,643.7299999999999
144,35633136,2023-02-12,-128.62,515.1099999999999
499,35633136,2023-02-14,223.99,739.0999999999999
835,35642953,2023-01-31,,137.26
7276,35642953,2023-02-07,-45.83,91.42999999999999
7713,35642953,2023-02-10,141.83,233.26
2561,35642953,2023-02-11,-102.43,130.83
5783,35642953,2023-02-13,126.72,257.55
836,35652360,2023-01-31,,41.81
6285,35652360,2023-02-02,87.3,129.11
7984,35652360,2023-02-07,-135.62,-6.509999999999991
4116,35652360,2023-02-10,-101.74,-108.24999999999999
7782,35652360,2023-02-12,-7.46,-115.70999999999998
837,35698347,2023-01-31,,258.22
4799,35698347,2023-02-09,-145.02,113.20000000000002
5106,35698347,2023-02-12,82.2,195.40000000000003
4541,35698347,2023-02-12,76.36,271.76
6716,35698347,2023-02-12,28.42,300.18
788,35698347,2023-02-12,-143.1,157.08000000000004
4989,35698347,2023-02-13,23.8,180.88000000000005
109,35698347,2023-02-14,-105.03,75.85000000000004
838,35712712,2023-01-31,,828.88
4903,35712712,2023-02-02,94.92,923.8
3084,35712712,2023-02-04,91.22,1015.02
3459,35712712,2023-02-13,-93.58,921.44
1296,35712712,2023-02-14,-131.58,789.86
839,35721788,2023-01-31,,837.07
3302,35721788,2023-02-02,47.72,884.7900000000001
3557,35721788,2023-02-04,1548.2,2432.9900000000002
2543,35721788,2023-02-05,-189.35,2243.64
4324,35721788,2023-02-07,166.27,2409.91
1611,35721788,2023-02-11,-67.03,2342.88
840,35726421,2023-01-31,,379.1
1079,35726421,2023-02-01,-36.3,342.8
1281,35726421,2023-02-09,257.1,599.9000000000001
1406,35726421,2023-02-09,-32.68,567.22
6286,35726421,2023-02-11,-117.41,449.81000000000006
2735,35726421,2023-02-12,118.77,568.58
486,35726421,2023-02-12,-146.81,421.77000000000004
2399,35726421,2023-02-13,32.01,453.78000000000003
26,35726421,2023-02-14,143.07,596.85
6398,35726421,2023-02-14,-84.96,511.89000000000004
841,35746207,2023-01-31,,785.36
489,35746207,2023-02-02,142.26,927.62
4452,35746207,2023-02-04,-163.58,764.04
3878,35746207,2023-02-08,-136.06,627.98
5138,35746207,2023-02-09,-180.04,447.94
1590,35746207,2023-02-11,-106.87,341.07
1354,35746207,2023-02-14,82.48,423.55
1881,35746207,2023-02-14,-73.77,349.78
842,35762783,2023-01-31,,346.14
371,35762783,2023-02-04,34.64,380.78
783,35762783,2023-02-06,97.52,478.29999999999995
2489,35762783,2023-02-06,-98.21,380.09
843,35772673,2023-01-31,,517.9
2191,35772673,2023-02-01,-76.39,441.51
5519,35772673,2023-02-11,17.45,458.96
20,35772673,2023-02-12,113.78,572.74
844,35799522,2023-01-31,,750.79
5245,35799522,2023-02-04,122.19,872.98
7561,35799522,2023-02-04,-84.48,788.5
4956,35799522,2023-02-08,811.2,1599.7
4329,35799522,2023-02-09,77.09,1676.79
7570,35799522,2023-02-12,481.2,2157.99
4073,35799522,2023-02-12,-122.13,2035.8600000000001
7487,35799522,2023-02-13,53.69,2089.55
845,35805852,2023-01-31,,886.37
2819,35805852,2023-02-03,26.28,912.65
4112,35805852,2023-02-08,159.05,1071.7
3093,35805852,2023-02-13,-80.1,991.6
1499,35805852,2023-02-13,-128.78,862.82
846,35827625,2023-01-31,,445.63
340,35827625,2023-02-01,-4.45,441.18
893,35827625,2023-02-03,-130.92,310.26
787,35827625,2023-02-06,50.86,361.12
2237,35827625,2023-02-07,166.06,527.1800000000001
103,35827625,2023-02-08,-103.49,423.69
272,35827625,2023-02-13,138.07,561.76
847,35869347,2023-01-31,,768.74
5498,35869347,2023-02-01,-99.06,669.6800000000001
1787,35869347,2023-02-06,128.7,798.38
4305,35869347,2023-02-08,-63.42,734.96
6325,35869347,2023-02-09,122.91,857.87
6895,35869347,2023-02-10,504.8,1362.67
1170,35869347,2023-02-13,-650.5,712.1700000000001
848,35948735,2023-01-31,,117.14
4736,35948735,2023-02-06,173.27,290.41
7344,35948735,2023-02-08,-257.4,33.01000000000005
6588,35948735,2023-02-10,-59.81,-26.799999999999955
2918,35948735,2023-02-12,-103.8,-130.59999999999997
60,35948735,2023-02-13,145.83,15.230000000000075
849,35996817,2023-01-31,,187.89
357,35996817,2023-02-02,62.13,250.01999999999998
3933,35996817,2023-02-02,-807.9,-557.88
8549,35996817,2023-02-03,-955.4,-1513.28
7732,35996817,2023-02-04,162.76,-1350.52
5532,35996817,2023-02-04,97.19,-1253.33
5933,35996817,2023-02-05,39.08,-1214.25
1551,35996817,2023-02-06,1144.5,-69.75
6692,35996817,2023-02-13,-111.75,-181.5
850,36007496,2023-01-31,,239.44
2861,36007496,2023-02-03,-106.54,132.89999999999998
4665,36007496,2023-02-04,130.37,263.27
430,36007496,2023-02-10,-142.78,120.48999999999998
3178,36007496,2023-02-11,-55.67,64.81999999999998
8444,36007496,2023-02-12,-90.33,-25.51000000000002
851,36106467,2023-01-31,,720.17
8170,36106467,2023-02-02,54.11,774.28
6450,36106467,2023-02-13,-48.97,725.31
3817,36106467,2023-02-14,-109.13,616.18
852,36110938,2023-01-31,,532.77
1832,36110938,2023-02-05,-151.15,381.62
885,36110938,2023-02-14,110.42,492.03999999999996
8363,36110938,2023-02-14,-51.36,440.67999999999995
853,36112473,2023-01-31,,530.67
1255,36112473,2023-02-02,104.28,634.9499999999999
5368,36112473,2023-02-07,-16.72,618.23
2982,36112473,2023-02-08,128.42,746.65
7684,36112473,2023-02-08,37.07,783.7199999999999
1614,36112473,2023-02-11,111.87,895.5899999999999
854,36114551,2023-01-31,,876.22
570,36114551,2023-02-03,-12.53,863.69
8068,36114551,2023-02-03,-1488.0,-624.31
5321,36114551,2023-02-07,-9.52,-633.8299999999999
1274,36114551,2023-02-11,134.5,-499.3299999999999
5161,36114551,2023-02-11,113.2,-386.12999999999994
2385,36114551,2023-02-13,-154.15,-540.28
4335,36114551,2023-02-14,134.51,-405.77
855,36126802,2023-01-31,,617.04
6089,36126802,2023-02-04,117.97,735.01
354,36126802,2023-02-10,-122.66,612.3499999999999
6051,36126802,2023-02-12,-80.63,531.72
856,36131723,2023-01-31,,602.96
3531,36131723,2023-02-02,723.0,1325.96
4092,36131723,2023-02-06,74.78,1400.74
5035,36131723,2023-02-07,153.24,1553.98
1448,36131723,2023-02-08,-60.7,1493.28
664,36131723,2023-02-13,118.36,1611.64
857,36141472,2023-01-31,,656.7
1138,36141472,2023-02-09,20.1,676.8000000000001
858,36143004,2023-01-31,,256.22
2260,36143004,2023-02-03,-132.95,123.27000000000004
8345,36143004,2023-02-04,-58.74,64.53000000000003
6964,36143004,2023-02-08,111.03,175.56000000000003
1861,36143004,2023-02-13,127.19,302.75
859,36171568,2023-01-31,,343.44
6710,36171568,2023-02-06,-169.47,173.97
162,36171568,2023-02-14,151.47,325.44
860,36192947,2023-01-31,,744.33
8314,36192947,2023-02-02,73.15,817.48
8158,36192947,2023-02-04,47.16,864.6400000000001
4122,36192947,2023-02-05,-103.8,760.84
6311,36192947,2023-02-05,-134.86,625.98
3008,36192947,2023-02-05,-158.54,467.44000000000005
2414,36192947,2023-02-07,435.8,903.24
5133,36192947,2023-02-11,36.38,939.62
6065,36192947,2023-02-11,-69.7,869.9200000000001
194,36192947,2023-02-13,-44.57,825.35
894,36192947,2023-02-14,74.53,899.88
861,36197772,2023-01-31,,962.03
3126,36197772,2023-02-01,-21.82,940.2099999999999
3609,36197772,2023-02-04,-189.3,750.91
4136,36197772,2023-02-06,179.58,930.49
7208,36197772,2023-02-12,-77.33,853.16
1588,36197772,2023-02-13,-164.76,688.4
2374,36197772,2023-02-14,-110.14,578.26
862,36258926,2023-01-31,,549.71
7251,36258926,2023-02-06,103.37,653.08
4879,36258926,2023-02-06,-100.71,552.37
596,36258926,2023-02-09,-133.16,419.21000000000004
8423,36258926,2023-02-10,120.39,539.6
863,36259936,2023-01-31,,628.23
3331,36259936,2023-02-01,18.77,647.0
2398,36259936,2023-02-05,403.6,1050.6
7483,36259936,2023-02-06,16.5,1067.1
1846,36259936,2023-02-08,-60.7,1006.4
6688,36259936,2023-02-11,-131.61,874.79
8065,36259936,2023-02-12,-113.45,761.34
864,36296704,2023-01-31,,491.31
258,36296704,2023-02-04,167.73,659.04
6442,36296704,2023-02-04,-191.64,467.4
1824,36296704,2023-02-05,16.24,483.64
2559,36296704,2023-02-08,116.58,600.22
865,36327122,2023-01-31,,808.81
3028,36327122,2023-02-02,-127.6,681.2099999999999
446,36327122,2023-02-07,104.16,785.3699999999999
6617,36327122,2023-02-08,-51.75,733.6199999999999
866,36389309,2023-01-31,,469.45
7893,36389309,2023-02-06,-132.93,336.52
5686,36389309,2023-02-08,-36.71,299.81
2552,36389309,2023-02-09,83.47,383.28
7424,36389309,2023-02-11,145.81,529.0899999999999
3067,36389309,2023-02-11,-1271.5,-742.4100000000001
867,36393557,2023-01-31,,407.12
5211,36393557,2023-02-03,-99.07,308.05
7873,36393557,2023-02-05,-101.16,206.89000000000001
2128,36393557,2023-02-06,-142.55,64.34
4862,36393557,2023-02-09,5.59,69.93
4104,36393557,2023-02-13,161.44,231.37
868,36419197,2023-01-31,,627.78
1935,36419197,2023-02-02,129.45,757.23
7394,36419197,2023-02-07,169.36,926.5899999999999
6432,36419197,2023-02-08,1693.2,2619.79
5688,36419197,2023-02-14,90.74,2710.5299999999997
869,36425954,2023-01-31,,93.85
4635,36425954,2023-02-03,-146.59,-52.74000000000001
7828,36425954,2023-02-04,150.84,98.1
2661,36425954,2023-02-04,131.69,229.79
1723,36425954,2023-02-10,-141.46,88.32999999999998
1794,36425954,2023-02-11,-40.22,48.109999999999985
2156,36425954,2023-02-14,104.18,152.29
870,36519974,2023-01-31,,922.41
1736,36519974,2023-02-05,-129.47,792.9399999999999
3986,36519974,2023-02-07,-38.88,754.06
1171,36519974,2023-02-09,-1522.7,-768.6400000000001
7667,36519974,2023-02-12,-138.36,-907.0000000000001
871,36549889,2023-01-31,,760.2
3595,36549889,2023-02-09,-97.39,662.8100000000001
7421,36549889,2023-02-10,-12.48,650.33
6023,36549889,2023-02-10,-131.62,518.71
7340,36549889,2023-02-14,143.83,662.5400000000001
872,36551112,2023-01-31,,976.02
7418,36551112,2023-02-01,-12.83,963.1899999999999
4432,36551112,2023-02-05,183.91,1147.1
6297,36551112,2023-02-05,-40.03,1107.07
5618,36551112,2023-02-06,97.64,1204.71
8343,36551112,2023-02-06,-32.34,1172.37
6100,36551112,2023-02-14,-1514.1,-341.73
5207,36551112,2023-02-14,-2197.2,-2538.93
873,36596942,2023-01-31,,550.9
893,36596942,2023-02-03,130.92,681.8199999999999
565,36596942,2023-02-06,110.09,791.91
32,36596942,2023-02-08,-74.13,717.78
7476,36596942,2023-02-08,-190.88,526.9
6922,36596942,2023-02-09,155.29,682.1899999999999
4674,36596942,2023-02-13,50.68,732.87
6195,36596942,2023-02-13,48.38,781.25
8552,36596942,2023-02-13,-18.85,762.4
874,36611100,2023-01-31,,485.06
7901,36611100,2023-02-02,144.06,629.12
8321,36611100,2023-02-03,-565.2,63.91999999999996
3532,36611100,2023-02-05,-91.56,-27.640000000000043
4874,36611100,2023-02-08,71.61,43.969999999999956
5898,36611100,2023-02-10,-174.77,-130.80000000000007
875,36636385,2023-01-31,,985.55
1520,36636385,2023-02-01,-134.06,851.49
3042,36636385,2023-02-04,74.02,925.51
4007,36636385,2023-02-07,1392.7,2318.21
3112,36636385,2023-02-10,-76.06,2242.15
3945,36636385,2023-02-10,-134.54,2107.61
876,36668239,2023-01-31,,566.32
1411,36668239,2023-02-02,1640.2,2206.52
8608,36668239,2023-02-03,-71.27,2135.25
7034,36668239,2023-02-11,-123.81,2011.4400000000003
6537,36668239,2023-02-13,-11.11,2000.3300000000002
877,36692647,2023-01-31,,710.29
2987,36692647,2023-02-02,166.35,876.64
300,36692647,2023-02-09,129.76,1006.4
878,36696277,2023-01-31,,395.42
2998,36696277,2023-02-01,153.43,548.85
8174,36696277,2023-02-08,74.38,623.23
5553,36696277,2023-02-08,-108.96,514.27
3307,36696277,2023-02-08,-121.98,392.29
805,36696277,2023-02-09,50.78,443.07000000000005
4682,36696277,2023-02-10,550.8,993.87
1357,36696277,2023-02-11,38.74,1032.61
4687,36696277,2023-02-12,1491.7,2524.31
879,36725272,2023-01-31,,52.82
7409,36725272,2023-02-02,52.78,105.6
7631,36725272,2023-02-05,129.27,234.87
5991,36725272,2023-02-06,161.37,396.24
4938,36725272,2023-02-07,-109.2,287.04
8484,36725272,2023-02-14,-126.36,160.68
880,36837451,2023-01-31,,429.52
7670,36837451,2023-02-01,146.02,575.54
1610,36837451,2023-02-02,212.6,788.14
1897,36837451,2023-02-02,96.32,884.46
1896,36837451,2023-02-02,31.96,916.42
3569,36837451,2023-02-07,-77.46,838.96
7208,36837451,2023-02-12,77.33,916.29
8512,36837451,2023-02-12,-119.09,797.1999999999999
881,36841261,2023-01-31,,172.37
5749,36841261,2023-02-01,-127.65,44.72
2684,36841261,2023-02-04,110.3,155.01999999999998
6405,36841261,2023-02-06,-159.47,-4.449999999999989
3033,36841261,2023-02-10,139.99,135.54000000000002
144,36841261,2023-02-12,128.62,264.16
4967,36841261,2023-02-14,-148.63,115.53000000000003
882,36849841,2023-01-31,,593.56
4377,36849841,2023-02-02,-62.52,531.04
5586,36849841,2023-02-03,-174.62,356.41999999999996
4677,36849841,2023-02-04,-83.73,272.68999999999994
3489,36849841,2023-02-05,114.02,386.7099999999999
5566,36849841,2023-02-10,-99.46,287.24999999999994
883,36871984,2023-01-31,,949.89
5371,36871984,2023-02-05,-103.29,846.6
5462,36871984,2023-02-07,56.49,903.09
3061,36871984,2023-02-08,-154.63,748.46
844,36871984,2023-02-12,1663.0,2411.46
3374,36871984,2023-02-13,-58.3,2353.16
884,36949196,2023-01-31,,614.22
6949,36949196,2023-02-02,118.32,732.54
4381,36949196,2023-02-03,124.88,857.4200000000001
5881,36949196,2023-02-04,-86.74,770.6800000000001
350,36949196,2023-02-04,-125.41,645.27
6274,36949196,2023-02-07,-85.77,559.5
885,36982820,2023-01-31,,833.46
8676,36982820,2023-02-01,599.8,1433.26
3545,36982820,2023-02-05,-74.55,1358.71
8564,36982820,2023-02-08,2.72,1361.43
6578,36982820,2023-02-12,117.45,1478.88
7942,36982820,2023-02-12,-125.62,1353.26
6062,36982820,2023-02-14,80.46,1433.72
886,37004975,2023-01-31,,635.77
3966,37004975,2023-02-04,-55.54,580.23
4068,37004975,2023-02-05,122.25,702.48
5575,37004975,2023-02-06,91.58,794.06
388,37004975,2023-02-06,59.58,853.64
8334,37004975,2023-02-07,-1679.8,-826.16
1195,37004975,2023-02-08,-1290.2,-2116.36
790,37004975,2023-02-09,37.65,-2078.71
5391,37004975,2023-02-09,-112.31,-2191.02
8523,37004975,2023-02-13,110.17,-2080.85
887,37017424,2023-01-31,,71.34
5903,37017424,2023-02-01,-85.83,-14.489999999999995
1257,37017424,2023-02-01,-98.52,-113.00999999999999
1131,37017424,2023-02-02,111.16,-1.8499999999999943
2831,37017424,2023-02-10,-11.07,-12.919999999999995
7950,37017424,2023-02-10,-1531.0,-1543.92
7812,37017424,2023-02-12,71.74,-1472.18
3930,37017424,2023-02-13,71.51,-1400.67
888,37062632,2023-01-31,,366.72
368,37062632,2023-02-01,119.45,486.17
8251,37062632,2023-02-04,89.51,575.6800000000001
5841,37062632,2023-02-06,-171.3,404.38
3819,37062632,2023-02-09,50.41,454.79
1104,37062632,2023-02-10,104.53,559.32
7708,37062632,2023-02-10,-72.61,486.71000000000004
8634,37062632,2023-02-13,87.03,573.74
889,37146521,2023-01-31,,471.64
1933,37146521,2023-02-01,-18.27,453.37
5708,37146521,2023-02-04,-94.29,359.08
6034,37146521,2023-02-08,-93.73,265.34999999999997
6837,37146521,2023-02-08,-195.35,70.0
8267,37146521,2023-02-08,-1565.7,-1495.7
1951,37146521,2023-02-10,-46.07,-1541.77
3555,37146521,2023-02-13,37.47,-1504.3
890,37164421,2023-01-31,,302.68
1850,37164421,2023-02-03,145.42,448.1
6818,37164421,2023-02-06,133.47,581.5699999999999
5993,37164421,2023-02-10,-197.72,383.85
7688,37164421,2023-02-11,182.11,565.96
891,37247834,2023-01-31,,319.19
6123,37247834,2023-02-01,-148.96,170.23
4574,37247834,2023-02-01,-937.1,-766.87
2402,37247834,2023-02-07,169.21,-597.66
1821,37247834,2023-02-08,163.97,-433.69
5568,37247834,2023-02-08,-56.13,-489.82
8436,37247834,2023-02-09,-80.13,-569.95
7603,37247834,2023-02-09,-138.48,-708.43
6130,37247834,2023-02-11,-117.67,-826.1
7502,37247834,2023-02-12,-185.51,-1011.6099999999999
974,37247834,2023-02-14,42.13,-969.4799999999999
892,37256412,2023-01-31,,24.43
4089,37256412,2023-02-03,-1529.4,-1504.97
1414,37256412,2023-02-05,135.39,-1369.58
7579,37256412,2023-02-08,80.13,-1289.45
2254,37256412,2023-02-11,123.24,-1166.21
893,37267391,2023-01-31,,819.11
6764,37267391,2023-02-01,-105.76,713.35
7524,37267391,2023-02-02,-666.0,47.35000000000002
2467,37267391,2023-02-04,102.71,150.06
6791,37267391,2023-02-06,629.3,779.3599999999999
5459,37267391,2023-02-06,-100.8,678.56
1811,37267391,2023-02-09,134.87,813.4299999999998
8610,37267391,2023-02-10,-62.82,750.6099999999999
7574,37267391,2023-02-11,47.38,797.9899999999999
894,37273974,2023-01-31,,533.14
7602,37273974,2023-02-02,699.9,1233.04
786,37273974,2023-02-02,80.13,1313.17
79,37273974,2023-02-03,180.87,1494.04
6261,37273974,2023-02-05,62.54,1556.58
7331,37273974,2023-02-13,-125.25,1431.33
895,37274865,2023-01-31,,95.23
896,37297429,2023-01-31,,693.82
1923,37297429,2023-02-01,-79.4,614.4200000000001
1980,37297429,2023-02-02,983.3,1597.72
883,37297429,2023-02-02,108.09,1705.81
3190,37297429,2023-02-03,-128.25,1577.56
5513,37297429,2023-02-05,45.9,1623.46
8623,37297429,2023-02-06,72.88,1696.3400000000001
7968,37297429,2023-02-08,-193.89,1502.45
7282,37297429,2023-02-14,-25.45,1477.0
5097,37297429,2023-02-14,-153.15,1323.8500000000001
897,37319261,2023-01-31,,574.42
5879,37319261,2023-02-04,-99.39,475.03
3253,37319261,2023-02-06,-1409.6,-934.5699999999999
6336,37319261,2023-02-09,-89.75,-1024.32
2815,37319261,2023-02-10,55.29,-969.03
898,37369245,2023-01-31,,446.65
6172,37369245,2023-02-01,-74.4,372.25
2741,37369245,2023-02-03,-43.72,328.53
6066,37369245,2023-02-04,82.56,411.09
5471,37369245,2023-02-04,-118.19,292.9
2063,37369245,2023-02-05,-40.41,252.48999999999998
4663,37369245,2023-02-10,-1324.9,-1072.41
754,37369245,2023-02-14,-124.26,-1196.67
899,37407392,2023-01-31,,822.17
642,37407392,2023-02-04,79.47,901.64
2498,37407392,2023-02-05,-6.87,894.77
5931,37407392,2023-02-10,-110.62,784.15
3970,37407392,2023-02-13,-87.2,696.9499999999999
1834,37407392,2023-02-14,49.4,746.3499999999999
900,37443706,2023-01-31,,621.08
2682,37443706,2023-02-03,88.33,709.4100000000001
4418,37443706,2023-02-07,-89.31,620.1
3040,37443706,2023-02-08,158.67,778.77
3950,37443706,2023-02-08,48.19,826.96
8553,37443706,2023-02-12,95.8,922.76
8519,37443706,2023-02-13,1088.0,2010.76
6905,37443706,2023-02-13,-97.05,1913.71
11,37443706,2023-02-14,47.25,1960.96
901,37503622,2023-01-31,,630.18
4919,37503622,2023-02-03,146.88,777.06
778,37503622,2023-02-03,-121.3,655.76
4215,37503622,2023-02-04,-1246.9,-591.1400000000001
7944,37503622,2023-02-04,-1395.3,-1986.44
6414,37503622,2023-02-09,1300.7,-685.74
2582,37503622,2023-02-09,103.16,-582.58
1717,37503622,2023-02-09,-102.69,-685.27
902,37510139,2023-01-31,,546.33
3415,37510139,2023-02-03,-825.8,-279.4699999999999
6354,37510139,2023-02-05,116.94,-162.52999999999992
7285,37510139,2023-02-11,42.19,-120.33999999999992
5313,37510139,2023-02-14,163.39,43.05000000000007
903,37528735,2023-01-31,,368.39
1283,37528735,2023-02-02,-92.47,275.91999999999996
1644,37528735,2023-02-07,153.3,429.22
290,37528735,2023-02-08,-42.59,386.63
5652,37528735,2023-02-11,11.3,397.93
6628,37528735,2023-02-14,89.42,487.35
904,37561049,2023-01-31,,903.95
3527,37561049,2023-02-01,-80.58,823.37
5520,37561049,2023-02-02,-140.34,683.03
8360,37561049,2023-02-03,-78.66,604.37
8183,37561049,2023-02-04,96.78,701.1500000000001
1508,37561049,2023-02-04,2.86,704.01
542,37561049,2023-02-05,1922.5,2626.51
7888,37561049,2023-02-13,163.33,2789.84
2757,37561049,2023-02-13,-156.37,2633.47
649,37561049,2023-02-14,113.07,2746.54
905,37599317,2023-01-31,,177.32
57,37599317,2023-02-02,116.43,293.75
4606,37599317,2023-02-03,-167.61,126.13999999999999
5255,37599317,2023-02-09,56.53,182.67
6063,37599317,2023-02-11,73.62,256.28999999999996
8146,37599317,2023-02-11,-103.41,152.88
817,37599317,2023-02-12,-132.48,20.400000000000006
906,37642787,2023-01-31,,396.03
8383,37642787,2023-02-03,78.28,474.30999999999995
6319,37642787,2023-02-03,1.03,475.34
7510,37642787,2023-02-03,-187.7,287.64
4871,37642787,2023-02-04,-127.76,159.88
4952,37642787,2023-02-06,-48.31,111.56999999999998
4378,37642787,2023-02-10,1289.6,1401.1699999999998
422,37642787,2023-02-10,25.31,1426.4799999999998
3321,37642787,2023-02-14,159.09,1585.57
907,37658218,2023-01-31,,561.27
2761,37658218,2023-02-01,570.3,1131.57
1450,37658218,2023-02-02,-39.87,1091.7
3095,37658218,2023-02-07,43.63,1135.33
8130,37658218,2023-02-09,-83.42,1051.9099999999999
5731,37658218,2023-02-14,-85.5,966.41
4915,37658218,2023-02-14,-101.53,864.8799999999999
908,37678813,2023-01-31,,767.56
1501,37678813,2023-02-03,-67.35,700.2099999999999
7326,37678813,2023-02-08,-105.41,594.8
8686,37678813,2023-02-13,78.14,672.9399999999999
913,37678813,2023-02-13,66.23,739.17
909,37767441,2023-01-31,,726.46
6480,37767441,2023-02-01,-88.19,638.27
8133,37767441,2023-02-02,-15.8,622.47
7526,37767441,2023-02-03,94.83,717.3000000000001
6882,37767441,2023-02-08,87.01,804.3100000000001
5012,37767441,2023-02-09,64.96,869.27
1919,37767441,2023-02-12,169.44,1038.71
910,37789180,2023-01-31,,854.05
7754,37789180,2023-02-02,-75.99,778.06
1463,37789180,2023-02-03,19.89,797.9499999999999
4470,37789180,2023-02-07,84.83,882.78
3808,37789180,2023-02-08,1621.0,2503.7799999999997
1979,37789180,2023-02-09,-1726.4,777.3799999999999
5056,37789180,2023-02-11,1037.0,1814.3799999999999
5781,37789180,2023-02-11,64.84,1879.2199999999998
8506,37789180,2023-02-11,26.87,1906.09
8210,37789180,2023-02-12,-66.32,1839.77
625,37789180,2023-02-13,-147.5,1692.27
911,37796234,2023-01-31,,992.46
7127,37796234,2023-02-02,1698.0,2690.46
5919,37796234,2023-02-02,54.93,2745.39
4213,37796234,2023-02-04,189.38,2934.77
4313,37796234,2023-02-04,-84.12,2850.65
8241,37796234,2023-02-04,-84.91,2765.7400000000002
7342,37796234,2023-02-06,63.36,2829.1
4433,37796234,2023-02-08,1096.2,3925.3
6050,37796234,2023-02-09,38.71,3964.01
8495,37796234,2023-02-09,-173.2,3790.8100000000004
912,37830423,2023-01-31,,285.5
238,37830423,2023-02-02,-84.91,200.59
5385,37830423,2023-02-04,120.69,321.28
381,37830423,2023-02-05,55.38,376.66
6975,37830423,2023-02-07,-69.94,306.72
8271,37830423,2023-02-08,19.11,325.83
5416,37830423,2023-02-08,17.63,343.46
2870,37830423,2023-02-13,-63.17,280.28999999999996
913,37878074,2023-01-31,,647.56
5902,37878074,2023-02-01,-124.69,522.8699999999999
8470,37878074,2023-02-03,-1218.0,-695.1300000000001
8648,37878074,2023-02-04,-36.24,-731.3700000000001
7829,37878074,2023-02-11,-102.13,-833.5000000000001
495,37878074,2023-02-11,-117.62,-951.1200000000001
1330,37878074,2023-02-11,-720.7,-1671.8200000000002
914,37905098,2023-01-31,,389.98
4868,37905098,2023-02-04,112.65,502.63
5609,37905098,2023-02-07,-37.9,464.73
7134,37905098,2023-02-07,-92.13,372.6
1467,37905098,2023-02-07,-197.62,174.98000000000002
7326,37905098,2023-02-08,105.41,280.39
5543,37905098,2023-02-09,109.67,390.06
2936,37905098,2023-02-11,80.85,470.91
2252,37905098,2023-02-12,-125.27,345.64
3055,37905098,2023-02-12,-170.43,175.21
915,37936898,2023-01-31,,745.79
3593,37936898,2023-02-01,-104.85,640.9399999999999
4273,37936898,2023-02-03,-98.53,542.41
3405,37936898,2023-02-06,159.49,701.9
6372,37936898,2023-02-06,-999.1,-297.20000000000005
311,37936898,2023-02-10,163.93,-133.27000000000004
8464,37936898,2023-02-10,62.15,-71.12000000000003
117,37936898,2023-02-11,-86.98,-158.10000000000005
4749,37936898,2023-02-13,73.86,-84.24000000000005
916,37945317,2023-01-31,,8.24
5092,37945317,2023-02-02,122.81,131.05
5746,37945317,2023-02-03,529.6,660.6500000000001
1158,37945317,2023-02-06,-120.15,540.5
7229,37945317,2023-02-07,1689.7,2230.2
7755,37945317,2023-02-09,-108.53,2121.67
5747,37945317,2023-02-09,-217.27,1904.4
1498,37945317,2023-02-10,1524.4,3428.8
7885,37945317,2023-02-12,89.44,3518.2400000000002
631,37945317,2023-02-14,-100.7,3417.54
917,37953007,2023-01-31,,440.78
4079,37953007,2023-02-02,-68.21,372.57
5389,37953007,2023-02-04,130.12,502.69
1389,37953007,2023-02-04,-786.1,-283.41
918,38032055,2023-01-31,,416.47
8659,38032055,2023-02-04,-32.51,383.96000000000004
4877,38032055,2023-02-07,12.66,396.62
2041,38032055,2023-02-07,-155.12,241.50000000000003
3701,38032055,2023-02-10,-121.29,120.21000000000002
7622,38032055,2023-02-10,-386.8,-266.59
2853,38032055,2023-02-12,147.01,-119.57999999999998
6942,38032055,2023-02-14,88.36,-31.219999999999985
919,38038623,2023-01-31,,526.98
7485,38038623,2023-02-05,1345.1,1872.08
1663,38038623,2023-02-06,-55.26,1816.82
7341,38038623,2023-02-10,-124.93,1691.8899999999999
3864,38038623,2023-02-13,-148.57,1543.32
1636,38038623,2023-02-14,-195.92,1347.3999999999999
920,38124225,2023-01-31,,943.59
6331,38124225,2023-02-05,107.79,1051.38
1981,38124225,2023-02-08,91.24,1142.6200000000001
471,38124225,2023-02-08,-114.16,1028.46
7478,38124225,2023-02-09,-101.24,927.22
8338,38124225,2023-02-09,-145.58,781.6400000000001
1712,38124225,2023-02-10,114.32,895.96
1148,38124225,2023-02-10,63.35,959.3100000000001
7529,38124225,2023-02-13,65.9,1025.21
921,38157078,2023-01-31,,756.55
538,38157078,2023-02-04,664.6,1421.15
4292,38157078,2023-02-07,-86.52,1334.6299999999999
377,38157078,2023-02-13,-169.97,1164.6599999999999
922,38224160,2023-01-31,,701.82
6385,38224160,2023-02-02,-92.9,608.9200000000001
1423,38224160,2023-02-03,-119.1,489.82000000000005
8231,38224160,2023-02-07,-75.95,413.87000000000006
5073,38224160,2023-02-13,-76.04,337.83000000000004
923,38291062,2023-01-31,,486.68
5217,38291062,2023-02-01,-82.42,404.26
582,38291062,2023-02-05,-78.67,325.59000000000003
2618,38291062,2023-02-06,246.82,572.41
3090,38291062,2023-02-11,1.71,574.12
3849,38291062,2023-02-12,-119.93,454.19
4384,38291062,2023-02-14,77.33,531.52
1418,38291062,2023-02-14,-105.25,426.27
924,38316158,2023-01-31,,138.4
3898,38316158,2023-02-02,74.49,212.89
3211,38316158,2023-02-05,227.66,440.55
4655,38316158,2023-02-05,92.28,532.83
4943,38316158,2023-02-07,35.98,568.8100000000001
945,38316158,2023-02-08,24.76,593.57
1783,38316158,2023-02-14,-53.27,540.3
925,38346624,2023-01-31,,740.09
6953,38346624,2023-02-10,737.2,1477.29
1737,38346624,2023-02-10,185.21,1662.5
926,38395807,2023-01-31,,463.52
5210,38395807,2023-02-07,144.93,608.45
3913,38395807,2023-02-08,44.05,652.5
4575,38395807,2023-02-09,-40.77,611.73
761,38395807,2023-02-12,91.23,702.96
927,38428295,2023-01-31,,690.12
5558,38428295,2023-02-08,-199.46,490.65999999999997
3034,38428295,2023-02-11,-167.56,323.1
6557,38428295,2023-02-13,-128.11,194.98999999999998
8260,38428295,2023-02-14,-170.29,24.69999999999999
928,38429514,2023-01-31,,627.62
1352,38429514,2023-02-01,-72.18,555.44
2130,38429514,2023-02-04,-119.83,435.61
806,38429514,2023-02-08,-108.02,327.59000000000003
1080,38429514,2023-02-10,-139.76,187.83
5979,38429514,2023-02-11,47.32,235.15
4146,38429514,2023-02-12,102.95,338.1
8177,38429514,2023-02-14,53.96,392.06
929,38442044,2023-01-31,,106.95
6433,38442044,2023-02-02,64.9,171.85000000000002
3865,38442044,2023-02-03,-23.84,148.01000000000002
6455,38442044,2023-02-06,50.95,198.96
6642,38442044,2023-02-07,113.13,312.09000000000003
356,38442044,2023-02-07,-144.16,167.93
4084,38442044,2023-02-07,-152.25,15.680000000000007
3202,38442044,2023-02-08,57.77,73.45000000000002
1659,38442044,2023-02-08,34.12,107.57000000000001
1997,38442044,2023-02-12,98.65,206.22000000000003
6318,38442044,2023-02-14,860.1,1066.3200000000002
930,38487215,2023-01-31,,780.01
7099,38487215,2023-02-01,808.4,1588.4099999999999
8626,38487215,2023-02-03,118.95,1707.36
4121,38487215,2023-02-03,-128.1,1579.26
1007,38487215,2023-02-06,-1543.0,36.25999999999999
931,38495059,2023-01-31,,14.18
1083,38495059,2023-02-02,-36.6,-22.42
4078,38495059,2023-02-06,-42.54,-64.96000000000001
4718,38495059,2023-02-11,-136.0,-200.96
932,38502892,2023-01-31,,600.32
7486,38502892,2023-02-06,-62.08,538.24
2979,38502892,2023-02-07,71.61,609.85
7402,38502892,2023-02-08,-47.37,562.48
933,38528119,2023-01-31,,165.9
1409,38528119,2023-02-06,78.29,244.19
4527,38528119,2023-02-06,-191.25,52.94
1149,38528119,2023-02-08,-167.66,-114.72
1569,38528119,2023-02-13,168.95,54.22999999999999
6101,38528119,2023-02-14,116.52,170.75
934,38558525,2023-01-31,,833.07
5146,38558525,2023-02-04,62.25,895.32
688,38558525,2023-02-07,1819.0,2714.32
6727,38558525,2023-02-08,194.3,2908.6200000000003
935,38564653,2023-01-31,,647.95
413,38564653,2023-02-03,3.5,651.45
7132,38564653,2023-02-05,104.58,756.0300000000001
7680,38564653,2023-02-12,133.45,889.48
7974,38564653,2023-02-13,93.97,983.45
936,38587383,2023-01-31,,579.12
4060,38587383,2023-02-01,81.07,660.19
5135,38587383,2023-02-01,-146.1,514.09
3076,38587383,2023-02-03,110.66,624.75
7776,38587383,2023-02-03,-39.37,585.38
5971,38587383,2023-02-04,-162.1,423.28
7717,38587383,2023-02-07,124.31,547.59
4324,38587383,2023-02-07,-166.27,381.32
5431,38587383,2023-02-09,-118.41,262.90999999999997
6040,38587383,2023-02-12,-37.14,225.76999999999998
2586,38587383,2023-02-12,-82.59,143.18
937,38606148,2023-01-31,,956.59
1131,38606148,2023-02-02,-111.16,845.4300000000001
3455,38606148,2023-02-04,67.91,913.34
5788,38606148,2023-02-04,-72.53,840.8100000000001
837,38606148,2023-02-06,-26.04,814.77
5184,38606148,2023-02-11,-132.56,682.21
1570,38606148,2023-02-12,131.58,813.7900000000001
1598,38606148,2023-02-12,-1323.4,-509.61
938,38627867,2023-01-31,,132.74
2538,38627867,2023-02-05,-99.91,32.83000000000001
1868,38627867,2023-02-06,70.94,103.77000000000001
7821,38627867,2023-02-14,-102.09,1.6800000000000068
939,38690875,2023-01-31,,320.39
6250,38690875,2023-02-03,-126.21,194.18
6616,38690875,2023-02-06,-198.2,-4.019999999999982
4842,38690875,2023-02-11,-147.09,-151.10999999999999
5736,38690875,2023-02-13,-76.09,-227.2
5587,38690875,2023-02-13,-104.24,-331.44
3551,38690875,2023-02-14,-122.9,-454.34
940,38740782,2023-01-31,,702.64
330,38740782,2023-02-04,-133.55,569.0899999999999
6663,38740782,2023-02-05,-61.09,508.0
7613,38740782,2023-02-12,76.1,584.0999999999999
2219,38740782,2023-02-12,-84.07,500.03
941,38749064,2023-01-31,,569.98
382,38749064,2023-02-01,143.97,713.95
1309,38749064,2023-02-02,-1436.3,-722.3499999999999
284,38749064,2023-02-03,89.06,-633.29
1089,38749064,2023-02-14,138.71,-494.5799999999999
942,38764064,2023-01-31,,648.12
8306,38764064,2023-02-01,52.17,700.29
8133,38764064,2023-02-02,15.8,716.09
7293,38764064,2023-02-07,106.64,822.73
6947,38764064,2023-02-09,32.87,855.6
4026,38764064,2023-02-11,9.25,864.85
125,38764064,2023-02-13,96.51,961.36
3784,38764064,2023-02-14,58.88,1020.24
943,38780970,2023-01-31,,846.59
3166,38780970,2023-02-01,-118.27,728.32
6445,38780970,2023-02-04,117.26,845.58
5331,38780970,2023-02-07,54.28,899.86
1805,38780970,2023-02-10,47.87,947.73
6141,38780970,2023-02-13,-838.9,108.83000000000004
944,38839019,2023-01-31,,187.15
4574,38839019,2023-02-01,937.1,1124.25
686,38839019,2023-02-01,-52.99,1071.26
6495,38839019,2023-02-02,-156.04,915.22
2852,38839019,2023-02-08,113.98,1029.2
6594,38839019,2023-02-11,106.4,1135.6
7914,38839019,2023-02-11,-164.37,971.23
1802,38839019,2023-02-14,170.57,1141.8
945,38903150,2023-01-31,,263.28
6036,38903150,2023-02-03,-96.77,166.51
1854,38903150,2023-02-04,-128.19,38.31999999999999
4985,38903150,2023-02-07,-188.36,-150.04000000000002
2140,38903150,2023-02-10,153.84,3.799999999999983
4499,38903150,2023-02-10,84.17,87.96999999999998
8612,38903150,2023-02-11,-133.59,-45.62000000000002
1641,38903150,2023-02-14,-1157.1,-1202.72
946,38921478,2023-01-31,,641.48
7564,38921478,2023-02-02,112.16,753.64
3180,38921478,2023-02-03,-7.7,745.94
8408,38921478,2023-02-04,-90.13,655.8100000000001
452,38921478,2023-02-05,69.58,725.39
662,38921478,2023-02-05,-1292.8,-567.41
6177,38921478,2023-02-07,46.92,-520.49
558,38921478,2023-02-10,-114.74,-635.23
3278,38921478,2023-02-12,105.2,-530.03
921,38921478,2023-02-13,-43.56,-573.5899999999999
3149,38921478,2023-02-14,-130.84,-704.43
947,38957380,2023-01-31,,37.95
2075,38957380,2023-02-02,-117.9,-79.95
4123,38957380,2023-02-03,75.66,-4.290000000000006
516,38957380,2023-02-04,88.83,84.53999999999999
5383,38957380,2023-02-07,-112.51,-27.970000000000013
505,38957380,2023-02-07,-123.7,-151.67000000000002
5774,38957380,2023-02-07,-133.96,-285.63
8353,38957380,2023-02-10,167.95,-117.68000000000004
752,38957380,2023-02-10,121.27,3.589999999999961
2856,38957380,2023-02-13,-128.09,-124.50000000000004
948,38969279,2023-01-31,,195.74
4050,38969279,2023-02-02,148.09,343.83000000000004
2670,38969279,2023-02-04,1579.8,1923.63
378,38969279,2023-02-04,-5.54,1918.09
777,38969279,2023-02-05,177.45,2095.54
7452,38969279,2023-02-05,-2160.7,-65.15999999999985
3419,38969279,2023-02-06,1037.3,972.1400000000001
5858,38969279,2023-02-10,1499.1,2471.24
2918,38969279,2023-02-12,103.8,2575.04
949,38990596,2023-01-31,,108.78
3268,38990596,2023-02-03,1462.8,1571.58
2049,38990596,2023-02-07,1348.3,2919.88
7062,38990596,2023-02-07,-24.33,2895.5499999999997
5711,38990596,2023-02-10,125.04,3020.5899999999997
1838,38990596,2023-02-12,-93.42,2927.17
2579,38990596,2023-02-13,-122.16,2805.0099999999998
950,38991889,2023-01-31,,292.35
4957,38991889,2023-02-05,-104.95,187.40000000000003
2898,38991889,2023-02-08,-162.63,24.77000000000004
1323,38991889,2023-02-10,23.96,48.73000000000004
6969,38991889,2023-02-10,-75.71,-26.979999999999954
7678,38991889,2023-02-12,129.0,102.02000000000004
1566,38991889,2023-02-14,-38.92,63.10000000000004
951,39001531,2023-01-31,,882.34
5392,39001531,2023-02-03,-68.13,814.21
7547,39001531,2023-02-06,-48.43,765.7800000000001
8353,39001531,2023-02-10,-167.95,597.83
6546,39001531,2023-02-13,-110.74,487.09000000000003
952,39013360,2023-01-31,,987.76
7512,39013360,2023-02-02,111.21,1098.97
6776,39013360,2023-02-03,183.87,1282.84
36,39013360,2023-02-07,-80.19,1202.65
3022,39013360,2023-02-12,160.33,1362.98
7209,39013360,2023-02-12,114.77,1477.75
6456,39013360,2023-02-12,108.16,1585.91
6961,39013360,2023-02-12,93.42,1679.33
844,39013360,2023-02-12,-1663.0,16.329999999999927
953,39061853,2023-01-31,,353.93
8117,39061853,2023-02-01,98.05,451.98
7534,39061853,2023-02-03,118.33,570.31
7265,39061853,2023-02-03,106.6,676.91
1668,39061853,2023-02-04,74.21,751.12
8570,39061853,2023-02-04,0.23,751.35
1713,39061853,2023-02-04,-58.86,692.49
8627,39061853,2023-02-05,-117.54,574.95
4934,39061853,2023-02-07,-100.32,474.63
7334,39061853,2023-02-09,-185.1,289.53
4996,39061853,2023-02-12,-86.65,202.88
1632,39061853,2023-02-14,-82.4,120.47999999999999
954,39093565,2023-01-31,,107.2
2531,39093565,2023-02-04,-178.94,-71.74
8079,39093565,2023-02-08,-1872.8,-1944.54
8573,39093565,2023-02-10,92.49,-1852.05
955,39097663,2023-01-31,,326.42
2719,39097663,2023-02-02,124.78,451.20000000000005
4661,39097663,2023-02-08,67.17,518.37
1691,39097663,2023-02-12,125.48,643.85
8441,39097663,2023-02-12,-40.07,603.78
956,39122920,2023-01-31,,445.68
6404,39122920,2023-02-08,124.8,570.48
4261,39122920,2023-02-08,66.97,637.45
2733,39122920,2023-02-09,134.75,772.2
7341,39122920,2023-02-10,124.93,897.13
5089,39122920,2023-02-12,56.08,953.21
7898,39122920,2023-02-12,-111.7,841.51
5357,39122920,2023-02-13,96.04,937.55
8458,39122920,2023-02-13,22.49,960.04
8086,39122920,2023-02-14,-75.01,885.03
3306,39122920,2023-02-14,-142.18,742.8499999999999
957,39123048,2023-01-31,,687.59
3566,39123048,2023-02-01,83.41,771.0
7438,39123048,2023-02-01,-92.64,678.36
5529,39123048,2023-02-03,-87.46,590.9000000000001
958,39123048,2023-02-03,-513.3,77.60000000000014
5266,39123048,2023-02-08,-135.88,-58.27999999999986
5402,39123048,2023-02-09,-140.35,-198.62999999999985
6989,39123048,2023-02-09,-157.79,-356.41999999999985
8500,39123048,2023-02-10,-13.9,-370.3199999999998
2634,39123048,2023-02-12,-122.43,-492.7499999999999
7880,39123048,2023-02-14,140.0,-352.7499999999999
958,39160879,2023-01-31,,444.15
4738,39160879,2023-02-01,-186.89,257.26
7848,39160879,2023-02-04,133.05,390.31
6141,39160879,2023-02-13,838.9,1229.21
6806,39160879,2023-02-14,302.7,1531.9099999999999
959,39161053,2023-01-31,,375.28
8489,39161053,2023-02-01,142.14,517.42
7374,39161053,2023-02-01,-156.89,360.53
6758,39161053,2023-02-02,93.84,454.37
6249,39161053,2023-02-03,103.43,557.8
7931,39161053,2023-02-05,480.6,1038.4
6852,39161053,2023-02-05,-137.15,901.25
7790,39161053,2023-02-07,53.14,954.39
2571,39161053,2023-02-14,-114.68,839.7099999999999
960,39267013,2023-01-31,,516.74
8511,39267013,2023-02-02,-1495.8,-979.06
4209,39267013,2023-02-03,-67.76,-1046.82
4782,39267013,2023-02-04,-68.14,-1114.96
3191,39267013,2023-02-12,-89.62,-1204.58
3225,39267013,2023-02-14,-143.79,-1348.37
961,39298122,2023-01-31,,607.25
8273,39298122,2023-02-01,135.0,742.25
427,39298122,2023-02-02,122.54,864.79
8584,39298122,2023-02-03,193.29,1058.08
8009,39298122,2023-02-06,-885.9,172.18000000000006
5723,39298122,2023-02-08,-154.47,17.710000000000065
2406,39298122,2023-02-12,-53.57,-35.859999999999935
6415,39298122,2023-02-13,-32.94,-68.79999999999993
962,39360799,2023-01-31,,379.72
439,39360799,2023-02-01,-98.45,281.27000000000004
1795,39360799,2023-02-01,-137.25,144.02000000000004
7760,39360799,2023-02-01,-1634.7,-1490.68
2014,39360799,2023-02-07,43.24,-1447.44
2422,39360799,2023-02-13,117.96,-1329.48
963,39386771,2023-01-31,,171.52
2507,39386771,2023-02-02,99.44,270.96000000000004
1674,39386771,2023-02-02,-87.3,183.66000000000003
8557,39386771,2023-02-04,-94.61,89.05000000000001
7732,39386771,2023-02-04,-162.76,-73.70999999999998
6883,39386771,2023-02-10,107.08,33.37000000000002
126,39386771,2023-02-10,85.88,119.25000000000001
3862,39386771,2023-02-10,-57.19,62.06000000000002
964,39398476,2023-01-31,,541.52
3327,39398476,2023-02-02,106.61,648.13
6337,39398476,2023-02-07,116.86,764.99
5805,39398476,2023-02-10,100.16,865.15
965,39400991,2023-01-31,,896.44
7264,39400991,2023-02-05,10.32,906.7600000000001
3985,39400991,2023-02-11,38.45,945.21
3459,39400991,2023-02-13,93.58,1038.79
966,39402264,2023-01-31,,993.04
580,39402264,2023-02-01,1255.3,2248.34
7798,39402264,2023-02-05,126.99,2375.33
902,39402264,2023-02-07,99.51,2474.84
2649,39402264,2023-02-07,-98.93,2375.91
5772,39402264,2023-02-11,-1949.6,426.30999999999995
2972,39402264,2023-02-14,-117.68,308.62999999999994
487,39402264,2023-02-14,-241.71,66.91999999999993
967,39427922,2023-01-31,,794.1
2948,39427922,2023-02-01,-131.53,662.57
7443,39427922,2023-02-02,145.85,808.4200000000001
723,39427922,2023-02-03,140.5,948.9200000000001
7306,39427922,2023-02-04,-163.28,785.64
6182,39427922,2023-02-07,-146.82,638.82
3158,39427922,2023-02-08,-117.07,521.75
6225,39427922,2023-02-13,30.41,552.1600000000001
4521,39427922,2023-02-14,-163.28,388.88
968,39491241,2023-01-31,,564.0
4288,39491241,2023-02-02,100.0,664.0
5038,39491241,2023-02-05,122.18,786.1800000000001
1282,39491241,2023-02-06,79.45,865.63
7819,39491241,2023-02-08,115.63,981.26
6051,39491241,2023-02-12,80.63,1061.89
2048,39491241,2023-02-12,-120.9,940.99
969,39502821,2023-01-31,,924.88
8078,39502821,2023-02-03,321.6,1246.48
3104,39502821,2023-02-03,-28.45,1218.03
2892,39502821,2023-02-05,26.93,1244.96
464,39502821,2023-02-09,-59.28,1185.68
7188,39502821,2023-02-09,-136.48,1049.2
3683,39502821,2023-02-12,-206.28,842.9200000000001
970,39504855,2023-01-31,,890.63
1517,39504855,2023-02-02,118.6,1009.23
1005,39504855,2023-02-05,-124.37,884.86
1663,39504855,2023-02-06,55.26,940.12
2597,39504855,2023-02-11,1000.2,1940.3200000000002
2722,39504855,2023-02-11,-93.32,1847.0
4354,39504855,2023-02-12,3.07,1850.0700000000002
6633,39504855,2023-02-14,-72.35,1777.72
971,39516154,2023-01-31,,620.87
3044,39516154,2023-02-02,-1273.1,-652.2299999999999
7108,39516154,2023-02-06,22.66,-629.5699999999999
4256,39516154,2023-02-11,-1094.0,-1723.57
2842,39516154,2023-02-12,-106.02,-1829.59
2440,39516154,2023-02-13,157.09,-1672.5
2652,39516154,2023-02-13,-62.08,-1734.58
972,39516203,2023-01-31,,689.19
1676,39516203,2023-02-03,129.19,818.3800000000001
2484,39516203,2023-02-07,-186.08,632.3000000000001
1341,39516203,2023-02-10,93.02,725.32
7775,39516203,2023-02-11,30.47,755.7900000000001
5904,39516203,2023-02-11,23.0,778.7900000000001
7882,39516203,2023-02-13,-112.31,666.48
2028,39516203,2023-02-14,172.96,839.44
973,39529729,2023-01-31,,425.66
7096,39529729,2023-02-01,86.44,512.1
3828,39529729,2023-02-02,38.74,550.84
560,39529729,2023-02-06,35.38,586.22
7624,39529729,2023-02-07,-78.85,507.37
2408,39529729,2023-02-11,-226.92,280.45000000000005
886,39529729,2023-02-12,100.01,380.46000000000004
4688,39529729,2023-02-13,-63.85,316.61000000000007
974,39542358,2023-01-31,,671.28
3217,39542358,2023-02-06,-48.45,622.8299999999999
6209,39542358,2023-02-07,107.26,730.0899999999999
1575,39542358,2023-02-08,522.3,1252.3899999999999
7344,39542358,2023-02-08,257.4,1509.79
4874,39542358,2023-02-08,-71.61,1438.1799999999998
5711,39542358,2023-02-10,-125.04,1313.1399999999999
1778,39542358,2023-02-11,2361.6,3674.74
3969,39542358,2023-02-11,1168.2,4842.94
6464,39542358,2023-02-11,-62.18,4780.76
975,39590347,2023-01-31,,180.22
4994,39590347,2023-02-04,-35.8,144.42000000000002
7863,39590347,2023-02-05,-101.45,42.97
2378,39590347,2023-02-09,-165.46,-122.49000000000001
3234,39590347,2023-02-12,-57.89,-180.38
759,39590347,2023-02-12,-133.67,-314.05
976,39602737,2023-01-31,,881.44
2836,39602737,2023-02-06,83.89,965.33
2973,39602737,2023-02-13,-95.71,869.6200000000001
977,39620163,2023-01-31,,126.08
5198,39620163,2023-02-03,-126.76,-0.6800000000000068
2513,39620163,2023-02-05,-193.2,-193.88
461,39620163,2023-02-09,-59.74,-253.62
8445,39620163,2023-02-10,27.61,-226.01
2634,39620163,2023-02-12,122.43,-103.57999999999998
3728,39620163,2023-02-12,-105.79,-209.37
5087,39620163,2023-02-14,-99.23,-308.6
978,39623640,2023-01-31,,617.74
500,39623640,2023-02-03,141.26,759.0
6669,39623640,2023-02-03,62.98,821.98
4480,39623640,2023-02-03,-163.12,658.86
8228,39623640,2023-02-09,-136.79,522.0699999999999
2042,39623640,2023-02-09,-176.29,345.78
1731,39623640,2023-02-10,-186.7,159.08
4212,39623640,2023-02-11,94.12,253.20000000000002
979,39662559,2023-01-31,,536.88
4438,39662559,2023-02-06,106.77,643.65
4536,39662559,2023-02-08,-45.23,598.42
493,39662559,2023-02-09,140.11,738.53
8453,39662559,2023-02-09,78.03,816.56
7015,39662559,2023-02-13,45.1,861.66
980,39684993,2023-01-31,,168.99
1705,39684993,2023-02-03,612.6,781.59
8594,39684993,2023-02-04,102.22,883.8100000000001
3919,39684993,2023-02-05,27.15,910.96
6349,39684993,2023-02-06,-146.22,764.74
7172,39684993,2023-02-08,83.02,847.76
946,39684993,2023-02-14,47.11,894.87
981,39710099,2023-01-31,,155.88
6764,39710099,2023-02-01,105.76,261.64
5908,39710099,2023-02-02,-191.44,70.19999999999999
8535,39710099,2023-02-05,-63.96,6.239999999999988
448,39710099,2023-02-09,-105.33,-99.09
3272,39710099,2023-02-11,-82.76,-181.85000000000002
5633,39710099,2023-02-13,-211.13,-392.98
982,39744047,2023-01-31,,505.93
7643,39744047,2023-02-08,103.57,609.5
675,39744047,2023-02-14,1583.4,2192.9
3439,39744047,2023-02-14,-55.79,2137.11
983,39749381,2023-01-31,,576.13
7448,39749381,2023-02-02,-70.63,505.5
3314,39749381,2023-02-03,16.93,522.43
531,39749381,2023-02-03,-207.91,314.52
8322,39749381,2023-02-04,91.7,406.22
6559,39749381,2023-02-06,158.11,564.33
2128,39749381,2023-02-06,142.55,706.8800000000001
7040,39749381,2023-02-08,183.05,889.9300000000001
2502,39749381,2023-02-08,49.6,939.5300000000001
3096,39749381,2023-02-09,-156.71,782.82
3476,39749381,2023-02-11,-143.94,638.8800000000001
638,39749381,2023-02-14,52.36,691.24
984,39772392,2023-01-31,,370.34
8369,39772392,2023-02-01,101.28,471.62
1879,39772392,2023-02-01,-116.66,354.96
6862,39772392,2023-02-02,179.0,533.96
3180,39772392,2023-02-03,7.7,541.66
7041,39772392,2023-02-08,38.27,579.93
1581,39772392,2023-02-09,-108.57,471.36
5360,39772392,2023-02-10,171.22,642.5799999999999
985,39822234,2023-01-31,,718.73
2289,39822234,2023-02-02,681.0,1399.73
175,39822234,2023-02-02,97.9,1497.63
3066,39822234,2023-02-04,113.62,1611.25
2354,39822234,2023-02-05,17.88,1629.13
2758,39822234,2023-02-09,159.54,1788.67
2171,39822234,2023-02-09,40.77,1829.44
5718,39822234,2023-02-10,-849.7,979.74
1521,39822234,2023-02-14,64.1,1043.84
986,39863459,2023-01-31,,387.4
1605,39863459,2023-02-02,-121.1,266.29999999999995
6532,39863459,2023-02-04,-48.63,217.67
8393,39863459,2023-02-13,101.87,319.53999999999996
890,39863459,2023-02-13,-123.49,196.05
987,39875057,2023-01-31,,126.02
1014,39875057,2023-02-05,-149.4,-23.38000000000001
7268,39875057,2023-02-09,-115.89,-139.27
2341,39875057,2023-02-11,96.34,-42.93000000000001
3754,39875057,2023-02-11,-126.5,-169.43
3077,39875057,2023-02-13,153.16,-16.27000000000001
3023,39875057,2023-02-14,-104.45,-120.72000000000001
988,39920664,2023-01-31,,627.45
5274,39920664,2023-02-06,101.84,729.2900000000001
6213,39920664,2023-02-10,190.65,919.94
612,39920664,2023-02-10,-72.61,847.33
989,39974803,2023-01-31,,567.93
2229,39974803,2023-02-04,85.93,653.8599999999999
6952,39974803,2023-02-04,-39.82,614.04
352,39974803,2023-02-07,-131.84,482.19999999999993
572,39974803,2023-02-08,86.91,569.1099999999999
68,39974803,2023-02-10,74.29,643.4
990,40004707,2023-01-31,,206.15
1704,40004707,2023-02-04,74.84,280.99
7898,40004707,2023-02-12,111.7,392.69
991,40039031,2023-01-31,,124.72
3148,40039031,2023-02-02,792.0,916.72
8488,40039031,2023-02-07,-1581.8,-665.0799999999999
5975,40039031,2023-02-08,157.28,-507.79999999999995
1199,40039031,2023-02-08,-35.13,-542.93
3048,40039031,2023-02-09,97.15,-445.7799999999999
929,40039031,2023-02-12,-43.72,-489.4999999999999
6114,40039031,2023-02-14,-134.52,-624.02
992,40048102,2023-01-31,,519.25
3709,40048102,2023-02-03,103.29,622.54
1901,40048102,2023-02-06,-43.89,578.65
4956,40048102,2023-02-08,-811.2,-232.55000000000007
8305,40048102,2023-02-09,-119.86,-352.4100000000001
6343,40048102,2023-02-10,168.35,-184.06000000000006
2581,40048102,2023-02-12,20.81,-163.25000000000006
993,40082477,2023-01-31,,171.74
3347,40082477,2023-02-01,-131.11,40.629999999999995
361,40082477,2023-02-07,86.16,126.78999999999999
7850,40082477,2023-02-09,1434.1,1560.8899999999999
6247,40082477,2023-02-09,135.47,1696.36
3369,40082477,2023-02-11,-49.15,1647.2099999999998
757,40082477,2023-02-13,121.9,1769.11
3869,40082477,2023-02-14,120.81,1889.9199999999998
994,40082950,2023-01-31,,322.41
8132,40082950,2023-02-04,40.4,362.81
2419,40082950,2023-02-04,-80.37,282.44000000000005
7840,40082950,2023-02-08,169.4,451.84000000000003
2222,40082950,2023-02-08,149.73,601.57
922,40082950,2023-02-12,171.12,772.69
995,40091206,2023-01-31,,812.34
4319,40091206,2023-02-01,86.72,899.0600000000001
1755,40091206,2023-02-08,-118.11,780.95
3479,40091206,2023-02-09,-11.2,769.75
5133,40091206,2023-02-11,-36.38,733.37
2181,40091206,2023-02-12,157.02,890.3900000000001
1009,40091206,2023-02-13,67.73,958.12
996,40098771,2023-01-31,,742.62
4460,40098771,2023-02-03,-47.78,694.84
8586,40098771,2023-02-08,-145.4,549.44
8610,40098771,2023-02-10,62.82,612.26
485,40098771,2023-02-10,-93.3,518.96
7296,40098771,2023-02-11,-60.09,458.87
6687,40098771,2023-02-14,71.12,529.99
997,40098912,2023-01-31,,951.18
2088,40098912,2023-02-08,54.56,1005.74
8403,40098912,2023-02-10,78.83,1084.57
5308,40098912,2023-02-11,47.98,1132.55
481,40098912,2023-02-14,109.46,1242.01
998,40112082,2023-01-31,,289.68
4461,40112082,2023-02-04,-97.86,191.82
1228,40112082,2023-02-12,-168.73,23.090000000000032
1965,40112082,2023-02-13,-113.44,-90.34999999999997
999,40127778,2023-01-31,,196.74
5257,40127778,2023-02-01,-85.77,110.97000000000001
2955,40127778,2023-02-02,-205.49,-94.52
123,40127778,2023-02-05,-26.38,-120.89999999999999
756,40127778,2023-02-05,-179.9,-300.8
8558,40127778,2023-02-07,-159.97,-460.77
1818,40127778,2023-02-10,-90.86,-551.63
5336,40127778,2023-02-11,-832.5,-1384.13
2174,40127778,2023-02-14,-65.19,-1449.32
1000,40176462,2023-01-31,,193.24
2952,40176462,2023-02-02,744.2,937.44
2330,40176462,2023-02-05,276.4,1213.8400000000001
2792,40176462,2023-02-06,77.47,1291.31
4077,40176462,2023-02-08,141.03,1432.3400000000001
2790,40176462,2023-02-10,-116.72,1315.6200000000001
2510,40176462,2023-02-13,33.75,1349.3700000000001
1001,40189934,2023-01-31,,804.21
5042,40189934,2023-02-02,1824.3,2628.51
6175,40189934,2023-02-04,-1705.8,922.71
8481,40189934,2023-02-07,64.02,986.73
2903,40189934,2023-02-13,-108.27,878.46
1002,40224914,2023-01-31,,53.1
5865,40224914,2023-02-01,8.07,61.17
8265,40224914,2023-02-05,-104.89,-43.72
2069,40224914,2023-02-13,-39.74,-83.46000000000001
7226,40224914,2023-02-14,91.53,8.069999999999993
1003,40247376,2023-01-31,,209.78
2451,40247376,2023-02-02,58.7,268.48
351,40247376,2023-02-04,-124.72,143.76
4567,40247376,2023-02-11,-91.93,51.83
7765,40247376,2023-02-12,-38.33,13.5
2822,40247376,2023-02-13,-49.9,-36.4
1004,40374724,2023-01-31,,692.58
84,40374724,2023-02-01,-187.15,505.43000000000006
4532,40374724,2023-02-02,36.32,541.75
4640,40374724,2023-02-03,105.36,647.11
219,40374724,2023-02-04,97.05,744.1600000000001
7561,40374724,2023-02-04,84.48,828.6400000000001
8132,40374724,2023-02-04,-40.4,788.24
1927,40374724,2023-02-05,62.34,850.58
4894,40374724,2023-02-05,-63.32,787.26
6965,40374724,2023-02-06,-160.25,627.01
1445,40374724,2023-02-09,-60.37,566.6400000000001
8563,40374724,2023-02-10,58.79,625.4300000000001
5290,40374724,2023-02-14,1139.7,1765.13
4130,40374724,2023-02-14,-95.2,1669.93
1005,40436811,2023-01-31,,445.93
8038,40436811,2023-02-03,-40.33,405.6
5458,40436811,2023-02-03,-55.47,350.13
4818,40436811,2023-02-08,-66.67,283.46000000000004
4234,40436811,2023-02-11,42.48,325.94
2144,40436811,2023-02-13,30.92,356.86
860,40436811,2023-02-13,-81.01,275.85
1006,40507682,2023-01-31,,524.63
5854,40507682,2023-02-01,86.68,611.31
8602,40507682,2023-02-02,-83.88,527.4300000000001
192,40507682,2023-02-08,53.13,580.5600000000001
5595,40507682,2023-02-10,-74.41,506.15
5725,40507682,2023-02-12,118.43,624.58
916,40507682,2023-02-12,-77.47,547.11
425,40507682,2023-02-13,76.49,623.6
6100,40507682,2023-02-14,1514.1,2137.7
1007,40530538,2023-01-31,,364.98
4908,40530538,2023-02-06,-13.61,351.37
6934,40530538,2023-02-06,-16.08,335.29
6013,40530538,2023-02-06,-87.21,248.08000000000004
700,40530538,2023-02-07,166.24,414.32000000000005
8509,40530538,2023-02-07,27.47,441.7900000000001
8685,40530538,2023-02-13,-112.38,329.4100000000001
1008,40548885,2023-01-31,,160.32
6980,40548885,2023-02-04,-25.82,134.5
3687,40548885,2023-02-05,130.7,265.2
8412,40548885,2023-02-07,117.32,382.52
1441,40548885,2023-02-12,56.37,438.89
3437,40548885,2023-02-13,334.9,773.79
2730,40548885,2023-02-14,-68.84,704.9499999999999
1009,40550712,2023-01-31,,511.4
4761,40550712,2023-02-05,85.05,596.4499999999999
6395,40550712,2023-02-06,-72.25,524.1999999999999
6334,40550712,2023-02-06,-98.85,425.34999999999997
456,40550712,2023-02-07,-112.11,313.24
4656,40550712,2023-02-09,-84.03,229.20999999999998
719,40550712,2023-02-11,149.28,378.49
1010,40551490,2023-01-31,,569.45
4939,40551490,2023-02-04,95.01,664.46
6554,40551490,2023-02-04,-761.9,-97.43999999999994
7718,40551490,2023-02-05,101.23,3.790000000000063
2309,40551490,2023-02-12,76.51,80.30000000000007
1011,40600852,2023-01-31,,15.08
1751,40600852,2023-02-01,57.48,72.56
5544,40600852,2023-02-01,32.39,104.94999999999999
8466,40600852,2023-02-06,157.94,262.89
4770,40600852,2023-02-08,-146.43,116.45999999999998
3935,40600852,2023-02-09,24.49,140.95
5802,40600852,2023-02-10,-34.9,106.04999999999998
6185,40600852,2023-02-11,154.67,260.71999999999997
1614,40600852,2023-02-11,-111.87,148.84999999999997
5270,40600852,2023-02-11,-667.1,-518.25
7626,40600852,2023-02-13,-93.21,-611.4600000000002
1012,40631802,2023-01-31,,104.96
3060,40631802,2023-02-02,136.28,241.24
3140,40631802,2023-02-02,-528.9,-287.65999999999997
3609,40631802,2023-02-04,189.3,-98.35999999999996
7429,40631802,2023-02-06,136.61,38.25000000000006
689,40631802,2023-02-08,-714.2,-675.95
8644,40631802,2023-02-10,-92.9,-768.85
1013,40673170,2023-01-31,,124.66
7230,40673170,2023-02-01,95.49,220.14999999999998
5282,40673170,2023-02-04,-103.05,117.1
6156,40673170,2023-02-06,-80.15,36.94999999999999
51,40673170,2023-02-08,123.3,160.25
4849,40673170,2023-02-13,14.09,174.33999999999997
1014,40712298,2023-01-31,,781.72
2503,40712298,2023-02-06,107.96,889.6800000000001
2448,40712298,2023-02-07,74.11,963.79
4842,40712298,2023-02-11,147.09,1110.88
1015,40745545,2023-01-31,,460.29
253,40745545,2023-02-01,-85.94,374.35
1431,40745545,2023-02-04,-189.33,185.02
5856,40745545,2023-02-11,159.21,344.23
1077,40745545,2023-02-11,-100.04,244.19
5175,40745545,2023-02-12,-139.58,104.61000000000001
3984,40745545,2023-02-13,121.39,226.0
1016,40745965,2023-01-31,,654.15
4823,40745965,2023-02-01,-1264.3,-610.15
4851,40745965,2023-02-02,-196.6,-806.75
1638,40745965,2023-02-03,77.07,-729.68
1271,40745965,2023-02-05,-98.72,-828.4
862,40745965,2023-02-07,-42.04,-870.4399999999999
8039,40745965,2023-02-08,-100.85,-971.29
5766,40745965,2023-02-09,111.83,-859.4599999999999
7205,40745965,2023-02-09,-81.65,-941.11
1017,40797438,2023-01-31,,679.38
1633,40797438,2023-02-01,49.69,729.0699999999999
7407,40797438,2023-02-02,-153.46,575.61
6376,40797438,2023-02-03,116.69,692.3
7068,40797438,2023-02-04,-77.37,614.93
2101,40797438,2023-02-06,193.06,807.99
5115,40797438,2023-02-10,98.45,906.4399999999999
4259,40797438,2023-02-12,84.72,991.16
8288,40797438,2023-02-14,-154.35,836.81
1018,40813783,2023-01-31,,288.51
4522,40813783,2023-02-03,130.36,418.87
6960,40813783,2023-02-06,32.2,451.07
6651,40813783,2023-02-07,119.18,570.25
2725,40813783,2023-02-14,-182.1,388.15000000000003
1019,40872555,2023-01-31,,115.88
40,40872555,2023-02-02,89.7,205.57999999999998
803,40872555,2023-02-03,-27.83,177.75
4671,40872555,2023-02-04,-1218.0,-1040.25
2550,40872555,2023-02-12,61.6,-978.65
1020,40898013,2023-01-31,,650.33
8249,40898013,2023-02-04,-115.27,535.0600000000001
2841,40898013,2023-02-04,-245.23,289.83000000000004
5381,40898013,2023-02-05,28.46,318.29
964,40898013,2023-02-06,-68.98,249.31000000000003
4870,40898013,2023-02-09,-30.36,218.95000000000005
1394,40898013,2023-02-11,130.61,349.56000000000006
3139,40898013,2023-02-13,-145.19,204.37000000000006
1021,40906801,2023-01-31,,83.77
6602,40906801,2023-02-01,185.45,269.21999999999997
4668,40906801,2023-02-02,-24.23,244.98999999999998
8329,40906801,2023-02-06,-42.19,202.79999999999995
1258,40906801,2023-02-09,1162.9,1365.7
7740,40906801,2023-02-09,97.54,1463.24
3882,40906801,2023-02-09,39.08,1502.3200000000002
3392,40906801,2023-02-09,-100.36,1401.96
1022,41022448,2023-01-31,,37.89
6277,41022448,2023-02-07,168.78,206.67000000000002
8485,41022448,2023-02-10,-180.01,26.659999999999997
1569,41022448,2023-02-13,-168.95,-142.29
6629,41022448,2023-02-14,161.34,19.05000000000001
1023,41036701,2023-01-31,,249.29
7197,41036701,2023-02-01,-802.6,-553.3100000000001
4772,41036701,2023-02-09,109.88,-443.43000000000006
3723,41036701,2023-02-14,823.0,379.56999999999994
1024,41038634,2023-01-31,,802.08
385,41038634,2023-02-02,-37.84,764.24
3312,41038634,2023-02-11,-202.15,562.09
3869,41038634,2023-02-14,-120.81,441.28000000000003
1025,41085190,2023-01-31,,78.73
4992,41085190,2023-02-03,113.59,192.32
4984,41085190,2023-02-03,-43.6,148.72
7445,41085190,2023-02-05,37.99,186.71
1126,41085190,2023-02-07,143.04,329.75
3468,41085190,2023-02-07,-1522.0,-1192.25
8045,41085190,2023-02-08,-118.54,-1310.79
6504,41085190,2023-02-08,-1168.1,-2478.89
4885,41085190,2023-02-10,1580.9,-897.9899999999998
3402,41085190,2023-02-12,78.26,-819.7299999999998
6672,41085190,2023-02-14,884.5,64.77000000000021
3494,41085190,2023-02-14,43.95,108.72000000000021
1026,41170515,2023-01-31,,713.46
1247,41170515,2023-02-03,227.05,940.51
5304,41170515,2023-02-10,-1147.5,-206.99
1027,41194009,2023-01-31,,585.15
3785,41194009,2023-02-07,-108.31,476.84
8087,41194009,2023-02-07,-138.38,338.46
457,41194009,2023-02-09,145.82,484.28
7994,41194009,2023-02-12,-104.69,379.59
5899,41194009,2023-02-13,-53.28,326.30999999999995
1028,41211432,2023-01-31,,205.0
89,41211432,2023-02-01,87.59,292.59000000000003
5771,41211432,2023-02-01,-80.9,211.69
2450,41211432,2023-02-04,129.37,341.06
4880,41211432,2023-02-07,-60.73,280.33
5972,41211432,2023-02-08,120.67,401.0
7523,41211432,2023-02-10,-97.9,303.1
3747,41211432,2023-02-11,-79.08,224.01999999999998
1029,41245288,2023-01-31,,540.61
5734,41245288,2023-02-05,92.78,633.39
8478,41245288,2023-02-10,59.42,692.8100000000001
5802,41245288,2023-02-10,34.9,727.71
7117,41245288,2023-02-11,87.57,815.28
1372,41245288,2023-02-13,-80.87,734.41
8519,41245288,2023-02-13,-1088.0,-353.59000000000003
1030,41245805,2023-01-31,,753.91
4723,41245805,2023-02-03,-116.55,637.36
5086,41245805,2023-02-04,900.7,1538.06
6392,41245805,2023-02-04,-55.24,1482.8200000000002
3840,41245805,2023-02-04,-176.15,1306.67
1031,41252281,2023-01-31,,834.88
7266,41252281,2023-02-01,148.34,983.22
4209,41252281,2023-02-03,67.76,1050.98
1766,41252281,2023-02-03,19.31,1070.29
284,41252281,2023-02-03,-89.06,981.23
1877,41252281,2023-02-05,-89.54,891.69
4151,41252281,2023-02-09,787.2,1678.89
8589,41252281,2023-02-10,1052.9,2731.79
1032,41282329,2023-01-31,,80.32
5626,41282329,2023-02-01,-42.27,38.04999999999999
3567,41282329,2023-02-05,1685.4,1723.45
3141,41282329,2023-02-09,-112.38,1611.0700000000002
1695,41282329,2023-02-10,75.67,1686.74
2517,41282329,2023-02-13,1023.0,2709.74
1033,41356963,2023-01-31,,398.3
2672,41356963,2023-02-04,80.86,479.16
2364,41356963,2023-02-05,74.98,554.14
7261,41356963,2023-02-05,-98.47,455.67
2306,41356963,2023-02-06,-125.59,330.08000000000004
2161,41356963,2023-02-09,132.11,462.19000000000005
1034,41420018,2023-01-31,,816.5
5780,41420018,2023-02-02,-118.87,697.63
4571,41420018,2023-02-09,-166.64,530.99
5082,41420018,2023-02-10,114.86,645.85
97,41420018,2023-02-13,68.86,714.71
8277,41420018,2023-02-14,96.41,811.12
1035,41542689,2023-01-31,,246.73
3446,41542689,2023-02-03,36.94,283.66999999999996
1680,41542689,2023-02-03,-149.87,133.79999999999998
6037,41542689,2023-02-04,-124.08,9.719999999999985
6958,41542689,2023-02-07,-130.23,-120.51
1590,41542689,2023-02-11,106.87,-13.64
1597,41542689,2023-02-12,1255.7,1242.06
5496,41542689,2023-02-13,-67.31,1174.75
1036,41561470,2023-01-31,,750.8
1887,41561470,2023-02-01,490.9,1241.6999999999998
6824,41561470,2023-02-03,144.92,1386.62
4235,41561470,2023-02-04,58.38,1445.0
7746,41561470,2023-02-05,161.25,1606.25
6837,41561470,2023-02-08,195.35,1801.6
160,41561470,2023-02-11,41.42,1843.02
3136,41561470,2023-02-14,-1083.0,760.02
1037,41574018,2023-01-31,,254.89
8544,41574018,2023-02-01,160.61,415.5
4550,41574018,2023-02-01,-19.88,395.62
6371,41574018,2023-02-05,-118.39,277.23
4861,41574018,2023-02-09,18.91,296.14
5775,41574018,2023-02-11,58.37,354.51
4227,41574018,2023-02-12,145.1,499.61
5328,41574018,2023-02-14,40.82,540.4300000000001
1038,41584073,2023-01-31,,561.74
364,41584073,2023-02-03,-46.59,515.15
2010,41584073,2023-02-04,91.41,606.56
1250,41584073,2023-02-04,34.22,640.78
3975,41584073,2023-02-05,96.95,737.73
6625,41584073,2023-02-08,-245.8,491.93
4610,41584073,2023-02-10,133.89,625.8199999999999
7890,41584073,2023-02-11,114.84,740.66
7583,41584073,2023-02-12,-70.6,670.06
1039,41664336,2023-01-31,,853.37
4366,41664336,2023-02-01,45.11,898.48
1040,41706310,2023-01-31,,126.08
1168,41706310,2023-02-01,82.09,208.17000000000002
7471,41706310,2023-02-01,71.89,280.06
292,41706310,2023-02-01,34.17,314.23
1150,41706310,2023-02-03,89.33,403.56
2460,41706310,2023-02-04,-88.18,315.38
1877,41706310,2023-02-05,89.54,404.92
3708,41706310,2023-02-06,-49.54,355.38
569,41706310,2023-02-06,-114.75,240.63
3679,41706310,2023-02-12,-97.82,142.81
1041,41716822,2023-01-31,,418.05
626,41716822,2023-02-01,78.07,496.12
3536,41716822,2023-02-06,158.15,654.27
4834,41716822,2023-02-10,106.77,761.04
2387,41716822,2023-02-10,-143.3,617.74
2897,41716822,2023-02-11,125.71,743.45
52,41716822,2023-02-12,-68.38,675.07
6611,41716822,2023-02-13,-47.15,627.92
1042,41741558,2023-01-31,,435.71
1108,41741558,2023-02-02,-43.55,392.15999999999997
1462,41741558,2023-02-05,57.79,449.95
2762,41741558,2023-02-05,-97.55,352.4
2464,41741558,2023-02-06,-86.91,265.49
6184,41741558,2023-02-07,-112.5,152.98999999999998
1836,41741558,2023-02-09,-58.59,94.39999999999998
6208,41741558,2023-02-09,-101.51,-7.110000000000028
911,41741558,2023-02-10,-151.6,-158.71000000000004
8377,41741558,2023-02-11,989.3,830.5899999999999
1043,41755476,2023-01-31,,72.71
8182,41755476,2023-02-02,205.22,277.93
2539,41755476,2023-02-02,62.51,340.44
764,41755476,2023-02-06,59.59,400.03
2770,41755476,2023-02-14,71.18,471.21
1044,41773473,2023-01-31,,355.0
850,41773473,2023-02-01,68.47,423.47
4543,41773473,2023-02-06,78.99,502.46
2735,41773473,2023-02-12,-118.77,383.69
1045,41778536,2023-01-31,,722.03
1716,41778536,2023-02-02,132.64,854.67
2883,41778536,2023-02-07,34.47,889.14
7642,41778536,2023-02-07,-129.29,759.8499999999999
4757,41778536,2023-02-08,-42.43,717.42
217,41778536,2023-02-09,859.1,1576.52
3242,41778536,2023-02-11,-160.56,1415.96
2752,41778536,2023-02-12,-150.22,1265.74
8060,41778536,2023-02-12,-1499.6,-233.8599999999999
8386,41778536,2023-02-13,112.18,-121.6799999999999
4356,41778536,2023-02-14,141.62,19.94000000000011
1046,41852767,2023-01-31,,993.36
4285,41852767,2023-02-01,114.68,1108.04
6462,41852767,2023-02-03,-106.35,1001.69
1388,41852767,2023-02-04,207.89,1209.58
4848,41852767,2023-02-06,155.92,1365.5
5794,41852767,2023-02-10,92.13,1457.63
409,41852767,2023-02-13,-23.37,1434.26
1047,41879906,2023-01-31,,29.05
7169,41879906,2023-02-01,-80.81,-51.760000000000005
8121,41879906,2023-02-03,105.23,53.47
4143,41879906,2023-02-06,-46.31,7.159999999999997
1454,41879906,2023-02-09,-65.76,-58.60000000000001
2442,41879906,2023-02-10,958.6,900.0
6582,41879906,2023-02-10,82.73,982.73
641,41879906,2023-02-11,-99.31,883.42
1048,41881442,2023-01-31,,650.34
7434,41881442,2023-02-01,-135.55,514.79
6841,41881442,2023-02-01,-212.26,302.53000000000003
3033,41881442,2023-02-10,-139.99,162.54000000000002
3114,41881442,2023-02-11,114.97,277.51
1074,41881442,2023-02-12,50.34,327.85
6256,41881442,2023-02-12,26.35,354.20000000000005
1049,41914097,2023-01-31,,921.06
1674,41914097,2023-02-02,87.3,1008.3599999999999
4296,41914097,2023-02-03,84.5,1092.86
5204,41914097,2023-02-04,-95.13,997.7299999999999
5935,41914097,2023-02-07,192.3,1190.03
2371,41914097,2023-02-07,-61.37,1128.66
5949,41914097,2023-02-08,-25.37,1103.29
572,41914097,2023-02-08,-86.91,1016.38
4805,41914097,2023-02-10,-111.11,905.27
6690,41914097,2023-02-13,93.82,999.0899999999999
2432,41914097,2023-02-13,-44.17,954.92
1050,41919083,2023-01-31,,884.52
4056,41919083,2023-02-01,-164.31,720.21
1364,41919083,2023-02-03,-99.68,620.53
6020,41919083,2023-02-07,1738.7,2359.23
88,41919083,2023-02-07,109.89,2469.12
183,41919083,2023-02-14,86.17,2555.29
5869,41919083,2023-02-14,-69.27,2486.02
1051,41954037,2023-01-31,,768.8
798,41954037,2023-02-08,34.38,803.18
5252,41954037,2023-02-08,-27.23,775.9499999999999
4714,41954037,2023-02-12,-1015.8,-239.85000000000002
106,41954037,2023-02-14,-145.08,-384.93000000000006
1052,41972741,2023-01-31,,374.09
7094,41972741,2023-02-02,123.02,497.10999999999996
5624,41972741,2023-02-08,88.5,585.61
3673,41972741,2023-02-09,155.66,741.27
4827,41972741,2023-02-12,57.33,798.6
6763,41972741,2023-02-13,48.57,847.17
1053,41981752,2023-01-31,,843.61
5795,41981752,2023-02-05,-179.42,664.19
2932,41981752,2023-02-10,1375.3,2039.49
927,41981752,2023-02-10,114.57,2154.06
7549,41981752,2023-02-11,50.91,2204.97
1054,42017456,2023-01-31,,947.67
1830,42017456,2023-02-04,-55.98,891.6899999999999
3654,42017456,2023-02-04,-132.12,759.5699999999999
6261,42017456,2023-02-05,-62.54,697.03
2951,42017456,2023-02-06,222.12,919.15
3073,42017456,2023-02-08,-77.04,842.11
1555,42017456,2023-02-10,66.19,908.3
1055,42181728,2023-01-31,,51.89
6285,42181728,2023-02-02,-87.3,-35.41
1642,42181728,2023-02-04,-88.31,-123.72
2888,42181728,2023-02-05,116.94,-6.780000000000001
5822,42181728,2023-02-06,-98.86,-105.64
4605,42181728,2023-02-06,-98.97,-204.61
3159,42181728,2023-02-07,153.16,-51.44999999999999
5040,42181728,2023-02-08,50.38,-1.069999999999986
6733,42181728,2023-02-13,-60.63,-61.69999999999999
1056,42202867,2023-01-31,,614.83
7406,42202867,2023-02-06,117.02,731.85
4538,42202867,2023-02-06,-82.67,649.1800000000001
5785,42202867,2023-02-07,129.86,779.0400000000001
402,42202867,2023-02-07,57.45,836.49
5694,42202867,2023-02-10,-85.13,751.36
1863,42202867,2023-02-11,-177.1,574.26
1057,42232896,2023-01-31,,647.99
4203,42232896,2023-02-02,21.71,669.7
2018,42232896,2023-02-04,-42.73,626.97
3621,42232896,2023-02-04,-84.59,542.38
1387,42232896,2023-02-09,97.8,640.1800000000001
4486,42232896,2023-02-10,130.57,770.75
3745,42232896,2023-02-10,74.94,845.69
3859,42232896,2023-02-13,-74.01,771.68
1058,42235537,2023-01-31,,165.2
1189,42235537,2023-02-01,807.2,972.4000000000001
6555,42235537,2023-02-02,-92.05,880.3500000000001
5515,42235537,2023-02-02,-101.22,779.1300000000001
2961,42235537,2023-02-04,-127.96,651.1700000000001
8658,42235537,2023-02-06,-161.61,489.56000000000006
2401,42235537,2023-02-07,-185.51,304.05000000000007
6558,42235537,2023-02-08,167.23,471.2800000000001
7589,42235537,2023-02-08,130.54,601.82
1612,42235537,2023-02-08,-118.58,483.24000000000007
8055,42235537,2023-02-08,-1244.2,-760.96
2108,42235537,2023-02-09,101.12,-659.84
3743,42235537,2023-02-10,118.64,-541.2
7514,42235537,2023-02-12,119.03,-422.17
3517,42235537,2023-02-13,-116.3,-538.47
6352,42235537,2023-02-14,88.32,-450.15000000000003
1059,42245590,2023-01-31,,229.01
4784,42245590,2023-02-01,55.09,284.1
3736,42245590,2023-02-02,120.7,404.8
5504,42245590,2023-02-07,639.3,1044.1
1539,42245590,2023-02-09,144.93,1189.03
3637,42245590,2023-02-09,-137.79,1051.24
7884,42245590,2023-02-12,134.05,1185.29
7674,42245590,2023-02-13,0.22,1185.51
1060,42255054,2023-01-31,,550.4
6263,42255054,2023-02-01,129.39,679.79
7832,42255054,2023-02-01,126.46,806.25
470,42255054,2023-02-04,292.64,1098.8899999999999
2097,42255054,2023-02-05,144.67,1243.56
1348,42255054,2023-02-07,-50.0,1193.56
2009,42255054,2023-02-08,57.72,1251.28
1061,42268900,2023-01-31,,521.35
1312,42268900,2023-02-01,140.67,662.02
4491,42268900,2023-02-03,177.67,839.69
8521,42268900,2023-02-03,-85.29,754.4
6117,42268900,2023-02-03,-97.5,656.9
7693,42268900,2023-02-05,-46.87,610.03
5223,42268900,2023-02-08,-103.7,506.33
2453,42268900,2023-02-09,38.42,544.75
1062,42300418,2023-01-31,,151.39
7099,42300418,2023-02-01,-808.4,-657.01
3597,42300418,2023-02-04,-950.2,-1607.21
8536,42300418,2023-02-11,127.49,-1479.72
1063,42311039,2023-01-31,,98.95
7745,42311039,2023-02-01,156.73,255.68
465,42311039,2023-02-03,-8.57,247.10999999999999
4456,42311039,2023-02-05,160.67,407.78
53,42311039,2023-02-06,-144.74,263.03999999999996
5692,42311039,2023-02-10,39.22,302.26
907,42311039,2023-02-10,-124.46,177.79999999999995
3746,42311039,2023-02-13,-128.84,48.95999999999998
1064,42322494,2023-01-31,,486.58
5707,42322494,2023-02-03,-15.35,471.22999999999996
2773,42322494,2023-02-06,78.93,550.16
1097,42322494,2023-02-07,-47.31,502.85
7484,42322494,2023-02-12,110.14,612.99
3921,42322494,2023-02-12,-101.4,511.59
1065,42340050,2023-01-31,,935.61
1996,42340050,2023-02-01,188.33,1123.94
3376,42340050,2023-02-01,-3.55,1120.39
7162,42340050,2023-02-03,-41.22,1079.17
484,42340050,2023-02-05,130.71,1209.88
4466,42340050,2023-02-07,52.36,1262.24
5296,42340050,2023-02-11,174.4,1436.64
6997,42340050,2023-02-12,-170.0,1266.64
5659,42340050,2023-02-13,-1678.8,-412.15999999999985
1066,42396753,2023-01-31,,628.86
5585,42396753,2023-02-02,-38.42,590.44
914,42396753,2023-02-07,98.66,689.1
4205,42396753,2023-02-08,-95.14,593.96
6727,42396753,2023-02-08,-194.3,399.65999999999997
1243,42396753,2023-02-09,77.75,477.40999999999997
1067,42509068,2023-01-31,,890.56
2723,42509068,2023-02-05,127.52,1018.0799999999999
2361,42509068,2023-02-05,-191.47,826.6099999999999
6725,42509068,2023-02-06,97.06,923.67
4702,42509068,2023-02-11,137.31,1060.98
4383,42509068,2023-02-12,518.5,1579.48
2528,42509068,2023-02-14,156.79,1736.27
1068,42515631,2023-01-31,,186.74
7113,42515631,2023-02-09,-117.38,69.36000000000001
7606,42515631,2023-02-10,-64.12,5.240000000000009
752,42515631,2023-02-10,-121.27,-116.02999999999999
3360,42515631,2023-02-11,116.46,0.4300000000000068
2748,42515631,2023-02-13,186.35,186.78
1069,42546381,2023-01-31,,409.3
6064,42546381,2023-02-05,197.22,606.52
7516,42546381,2023-02-05,-128.72,477.8
3081,42546381,2023-02-06,-127.85,349.95000000000005
1152,42546381,2023-02-09,61.15,411.1
5905,42546381,2023-02-14,104.78,515.88
1070,42589255,2023-01-31,,282.84
2465,42589255,2023-02-03,240.55,523.39
6962,42589255,2023-02-03,101.42,624.81
3294,42589255,2023-02-12,-134.18,490.63
1071,42602631,2023-01-31,,539.62
6543,42602631,2023-02-04,-196.98,342.64
7309,42602631,2023-02-07,-764.7,-422.06000000000006
1072,42652193,2023-01-31,,566.53
7133,42652193,2023-02-04,1465.5,2032.03
5875,42652193,2023-02-05,-129.51,1902.52
7586,42652193,2023-02-10,-89.09,1813.43
611,42652193,2023-02-13,-1062.5,750.9300000000001
1100,42652193,2023-02-14,-174.26,576.6700000000001
1073,42726921,2023-01-31,,590.15
7190,42726921,2023-02-05,155.76,745.91
347,42726921,2023-02-05,-99.16,646.75
3688,42726921,2023-02-12,1342.4,1989.15
3171,42726921,2023-02-12,157.87,2147.02
1074,42726928,2023-01-31,,601.3
2988,42726928,2023-02-01,102.89,704.1899999999999
199,42726928,2023-02-04,-55.58,648.6099999999999
5516,42726928,2023-02-04,-63.83,584.78
3963,42726928,2023-02-04,-210.25,374.53
3896,42726928,2023-02-05,181.42,555.9499999999999
419,42726928,2023-02-06,-52.22,503.72999999999996
3912,42726928,2023-02-06,-63.33,440.4
6135,42726928,2023-02-06,-75.55,364.84999999999997
5525,42726928,2023-02-12,187.21,552.06
1707,42726928,2023-02-14,-163.23,388.83
1075,42746180,2023-01-31,,12.15
4094,42746180,2023-02-04,-1610.8,-1598.6499999999999
3698,42746180,2023-02-05,-8.72,-1607.37
5447,42746180,2023-02-07,-79.0,-1686.37
38,42746180,2023-02-08,-92.43,-1778.8
8461,42746180,2023-02-09,-176.97,-1955.77
1076,42752982,2023-01-31,,526.19
781,42752982,2023-02-06,-106.97,419.22
6356,42752982,2023-02-07,-192.3,226.92000000000004
6164,42752982,2023-02-11,-43.78,183.14000000000004
7180,42752982,2023-02-14,-12.8,170.34000000000003
3546,42752982,2023-02-14,-42.9,127.44000000000004
1077,42783101,2023-01-31,,289.82
1381,42783101,2023-02-01,-61.16,228.66
1735,42783101,2023-02-06,92.42,321.08
6893,42783101,2023-02-07,-1035.2,-714.1200000000001
3602,42783101,2023-02-11,125.65,-588.4700000000001
3973,42783101,2023-02-12,-88.66,-677.1300000000001
2197,42783101,2023-02-13,142.63,-534.5000000000001
1078,42813808,2023-01-31,,633.08
6935,42813808,2023-02-08,-129.37,503.71000000000004
4072,42813808,2023-02-09,-125.63,378.08000000000004
1079,42838186,2023-01-31,,466.48
4028,42838186,2023-02-01,56.55,523.03
2380,42838186,2023-02-08,-1382.5,-859.47
831,42838186,2023-02-09,1176.8,317.3299999999999
2415,42838186,2023-02-10,-149.19,168.13999999999993
1080,42882563,2023-01-31,,419.69
2928,42882563,2023-02-07,-77.43,342.26
1081,42889744,2023-01-31,,223.01
4390,42889744,2023-02-02,98.78,321.78999999999996
8221,42889744,2023-02-03,-175.68,146.10999999999999
4898,42889744,2023-02-04,160.12,306.23
1082,43017336,2023-01-31,,935.99
1936,43017336,2023-02-03,-152.86,783.13
880,43017336,2023-02-12,-122.62,660.51
2356,43017336,2023-02-13,196.46,856.97
7567,43017336,2023-02-14,-96.78,760.19
1083,43017598,2023-01-31,,151.6
2613,43017598,2023-02-02,-148.35,3.25
5655,43017598,2023-02-07,164.87,168.12
1558,43017598,2023-02-07,-64.08,104.04
5692,43017598,2023-02-10,-39.22,64.82000000000001
5789,43017598,2023-02-12,-158.31,-93.49
6015,43017598,2023-02-13,75.37,-18.11999999999999
1300,43017598,2023-02-13,-77.47,-95.58999999999999
2732,43017598,2023-02-14,-64.61,-160.2
1084,43032836,2023-01-31,,386.83
4017,43032836,2023-02-01,137.9,524.73
8310,43032836,2023-02-01,132.52,657.25
1749,43032836,2023-02-01,-52.56,604.69
704,43032836,2023-02-02,148.04,752.73
7440,43032836,2023-02-03,136.92,889.65
8099,43032836,2023-02-03,56.07,945.72
5500,43032836,2023-02-04,-49.53,896.1899999999999
5334,43032836,2023-02-09,-42.5,853.6899999999999
5928,43032836,2023-02-09,-130.36,723.3299999999999
1085,43064169,2023-01-31,,555.44
1865,43064169,2023-02-02,27.69,583.1300000000001
4710,43064169,2023-02-03,772.8,1355.93
1335,43064169,2023-02-03,188.47,1544.4
500,43064169,2023-02-03,-141.26,1403.14
3072,43064169,2023-02-05,974.8,2377.94
4833,43064169,2023-02-07,-109.58,2268.36
4763,43064169,2023-02-07,-124.55,2143.81
4378,43064169,2023-02-10,-1289.6,854.21
5877,43064169,2023-02-11,110.11,964.32
5628,43064169,2023-02-11,75.76,1040.08
3017,43064169,2023-02-13,-103.99,936.09
1086,43074888,2023-01-31,,779.86
455,43074888,2023-02-02,-130.94,648.9200000000001
6055,43074888,2023-02-05,112.03,760.95
3403,43074888,2023-02-05,6.73,767.6800000000001
2697,43074888,2023-02-11,991.6,1759.2800000000002
4724,43074888,2023-02-11,104.39,1863.67
2240,43074888,2023-02-13,61.19,1924.8600000000001
1087,43080619,2023-01-31,,426.64
5838,43080619,2023-02-03,-22.57,404.07
2557,43080619,2023-02-05,17.93,422.0
8457,43080619,2023-02-08,-53.32,368.68
2196,43080619,2023-02-09,-112.69,255.98999999999998
7086,43080619,2023-02-13,84.91,340.9
1088,43140934,2023-01-31,,820.81
3638,43140934,2023-02-05,160.91,981.7199999999999
2104,43140934,2023-02-05,-57.87,923.8499999999999
6757,43140934,2023-02-10,-150.39,773.4599999999999
5302,43140934,2023-02-14,97.09,870.55
229,43140934,2023-02-14,-58.12,812.43
1089,43257373,2023-01-31,,483.49
540,43257373,2023-02-04,46.93,530.42
3525,43257373,2023-02-04,-135.72,394.70000000000005
3142,43257373,2023-02-06,116.91,511.61
6597,43257373,2023-02-06,-117.11,394.5
4649,43257373,2023-02-09,96.17,490.67
137,43257373,2023-02-12,-129.61,361.06
1090,43265708,2023-01-31,,814.0
898,43265708,2023-02-03,179.75,993.75
6236,43265708,2023-02-04,95.37,1089.12
5672,43265708,2023-02-13,65.62,1154.74
7193,43265708,2023-02-14,117.3,1272.04
1091,43312288,2023-01-31,,830.91
3814,43312288,2023-02-02,-152.95,677.96
8503,43312288,2023-02-04,-72.87,605.0899999999999
2469,43312288,2023-02-05,-84.4,520.6899999999999
3920,43312288,2023-02-08,110.55,631.24
4680,43312288,2023-02-13,66.09,697.3299999999999
8301,43312288,2023-02-14,-132.36,564.97
1092,43329727,2023-01-31,,477.69
8645,43329727,2023-02-04,-96.31,381.38
8110,43329727,2023-02-04,-1231.2,-849.82
356,43329727,2023-02-07,144.16,-705.6600000000001
206,43329727,2023-02-07,-141.01,-846.6700000000001
5275,43329727,2023-02-08,99.49,-747.1800000000001
2740,43329727,2023-02-13,42.54,-704.6400000000001
1093,43330367,2023-01-31,,172.38
7409,43330367,2023-02-02,-52.78,119.6
623,43330367,2023-02-06,88.52,208.12
8391,43330367,2023-02-10,-182.81,25.310000000000002
7652,43330367,2023-02-11,24.9,50.21
3970,43330367,2023-02-13,87.2,137.41
1094,43338400,2023-01-31,,783.12
7317,43338400,2023-02-01,-80.7,702.42
4534,43338400,2023-02-04,-134.81,567.61
5596,43338400,2023-02-08,147.81,715.4200000000001
989,43338400,2023-02-08,98.38,813.8
5207,43338400,2023-02-14,2197.2,3011.0
1095,43354643,2023-01-31,,863.38
7546,43354643,2023-02-02,105.59,968.97
2766,43354643,2023-02-06,-51.69,917.28
6917,43354643,2023-02-10,98.85,1016.13
1470,43354643,2023-02-11,125.91,1142.04
1096,43365633,2023-01-31,,57.11
299,43365633,2023-02-07,-27.88,29.23
4748,43365633,2023-02-10,-107.66,-78.42999999999999
5079,43365633,2023-02-13,111.43,33.000000000000014
1097,43368978,2023-01-31,,133.07
7814,43368978,2023-02-01,55.49,188.56
5963,43368978,2023-02-06,-172.68,15.879999999999995
4071,43368978,2023-02-06,-202.83,-186.95000000000002
5294,43368978,2023-02-11,64.21,-122.74000000000002
1098,43387803,2023-01-31,,646.4
5117,43387803,2023-02-02,57.84,704.24
7846,43387803,2023-02-03,50.38,754.62
7704,43387803,2023-02-05,128.94,883.56
2131,43387803,2023-02-05,23.02,906.5799999999999
3556,43387803,2023-02-05,-81.21,825.37
3957,43387803,2023-02-06,71.54,896.91
4713,43387803,2023-02-10,-113.99,782.92
2924,43387803,2023-02-10,-249.81,533.11
2239,43387803,2023-02-11,-139.14,393.97
3678,43387803,2023-02-14,141.17,535.14
1099,43417466,2023-01-31,,874.02
7989,43417466,2023-02-01,66.84,940.86
7393,43417466,2023-02-07,-84.97,855.89
6105,43417466,2023-02-12,-153.64,702.25
8016,43417466,2023-02-14,-195.84,506.40999999999997
1100,43420385,2023-01-31,,881.49
1536,43420385,2023-02-02,117.9,999.39
2391,43420385,2023-02-06,-71.0,928.39
7118,43420385,2023-02-07,52.52,980.91
1171,43420385,2023-02-09,1522.7,2503.61
2328,43420385,2023-02-09,129.19,2632.7999999999997
5989,43420385,2023-02-09,-83.64,2549.16
1101,43453543,2023-01-31,,890.67
6320,43453543,2023-02-01,-98.39,792.28
7444,43453543,2023-02-02,75.16,867.4399999999999
5499,43453543,2023-02-10,130.32,997.76
6885,43453543,2023-02-12,72.09,1069.85
1102,43490748,2023-01-31,,807.92
3659,43490748,2023-02-01,-143.86,664.06
8399,43490748,2023-02-07,173.42,837.4799999999999
6755,43490748,2023-02-08,66.93,904.41
726,43490748,2023-02-10,135.0,1039.4099999999999
5668,43490748,2023-02-13,-82.37,957.04
8052,43490748,2023-02-13,-102.44,854.5999999999999
1013,43490748,2023-02-14,77.21,931.81
1103,43499771,2023-01-31,,28.4
727,43499771,2023-02-01,78.47,106.87
6936,43499771,2023-02-06,1003.2,1110.0700000000002
1963,43499771,2023-02-06,77.81,1187.88
4621,43499771,2023-02-06,-65.08,1122.8
1021,43499771,2023-02-07,-75.13,1047.67
915,43499771,2023-02-07,-149.48,898.19
5273,43499771,2023-02-11,143.86,1042.0500000000002
6416,43499771,2023-02-11,-118.35,923.7
5874,43499771,2023-02-12,-154.74,768.96
2181,43499771,2023-02-12,-157.02,611.94
1856,43499771,2023-02-14,228.87,840.8100000000001
1104,43541008,2023-01-31,,413.2
4197,43541008,2023-02-01,105.55,518.75
5239,43541008,2023-02-05,-56.72,462.03
8154,43541008,2023-02-05,-1144.8,-682.77
4234,43541008,2023-02-11,-42.48,-725.25
1953,43541008,2023-02-13,73.96,-651.29
1105,43597919,2023-01-31,,906.64
7462,43597919,2023-02-03,-95.54,811.1
6039,43597919,2023-02-06,144.03,955.13
3404,43597919,2023-02-06,-944.2,10.92999999999995
2699,43597919,2023-02-07,1610.4,1621.33
6882,43597919,2023-02-08,-87.01,1534.32
1598,43597919,2023-02-12,1323.4,2857.7200000000003
3684,43597919,2023-02-12,-114.06,2743.66
607,43597919,2023-02-14,44.44,2788.1
1106,43616790,2023-01-31,,365.67
324,43616790,2023-02-02,62.33,428.0
5466,43616790,2023-02-05,61.68,489.68
529,43616790,2023-02-06,-154.24,335.44
4786,43616790,2023-02-07,139.63,475.07
5533,43616790,2023-02-08,943.5,1418.57
6839,43616790,2023-02-08,36.72,1455.29
1241,43616790,2023-02-09,74.39,1529.6799999999998
5561,43616790,2023-02-09,-1705.6,-175.92000000000007
2644,43616790,2023-02-13,104.18,-71.74000000000007
1107,43623061,2023-01-31,,724.39
878,43623061,2023-02-02,1502.2,2226.59
6109,43623061,2023-02-04,-75.48,2151.11
2749,43623061,2023-02-11,331.8,2482.91
7171,43623061,2023-02-12,66.33,2549.24
3651,43623061,2023-02-12,-76.84,2472.4
2074,43623061,2023-02-13,-129.32,2343.08
1153,43623061,2023-02-14,-49.38,2293.7
8463,43623061,2023-02-14,-124.19,2169.5099999999998
1108,43772330,2023-01-31,,701.52
676,43772330,2023-02-03,-169.95,531.5699999999999
1574,43772330,2023-02-05,-143.73,387.84000000000003
3762,43772330,2023-02-06,-97.33,290.51
1494,43772330,2023-02-08,65.49,356.0
6707,43772330,2023-02-10,98.76,454.76
6888,43772330,2023-02-11,90.71,545.47
3349,43772330,2023-02-12,45.77,591.24
1109,43781476,2023-01-31,,28.83
4388,43781476,2023-02-01,128.49,157.32
7286,43781476,2023-02-02,115.98,273.3
3677,43781476,2023-02-02,56.3,329.6
984,43781476,2023-02-04,143.83,473.43
7271,43781476,2023-02-06,45.55,518.98
6366,43781476,2023-02-08,-52.3,466.68
5533,43781476,2023-02-08,-943.5,-476.82
6106,43781476,2023-02-13,153.14,-323.68
1110,43811112,2023-01-31,,99.92
5555,43811112,2023-02-02,-97.69,2.230000000000004
972,43811112,2023-02-05,5.44,7.670000000000004
1417,43811112,2023-02-07,1760.8,1768.47
2247,43811112,2023-02-08,-99.77,1668.7
3856,43811112,2023-02-08,-136.68,1532.02
3343,43811112,2023-02-09,-1485.0,47.01999999999998
7392,43811112,2023-02-10,-52.93,-5.910000000000018
2445,43811112,2023-02-13,65.54,59.62999999999999
4780,43811112,2023-02-14,93.12,152.75
1111,43830772,2023-01-31,,158.17
7466,43830772,2023-02-03,89.74,247.90999999999997
1112,43843937,2023-01-31,,79.03
3026,43843937,2023-02-06,67.96,146.99
2351,43843937,2023-02-09,940.9,1087.8899999999999
4422,43843937,2023-02-10,155.28,1243.17
6004,43843937,2023-02-11,518.1,1761.27
5814,43843937,2023-02-13,901.5,2662.77
1113,43858112,2023-01-31,,641.78
2606,43858112,2023-02-01,-102.95,538.8299999999999
3025,43858112,2023-02-02,-39.75,499.08
1041,43858112,2023-02-04,77.7,576.78
8349,43858112,2023-02-04,-49.6,527.18
5506,43858112,2023-02-05,-65.82,461.36
5275,43858112,2023-02-08,-99.49,361.87
2789,43858112,2023-02-13,90.0,451.87
3313,43858112,2023-02-13,-118.46,333.40999999999997
3718,43858112,2023-02-14,171.25,504.65999999999997
4509,43858112,2023-02-14,-170.78,333.88
1114,43860538,2023-01-31,,478.05
2376,43860538,2023-02-02,-89.8,388.25
5415,43860538,2023-02-08,69.75,458.0
4794,43860538,2023-02-12,-53.98,404.02000000000004
1115,43892675,2023-01-31,,997.95
8684,43892675,2023-02-03,64.03,1061.98
4315,43892675,2023-02-07,-150.57,911.4100000000001
5599,43892675,2023-02-08,-80.77,830.6400000000001
7439,43892675,2023-02-14,-53.35,777.2900000000001
1116,43930935,2023-01-31,,651.22
5998,43930935,2023-02-04,-21.78,629.44
5385,43930935,2023-02-04,-120.69,508.75
460,43930935,2023-02-09,-63.04,445.71000000000004
5955,43930935,2023-02-12,69.99,515.7
4971,43930935,2023-02-14,-82.7,433.0
1117,43979238,2023-01-31,,68.08
3629,43979238,2023-02-01,170.96,239.04000000000002
828,43979238,2023-02-03,49.39,288.43
6739,43979238,2023-02-03,-64.85,223.57999999999998
8249,43979238,2023-02-04,115.27,338.85
1443,43979238,2023-02-06,-178.37,160.48
987,43979238,2023-02-12,1486.8,1647.28
1118,44007497,2023-01-31,,331.92
7162,44007497,2023-02-03,41.22,373.14
1886,44007497,2023-02-05,-87.07,286.07000000000005
5102,44007497,2023-02-06,-39.91,246.16000000000003
7660,44007497,2023-02-07,-54.52,191.64000000000001
2960,44007497,2023-02-08,88.74,280.38
6439,44007497,2023-02-08,61.39,341.77000000000004
1119,44009985,2023-01-31,,763.43
3875,44009985,2023-02-02,13.68,777.1099999999999
6795,44009985,2023-02-08,-946.2,-169.09000000000015
5497,44009985,2023-02-10,905.0,735.9099999999999
8631,44009985,2023-02-11,102.26,838.1699999999998
4578,44009985,2023-02-11,-60.05,778.1199999999999
4991,44009985,2023-02-13,106.6,884.7199999999998
4283,44009985,2023-02-14,-104.91,779.8099999999998
1120,44019515,2023-01-31,,312.63
7725,44019515,2023-02-02,116.25,428.88
1894,44019515,2023-02-04,-151.32,277.56
2446,44019515,2023-02-06,-38.7,238.86
3062,44019515,2023-02-06,-102.12,136.74
3079,44019515,2023-02-07,1159.5,1296.24
8436,44019515,2023-02-09,80.13,1376.37
4043,44019515,2023-02-13,101.48,1477.85
1121,44066457,2023-01-31,,18.09
8085,44066457,2023-02-03,1179.0,1197.09
4746,44066457,2023-02-03,78.92,1276.01
7918,44066457,2023-02-03,-92.94,1183.07
5998,44066457,2023-02-04,21.78,1204.85
4252,44066457,2023-02-05,102.9,1307.75
4187,44066457,2023-02-11,103.18,1410.9299999999998
4707,44066457,2023-02-13,-1226.1,184.82999999999993
3892,44066457,2023-02-14,156.38,341.2099999999999
1649,44066457,2023-02-14,-51.9,289.30999999999995
1038,44066457,2023-02-14,-149.95,139.35999999999993
1122,44075619,2023-01-31,,979.0
3395,44075619,2023-02-05,217.15,1196.15
7457,44075619,2023-02-08,-83.96,1112.19
2807,44075619,2023-02-08,-108.51,1003.6800000000001
3595,44075619,2023-02-09,97.39,1101.07
703,44075619,2023-02-10,92.21,1193.28
1136,44075619,2023-02-10,50.52,1243.8
2660,44075619,2023-02-12,-78.89,1164.91
1123,44130477,2023-01-31,,918.0
1671,44130477,2023-02-04,622.4,1540.4
2272,44130477,2023-02-04,-66.17,1474.23
5801,44130477,2023-02-08,137.66,1611.8899999999999
4061,44130477,2023-02-08,129.87,1741.76
1779,44130477,2023-02-12,-36.64,1705.12
1124,44133867,2023-01-31,,358.61
4400,44133867,2023-02-03,169.26,527.87
2455,44133867,2023-02-04,-91.11,436.76
7615,44133867,2023-02-11,851.2,1287.96
1772,44133867,2023-02-14,26.02,1313.98
1125,44140049,2023-01-31,,372.02
1428,44140049,2023-02-06,-49.33,322.69
432,44140049,2023-02-10,84.47,407.15999999999997
927,44140049,2023-02-10,-114.57,292.59
3787,44140049,2023-02-11,122.35,414.94
6388,44140049,2023-02-11,-89.98,324.96
7237,44140049,2023-02-13,77.8,402.76
1126,44145489,2023-01-31,,635.75
8151,44145489,2023-02-03,87.5,723.25
2766,44145489,2023-02-06,51.69,774.94
5490,44145489,2023-02-10,-79.08,695.86
2525,44145489,2023-02-11,-55.33,640.53
6174,44145489,2023-02-12,-1003.7,-363.1700000000001
1127,44162563,2023-01-31,,325.77
1258,44162563,2023-02-09,-1162.9,-837.1300000000001
160,44162563,2023-02-11,-41.42,-878.5500000000001
3541,44162563,2023-02-14,-102.55,-981.1000000000001
1128,44164363,2023-01-31,,998.43
2056,44164363,2023-02-02,164.6,1163.03
2626,44164363,2023-02-02,82.72,1245.75
5560,44164363,2023-02-03,-155.02,1090.73
2601,44164363,2023-02-06,-51.71,1039.02
8366,44164363,2023-02-09,-72.19,966.8299999999999
1129,44228646,2023-01-31,,651.3
5173,44228646,2023-02-03,129.77,781.0699999999999
7189,44228646,2023-02-03,-53.78,727.29
847,44228646,2023-02-04,1315.2,2042.49
8154,44228646,2023-02-05,1144.8,3187.29
2126,44228646,2023-02-05,112.01,3299.3
5477,44228646,2023-02-07,36.15,3335.45
8055,44228646,2023-02-08,1244.2,4579.65
3295,44228646,2023-02-08,105.88,4685.53
5863,44228646,2023-02-09,-101.37,4584.16
6245,44228646,2023-02-10,46.55,4630.71
1919,44228646,2023-02-12,-169.44,4461.27
1130,44234432,2023-01-31,,399.17
6396,44234432,2023-02-01,-127.46,271.71000000000004
4538,44234432,2023-02-06,82.67,354.38
6627,44234432,2023-02-07,-46.31,308.07000000000005
2802,44234432,2023-02-08,-90.88,217.19000000000003
5494,44234432,2023-02-09,156.08,373.27000000000004
2102,44234432,2023-02-09,95.64,468.91
2843,44234432,2023-02-10,180.0,648.9100000000001
1567,44234432,2023-02-11,10.99,659.9
6686,44234432,2023-02-12,140.79,800.69
7543,44234432,2023-02-14,-191.09,609.6
1131,44239230,2023-01-31,,390.94
308,44239230,2023-02-01,-189.46,201.48
3630,44239230,2023-02-06,-68.72,132.76
1132,44242297,2023-01-31,,388.02
5120,44242297,2023-02-01,-136.95,251.07
3394,44242297,2023-02-03,195.91,446.98
8006,44242297,2023-02-05,962.0,1408.98
1,44242297,2023-02-09,170.19,1579.17
1951,44242297,2023-02-10,46.07,1625.24
6374,44242297,2023-02-11,102.02,1727.26
6174,44242297,2023-02-12,1003.7,2730.96
7773,44242297,2023-02-12,124.55,2855.51
3429,44242297,2023-02-13,147.05,3002.56
871,44242297,2023-02-14,179.57,3182.13
1133,44243236,2023-01-31,,797.95
2066,44243236,2023-02-01,-54.25,743.7
4796,44243236,2023-02-02,108.85,852.5500000000001
4937,44243236,2023-02-04,51.81,904.36
7390,44243236,2023-02-11,-123.03,781.33
5070,44243236,2023-02-12,966.7,1748.0300000000002
5960,44243236,2023-02-14,137.37,1885.4
1134,44272912,2023-01-31,,448.18
547,44272912,2023-02-01,-142.26,305.92
6191,44272912,2023-02-07,742.8,1048.72
6255,44272912,2023-02-07,-18.61,1030.1100000000001
8571,44272912,2023-02-07,-89.09,941.02
399,44272912,2023-02-08,113.46,1054.48
5303,44272912,2023-02-09,78.16,1132.64
7110,44272912,2023-02-09,38.09,1170.73
5724,44272912,2023-02-09,-157.69,1013.04
3927,44272912,2023-02-11,63.8,1076.84
4426,44272912,2023-02-12,882.7,1959.54
6223,44272912,2023-02-14,-118.75,1840.79
1135,44281556,2023-01-31,,70.7
8250,44281556,2023-02-01,-117.4,-46.7
7499,44281556,2023-02-08,58.6,11.899999999999999
1136,44310966,2023-01-31,,361.02
7224,44310966,2023-02-02,107.8,468.82
1837,44310966,2023-02-03,-136.66,332.15999999999997
6852,44310966,2023-02-05,137.15,469.30999999999995
4135,44310966,2023-02-07,-41.35,427.96
599,44310966,2023-02-09,-117.9,310.05999999999995
6979,44310966,2023-02-13,113.3,423.35999999999996
8373,44310966,2023-02-14,-0.36,422.99999999999994
1137,44317934,2023-01-31,,920.21
6086,44317934,2023-02-01,1888.2,2808.41
3956,44317934,2023-02-02,-162.4,2646.01
1295,44317934,2023-02-10,-206.87,2439.14
1459,44317934,2023-02-13,117.77,2556.91
1138,44331942,2023-01-31,,389.13
3964,44331942,2023-02-02,225.34,614.47
1743,44331942,2023-02-03,60.47,674.94
8349,44331942,2023-02-04,49.6,724.54
2287,44331942,2023-02-12,169.34,893.88
1139,44358901,2023-01-31,,576.73
4140,44358901,2023-02-01,-144.31,432.42
2617,44358901,2023-02-02,137.17,569.59
2492,44358901,2023-02-03,-117.51,452.08
2501,44358901,2023-02-04,73.67,525.75
6387,44358901,2023-02-08,1805.6,2331.35
7528,44358901,2023-02-10,75.3,2406.65
8088,44358901,2023-02-11,-40.81,2365.8399999999997
3973,44358901,2023-02-12,88.66,2454.5
1140,44364430,2023-01-31,,306.44
8127,44364430,2023-02-01,-65.61,240.82999999999998
5463,44364430,2023-02-09,-142.44,98.38999999999999
7495,44364430,2023-02-11,116.14,214.52999999999997
7148,44364430,2023-02-11,87.14,301.66999999999996
7463,44364430,2023-02-13,216.37,518.04
1141,44368280,2023-01-31,,291.54
1176,44368280,2023-02-03,13.52,305.06
2913,44368280,2023-02-09,-46.29,258.77000000000004
4342,44368280,2023-02-11,-84.29,174.48000000000002
1557,44368280,2023-02-11,-92.54,81.94000000000001
1652,44368280,2023-02-12,19.56,101.50000000000001
1142,44378133,2023-01-31,,721.21
3825,44378133,2023-02-01,-12.5,708.71
12,44378133,2023-02-02,123.2,831.9100000000001
1692,44378133,2023-02-03,100.38,932.2900000000001
7,44378133,2023-02-03,66.09,998.38
697,44378133,2023-02-08,44.49,1042.8700000000001
2315,44378133,2023-02-11,-633.2,409.66999999999996
4530,44378133,2023-02-12,-197.45,212.21999999999997
1563,44378133,2023-02-14,-102.06,110.15999999999997
7414,44378133,2023-02-14,-107.51,2.649999999999963
1143,44389169,2023-01-31,,978.69
4937,44389169,2023-02-04,-51.81,926.8800000000001
3618,44389169,2023-02-10,-103.67,823.21
726,44389169,2023-02-10,-135.0,688.21
1144,44413402,2023-01-31,,75.55
3601,44413402,2023-02-02,23.22,98.77
2217,44413402,2023-02-08,140.73,239.5
3542,44413402,2023-02-11,-126.93,112.56999999999996
1145,44427272,2023-01-31,,970.1
4615,44427272,2023-02-01,-174.19,795.9100000000001
1236,44427272,2023-02-02,2.63,798.5400000000001
2641,44427272,2023-02-05,108.26,906.8000000000001
597,44427272,2023-02-07,97.67,1004.47
5791,44427272,2023-02-10,-15.31,989.1600000000001
1146,44474369,2023-01-31,,663.93
5966,44474369,2023-02-09,64.46,728.39
2319,44474369,2023-02-09,-97.79,630.5999999999999
5206,44474369,2023-02-10,-71.41,559.1899999999999
5090,44474369,2023-02-11,-120.57,438.61999999999995
527,44474369,2023-02-12,80.58,519.1999999999999
3197,44474369,2023-02-12,69.4,588.5999999999999
1147,44516940,2023-01-31,,930.17
189,44516940,2023-02-01,-182.19,747.98
451,44516940,2023-02-06,-172.27,575.7099999999999
5639,44516940,2023-02-08,209.01,784.7199999999999
4363,44516940,2023-02-09,-12.71,772.01
1286,44516940,2023-02-12,165.18,937.1899999999999
2367,44516940,2023-02-12,58.82,996.01
3842,44516940,2023-02-12,-67.31,928.6999999999999
1148,44537960,2023-01-31,,675.03
2720,44537960,2023-02-01,-168.84,506.18999999999994
3305,44537960,2023-02-02,95.09,601.28
1699,44537960,2023-02-06,147.34,748.62
7021,44537960,2023-02-06,-135.04,613.5799999999999
2236,44537960,2023-02-09,-187.78,425.79999999999995
2675,44537960,2023-02-10,-72.06,353.74
556,44537960,2023-02-12,-192.75,160.98999999999998
7090,44537960,2023-02-13,-116.22,44.76999999999998
1149,44564500,2023-01-31,,355.18
5238,44564500,2023-02-01,215.02,570.2
2746,44564500,2023-02-03,67.38,637.58
6190,44564500,2023-02-06,34.38,671.96
8058,44564500,2023-02-10,67.6,739.56
1150,44586370,2023-01-31,,440.56
4,44586370,2023-02-02,-84.65,355.90999999999997
6581,44586370,2023-02-06,-40.91,315.0
4206,44586370,2023-02-06,-42.82,272.18
6812,44586370,2023-02-07,1500.0,1772.18
2928,44586370,2023-02-07,77.43,1849.6100000000001
498,44586370,2023-02-08,-166.36,1683.25
7387,44586370,2023-02-12,117.51,1800.76
7795,44586370,2023-02-13,-105.71,1695.0500000000002
6957,44586370,2023-02-14,69.01,1764.0600000000002
1875,44586370,2023-02-14,-52.78,1711.28
1151,44626164,2023-01-31,,915.14
5445,44626164,2023-02-07,65.37,980.51
8404,44626164,2023-02-09,-1166.4,-185.8900000000001
5627,44626164,2023-02-14,-124.79,-310.6800000000001
1152,44662337,2023-01-31,,768.12
5342,44662337,2023-02-01,119.68,887.8
4835,44662337,2023-02-09,-140.49,747.31
961,44662337,2023-02-14,162.09,909.4
1153,44701536,2023-01-31,,995.4
380,44701536,2023-02-01,-76.18,919.22
7122,44701536,2023-02-06,-151.44,767.78
6393,44701536,2023-02-08,110.6,878.38
5762,44701536,2023-02-08,-117.22,761.16
2673,44701536,2023-02-10,-117.1,644.06
8492,44701536,2023-02-11,-75.88,568.18
1154,44711172,2023-01-31,,382.83
7163,44711172,2023-02-02,-174.75,208.07999999999998
6869,44711172,2023-02-04,150.01,358.09
8374,44711172,2023-02-04,141.33,499.41999999999996
4464,44711172,2023-02-08,-81.17,418.25
7588,44711172,2023-02-13,8.94,427.19
1155,44759468,2023-01-31,,962.91
4750,44759468,2023-02-01,-97.92,864.99
4299,44759468,2023-02-04,141.71,1006.7
1625,44759468,2023-02-07,84.46,1091.16
5444,44759468,2023-02-09,-35.18,1055.98
7976,44759468,2023-02-10,74.15,1130.13
6926,44759468,2023-02-10,-105.35,1024.78
5053,44759468,2023-02-11,-34.81,989.97
1446,44759468,2023-02-12,-169.36,820.61
1949,44759468,2023-02-13,-110.34,710.27
1156,44794340,2023-01-31,,488.91
3080,44794340,2023-02-13,-71.54,417.37
1157,44812075,2023-01-31,,863.71
8139,44812075,2023-02-01,601.7,1465.41
7527,44812075,2023-02-02,116.1,1581.51
2357,44812075,2023-02-02,-108.51,1473.0
511,44812075,2023-02-06,127.59,1600.5900000000001
3795,44812075,2023-02-12,127.27,1727.8600000000001
848,44812075,2023-02-13,64.31,1792.17
1158,44816910,2023-01-31,,185.51
3047,44816910,2023-02-01,229.8,415.31
3496,44816910,2023-02-04,89.58,504.89
3065,44816910,2023-02-05,56.62,561.51
7987,44816910,2023-02-05,-9.05,552.46
7352,44816910,2023-02-05,-147.37,405.09000000000003
2160,44816910,2023-02-06,30.45,435.54
3881,44816910,2023-02-07,756.5,1192.04
4741,44816910,2023-02-08,110.8,1302.84
2399,44816910,2023-02-13,-32.01,1270.83
856,44816910,2023-02-13,-118.4,1152.4299999999998
1159,44873253,2023-01-31,,660.51
5768,44873253,2023-02-03,60.33,720.84
465,44873253,2023-02-03,8.57,729.41
3269,44873253,2023-02-05,-93.57,635.84
8135,44873253,2023-02-07,-113.43,522.41
4395,44873253,2023-02-10,-93.74,428.67
5830,44873253,2023-02-10,-192.26,236.41000000000003
8005,44873253,2023-02-11,726.2,962.6100000000001
1160,44902994,2023-01-31,,790.34
5257,44902994,2023-02-01,85.77,876.11
2809,44902994,2023-02-02,-174.13,701.98
3865,44902994,2023-02-03,23.84,725.82
5142,44902994,2023-02-03,-31.0,694.82
5591,44902994,2023-02-03,-58.23,636.59
7537,44902994,2023-02-03,-1259.6,-623.0099999999999
5708,44902994,2023-02-04,94.29,-528.7199999999999
6160,44902994,2023-02-04,76.17,-452.54999999999984
347,44902994,2023-02-05,99.16,-353.3899999999999
5430,44902994,2023-02-06,-28.63,-382.01999999999987
6322,44902994,2023-02-08,117.41,-264.6099999999999
2025,44902994,2023-02-13,-61.69,-326.29999999999984
1161,44912164,2023-01-31,,355.61
7107,44912164,2023-02-03,-110.67,244.94
458,44912164,2023-02-05,-29.75,215.19
6232,44912164,2023-02-07,-50.93,164.26000000000002
2133,44912164,2023-02-12,25.82,190.08
8487,44912164,2023-02-13,-128.76,61.32000000000002
8600,44912164,2023-02-14,157.43,218.75000000000003
1153,44912164,2023-02-14,49.38,268.13000000000005
1162,45015534,2023-01-31,,215.54
401,45015534,2023-02-06,-154.92,60.620000000000005
4044,45015534,2023-02-07,76.2,136.82
7904,45015534,2023-02-08,1032.4,1169.22
8130,45015534,2023-02-09,83.42,1252.64
1163,45015570,2023-01-31,,905.57
999,45015570,2023-02-01,754.9,1660.47
6724,45015570,2023-02-01,137.72,1798.19
5923,45015570,2023-02-06,-72.7,1725.49
3710,45015570,2023-02-06,-98.87,1626.6200000000001
3983,45015570,2023-02-07,136.3,1762.92
8397,45015570,2023-02-08,-150.64,1612.28
457,45015570,2023-02-09,-145.82,1466.46
1081,45015570,2023-02-13,159.89,1626.35
6567,45015570,2023-02-14,176.37,1802.72
1164,45020832,2023-01-31,,104.89
6555,45020832,2023-02-02,92.05,196.94
7541,45020832,2023-02-03,89.95,286.89
3110,45020832,2023-02-05,-158.24,128.64999999999998
5165,45020832,2023-02-09,110.01,238.65999999999997
6946,45020832,2023-02-11,42.85,281.51
1993,45020832,2023-02-11,16.09,297.59999999999997
1165,45021115,2023-01-31,,464.27
6511,45021115,2023-02-07,116.04,580.31
1902,45021115,2023-02-08,-189.71,390.59999999999997
3045,45021115,2023-02-10,125.47,516.0699999999999
4559,45021115,2023-02-10,62.01,578.0799999999999
5917,45021115,2023-02-11,1813.6,2391.68
6849,45021115,2023-02-12,41.2,2432.8799999999997
7284,45021115,2023-02-13,-18.93,2413.95
1166,45021398,2023-01-31,,783.24
8119,45021398,2023-02-02,77.43,860.6700000000001
1826,45021398,2023-02-04,515.6,1376.27
6097,45021398,2023-02-08,-68.68,1307.59
7851,45021398,2023-02-10,108.64,1416.23
1319,45021398,2023-02-10,-72.23,1344.0
1619,45021398,2023-02-10,-344.3,999.6999999999999
1167,45026430,2023-01-31,,745.31
2531,45026430,2023-02-04,178.94,924.25
6973,45026430,2023-02-07,-36.73,887.52
7415,45026430,2023-02-09,-148.45,739.0699999999999
2815,45026430,2023-02-10,-55.29,683.78
2368,45026430,2023-02-11,626.6,1310.38
4981,45026430,2023-02-13,-85.75,1224.63
1168,45027876,2023-01-31,,80.13
2608,45027876,2023-02-01,72.35,152.48
1751,45027876,2023-02-01,-57.48,95.0
6708,45027876,2023-02-01,-170.25,-75.25
6435,45027876,2023-02-03,-79.86,-155.11
3840,45027876,2023-02-04,176.15,21.04000000000002
2439,45027876,2023-02-06,-80.8,-59.75999999999998
2060,45027876,2023-02-07,54.35,-5.409999999999975
6347,45027876,2023-02-07,-227.16,-232.56999999999996
4354,45027876,2023-02-12,-3.07,-235.63999999999996
5362,45027876,2023-02-14,-85.41,-321.04999999999995
1169,45029598,2023-01-31,,558.87
4410,45029598,2023-02-06,-67.0,491.87
480,45029598,2023-02-06,-119.61,372.26
7661,45029598,2023-02-08,-149.83,222.43
5283,45029598,2023-02-09,76.46,298.89
3839,45029598,2023-02-09,70.47,369.36
6620,45029598,2023-02-09,-64.47,304.89
7782,45029598,2023-02-12,7.46,312.35
5084,45029598,2023-02-14,42.19,354.54
7929,45029598,2023-02-14,-1338.4,-983.8600000000001
1170,45067158,2023-01-31,,115.23
3603,45067158,2023-02-04,-78.83,36.400000000000006
313,45067158,2023-02-04,-101.3,-64.89999999999999
4685,45067158,2023-02-04,-102.44,-167.33999999999997
6988,45067158,2023-02-05,106.32,-61.019999999999996
3233,45067158,2023-02-05,-83.99,-145.01
2428,45067158,2023-02-09,184.91,39.900000000000006
5557,45067158,2023-02-10,177.19,217.09
2813,45067158,2023-02-11,90.72,307.81
1171,45089475,2023-01-31,,676.92
7056,45089475,2023-02-03,-119.64,557.28
4624,45089475,2023-02-13,-125.97,431.30999999999995
1497,45089475,2023-02-13,-1582.4,-1151.0900000000001
1172,45111669,2023-01-31,,459.28
3428,45111669,2023-02-01,121.91,581.1899999999999
1591,45111669,2023-02-03,16.43,597.62
8007,45111669,2023-02-10,-116.33,481.28999999999996
801,45111669,2023-02-11,-84.36,396.92999999999995
6535,45111669,2023-02-14,-173.04,223.89
1173,45161114,2023-01-31,,282.6
4487,45161114,2023-02-01,134.43,417.03000000000003
3804,45161114,2023-02-06,132.91,549.94
275,45161114,2023-02-10,126.15,676.09
1174,45196342,2023-01-31,,402.48
8501,45196342,2023-02-01,-64.89,337.59000000000003
7627,45196342,2023-02-03,-104.89,232.70000000000002
6122,45196342,2023-02-04,136.46,369.16
2353,45196342,2023-02-10,120.91,490.07000000000005
1416,45196342,2023-02-11,-112.23,377.84000000000003
8540,45196342,2023-02-12,-1192.7,-814.86
1175,45238909,2023-01-31,,904.83
4828,45238909,2023-02-04,120.85,1025.68
2105,45238909,2023-02-08,751.9,1777.58
5419,45238909,2023-02-08,-38.91,1738.67
1998,45238909,2023-02-13,133.97,1872.64
1176,45242171,2023-01-31,,174.66
4313,45242171,2023-02-04,84.12,258.78
3770,45242171,2023-02-09,-93.14,165.64
4216,45242171,2023-02-13,73.31,238.95
1177,45253870,2023-01-31,,273.37
145,45253870,2023-02-07,485.9,759.27
1511,45253870,2023-02-11,-78.2,681.0699999999999
4531,45253870,2023-02-12,142.98,824.05
1178,45275334,2023-01-31,,49.55
4312,45275334,2023-02-02,112.23,161.78
7541,45275334,2023-02-03,-89.95,71.83
1179,45397824,2023-01-31,,741.62
4694,45397824,2023-02-01,-130.8,610.8199999999999
6307,45397824,2023-02-02,177.51,788.3299999999999
4314,45397824,2023-02-03,20.42,808.75
7078,45397824,2023-02-03,-154.95,653.8
7852,45397824,2023-02-07,-113.55,540.25
5675,45397824,2023-02-11,46.65,586.9
3449,45397824,2023-02-12,134.97,721.87
2323,45397824,2023-02-14,-625.3,96.57000000000005
1180,45519330,2023-01-31,,840.22
6713,45519330,2023-02-01,-80.88,759.34
3029,45519330,2023-02-01,-180.83,578.51
2715,45519330,2023-02-03,240.26,818.77
3,45519330,2023-02-07,85.76,904.53
3316,45519330,2023-02-11,-163.65,740.88
1747,45519330,2023-02-13,25.59,766.47
1181,45543867,2023-01-31,,419.92
5217,45543867,2023-02-01,82.42,502.34000000000003
6747,45543867,2023-02-02,117.71,620.05
1837,45543867,2023-02-03,136.66,756.71
5156,45543867,2023-02-03,106.43,863.14
3468,45543867,2023-02-07,1522.0,2385.14
679,45543867,2023-02-09,100.78,2485.92
7675,45543867,2023-02-11,-78.66,2407.2599999999998
3335,45543867,2023-02-13,562.4,2969.66
1182,45558696,2023-01-31,,760.19
7558,45558696,2023-02-02,1890.0,2650.19
3991,45558696,2023-02-05,-1526.1,1124.0900000000001
467,45558696,2023-02-07,42.19,1166.2800000000002
5210,45558696,2023-02-07,-144.93,1021.3500000000001
8399,45558696,2023-02-07,-173.42,847.9300000000002
8629,45558696,2023-02-08,-62.15,785.7800000000002
1183,45611838,2023-01-31,,784.55
4926,45611838,2023-02-03,47.74,832.29
8382,45611838,2023-02-04,46.49,878.78
6649,45611838,2023-02-04,-53.51,825.27
5618,45611838,2023-02-06,-97.64,727.63
3332,45611838,2023-02-07,-69.22,658.41
7137,45611838,2023-02-09,173.88,832.29
332,45611838,2023-02-14,122.61,954.9
1184,45631973,2023-01-31,,762.7
2020,45631973,2023-02-01,-187.01,575.69
4790,45631973,2023-02-04,109.43,685.1200000000001
4144,45631973,2023-02-05,-220.0,465.12000000000006
1888,45631973,2023-02-08,-1428.0,-962.8799999999999
7891,45631973,2023-02-09,105.79,-857.0899999999999
82,45631973,2023-02-11,-108.78,-965.8699999999999
1185,45639009,2023-01-31,,489.05
7210,45639009,2023-02-04,-72.72,416.33000000000004
2839,45639009,2023-02-04,-108.24,308.09000000000003
972,45639009,2023-02-05,-5.44,302.65000000000003
5689,45639009,2023-02-05,-72.56,230.09000000000003
4171,45639009,2023-02-09,-44.94,185.15000000000003
3155,45639009,2023-02-12,205.26,390.41
7844,45639009,2023-02-12,-114.03,276.38
1186,45688415,2023-01-31,,686.92
6492,45688415,2023-02-01,1393.7,2080.62
4555,45688415,2023-02-03,178.47,2259.09
7047,45688415,2023-02-07,-121.91,2137.1800000000003
5987,45688415,2023-02-11,96.36,2233.54
263,45688415,2023-02-11,-135.48,2098.06
1814,45688415,2023-02-13,102.31,2200.37
1187,45706674,2023-01-31,,390.73
845,45706674,2023-02-01,-1187.7,-796.97
4003,45706674,2023-02-04,114.54,-682.4300000000001
863,45706674,2023-02-04,-141.31,-823.74
7828,45706674,2023-02-04,-150.84,-974.58
7008,45706674,2023-02-05,109.63,-864.95
4920,45706674,2023-02-06,-60.77,-925.72
3184,45706674,2023-02-10,-123.35,-1049.07
4021,45706674,2023-02-12,-158.11,-1207.18
1188,45740727,2023-01-31,,904.27
3214,45740727,2023-02-05,149.91,1054.18
4057,45740727,2023-02-08,-220.34,833.8399999999999
5055,45740727,2023-02-13,155.36,989.2
1189,45790907,2023-01-31,,567.67
4823,45790907,2023-02-01,1264.3,1831.9699999999998
7181,45790907,2023-02-01,112.34,1944.31
7001,45790907,2023-02-04,133.0,2077.31
5109,45790907,2023-02-04,-45.53,2031.78
4518,45790907,2023-02-05,108.92,2140.7
3564,45790907,2023-02-05,58.28,2198.98
877,45790907,2023-02-07,-67.95,2131.03
4972,45790907,2023-02-10,-1275.4,855.6299999999999
3195,45790907,2023-02-12,-144.32,711.31
1267,45790907,2023-02-14,-67.85,643.4599999999999
1190,45816894,2023-01-31,,227.68
4040,45816894,2023-02-02,-81.01,146.67000000000002
6477,45816894,2023-02-08,1006.9,1153.57
6553,45816894,2023-02-13,-44.84,1108.73
1231,45816894,2023-02-13,-152.58,956.1500000000001
1191,45822265,2023-01-31,,881.34
737,45822265,2023-02-02,-180.16,701.1800000000001
4829,45822265,2023-02-03,-113.78,587.4000000000001
5951,45822265,2023-02-05,99.15,686.5500000000001
6412,45822265,2023-02-05,-617.7,68.85000000000002
4280,45822265,2023-02-05,-1152.5,-1083.65
3845,45822265,2023-02-11,-86.28,-1169.93
1114,45822265,2023-02-11,-140.15,-1310.0800000000002
8471,45822265,2023-02-12,877.5,-432.58000000000015
1192,45829157,2023-01-31,,361.77
5962,45829157,2023-02-01,-147.6,214.17
6776,45829157,2023-02-03,-183.87,30.299999999999983
4904,45829157,2023-02-05,23.74,54.03999999999998
392,45829157,2023-02-06,156.97,211.01
6162,45829157,2023-02-08,-80.46,130.54999999999995
7097,45829157,2023-02-10,114.0,244.54999999999995
5512,45829157,2023-02-12,89.04,333.59
6494,45829157,2023-02-14,-153.48,180.10999999999999
1193,45859156,2023-01-31,,644.5
7670,45859156,2023-02-01,-146.02,498.48
1273,45859156,2023-02-02,120.32,618.8
4245,45859156,2023-02-05,166.03,784.8299999999999
4586,45859156,2023-02-07,102.22,887.05
1804,45859156,2023-02-10,1725.1,2612.1499999999996
1194,45960045,2023-01-31,,853.47
4121,45960045,2023-02-03,128.1,981.57
5670,45960045,2023-02-03,49.28,1030.85
5312,45960045,2023-02-07,-45.38,985.47
2425,45960045,2023-02-09,120.08,1105.55
2363,45960045,2023-02-13,-35.47,1070.08
4775,45960045,2023-02-13,-48.13,1021.95
1195,45974864,2023-01-31,,957.27
5968,45974864,2023-02-03,-108.6,848.67
6846,45974864,2023-02-10,120.81,969.48
4688,45974864,2023-02-13,63.85,1033.33
2184,45974864,2023-02-14,-43.42,989.91
1196,46012936,2023-01-31,,120.79
364,46012936,2023-02-03,46.59,167.38
3066,46012936,2023-02-04,-113.62,53.760000000000005
5684,46012936,2023-02-06,55.52,109.28
1035,46012936,2023-02-13,62.93,172.21
4913,46012936,2023-02-14,-175.07,-2.859999999999985
1197,46059921,2023-01-31,,905.78
4742,46059921,2023-02-01,-95.21,810.5699999999999
7663,46059921,2023-02-02,-79.3,731.27
8275,46059921,2023-02-10,83.52,814.79
8562,46059921,2023-02-13,9.8,824.59
8516,46059921,2023-02-14,-147.85,676.74
1198,46064017,2023-01-31,,672.77
168,46064017,2023-02-02,28.99,701.76
6738,46064017,2023-02-03,129.73,831.49
5990,46064017,2023-02-05,60.9,892.39
6734,46064017,2023-02-10,1575.6,2467.99
548,46064017,2023-02-11,-471.8,1996.1899999999998
8283,46064017,2023-02-12,145.68,2141.87
3118,46064017,2023-02-12,-115.87,2025.9999999999998
2941,46064017,2023-02-13,-800.9,1225.1
3928,46064017,2023-02-14,141.13,1366.2299999999998
1199,46067647,2023-01-31,,677.66
950,46067647,2023-02-03,-54.41,623.25
1529,46067647,2023-02-03,-88.94,534.31
6010,46067647,2023-02-03,-98.31,436.0
30,46067647,2023-02-06,64.29,500.28999999999996
1169,46067647,2023-02-08,-43.9,456.39
1719,46067647,2023-02-13,140.52,596.91
5483,46067647,2023-02-14,101.91,698.8199999999999
1200,46073044,2023-01-31,,957.36
3536,46073044,2023-02-06,-158.15,799.21
4498,46073044,2023-02-08,-265.04,534.17
7080,46073044,2023-02-11,-121.51,412.65999999999997
3218,46073044,2023-02-14,1879.5,2292.16
784,46073044,2023-02-14,155.82,2447.98
1201,46085917,2023-01-31,,340.16
2243,46085917,2023-02-06,104.85,445.01
4741,46085917,2023-02-08,-110.8,334.21000000000004
1396,46085917,2023-02-08,-1374.1,-1039.8899999999999
3673,46085917,2023-02-09,-155.66,-1195.55
4525,46085917,2023-02-10,90.3,-1105.2499999999998
2089,46085917,2023-02-11,155.49,-949.7599999999999
5496,46085917,2023-02-13,67.31,-882.4499999999998
2624,46085917,2023-02-13,62.41,-820.0399999999998
1202,46100177,2023-01-31,,979.25
2107,46100177,2023-02-02,-93.98,885.27
2289,46100177,2023-02-02,-681.0,204.26999999999998
1604,46100177,2023-02-03,-42.34,161.92999999999998
2726,46100177,2023-02-06,-74.62,87.30999999999997
1679,46100177,2023-02-08,797.2,884.51
799,46100177,2023-02-09,99.44,983.95
1203,46133743,2023-01-31,,862.26
4288,46133743,2023-02-02,-100.0,762.26
1070,46133743,2023-02-06,93.21,855.47
1479,46133743,2023-02-10,29.52,884.99
1204,46215382,2023-01-31,,549.77
8269,46215382,2023-02-03,-76.11,473.65999999999997
6740,46215382,2023-02-03,-152.95,320.71
876,46215382,2023-02-03,-1569.4,-1248.69
1166,46215382,2023-02-04,-57.41,-1306.1000000000001
1797,46215382,2023-02-05,-114.53,-1420.63
7404,46215382,2023-02-06,171.29,-1249.3400000000001
534,46215382,2023-02-07,-167.72,-1417.06
6857,46215382,2023-02-10,2084.1,667.04
4592,46215382,2023-02-11,-56.36,610.68
8398,46215382,2023-02-13,135.78,746.46
4867,46215382,2023-02-13,-38.78,707.68
1205,46230315,2023-01-31,,4.43
1120,46230315,2023-02-02,120.61,125.03999999999999
2207,46230315,2023-02-04,-153.16,-28.119999999999976
7006,46230315,2023-02-06,-145.42,-173.53999999999996
7331,46230315,2023-02-13,125.25,-48.289999999999964
4814,46230315,2023-02-13,-66.15,-114.43999999999997
1206,46231176,2023-01-31,,290.35
536,46231176,2023-02-01,162.41,452.76
5852,46231176,2023-02-01,-1397.4,-944.6400000000001
1771,46231176,2023-02-02,98.15,-846.4900000000001
606,46231176,2023-02-05,-46.86,-893.3500000000001
6292,46231176,2023-02-09,625.1,-268.2500000000001
5519,46231176,2023-02-11,-17.45,-285.7000000000001
6373,46231176,2023-02-12,55.81,-229.8900000000001
7004,46231176,2023-02-12,-37.7,-267.59000000000015
1917,46231176,2023-02-13,94.69,-172.90000000000012
8123,46231176,2023-02-13,-16.59,-189.49000000000012
1207,46255563,2023-01-31,,565.42
4328,46255563,2023-02-01,92.51,657.93
1667,46255563,2023-02-04,-129.16,528.77
6266,46255563,2023-02-14,-52.1,476.66999999999996
8043,46255563,2023-02-14,-89.67,387.0
1208,46322903,2023-01-31,,873.01
4607,46322903,2023-02-06,-22.54,850.47
1471,46322903,2023-02-06,-179.1,671.37
1592,46322903,2023-02-08,66.39,737.76
5248,46322903,2023-02-08,-206.07,531.69
5203,46322903,2023-02-09,143.77,675.46
116,46322903,2023-02-14,81.74,757.2
1209,46326165,2023-01-31,,571.8
5767,46326165,2023-02-03,-94.28,477.52
3420,46326165,2023-02-06,14.55,492.06999999999994
268,46326165,2023-02-07,-87.09,404.97999999999996
7869,46326165,2023-02-10,143.62,548.5999999999999
1698,46326165,2023-02-12,-99.3,449.29999999999995
8181,46326165,2023-02-13,185.27,634.5699999999999
1210,46346470,2023-01-31,,787.87
8651,46346470,2023-02-02,-93.94,693.9300000000001
7001,46346470,2023-02-04,-133.0,560.9300000000001
6753,46346470,2023-02-08,-35.51,525.42
8585,46346470,2023-02-09,70.29,595.71
3431,46346470,2023-02-11,-118.19,477.52
5060,46346470,2023-02-12,81.44,558.96
1009,46346470,2023-02-13,-67.73,491.23
1211,46355307,2023-01-31,,152.4
3735,46355307,2023-02-01,-161.31,-8.909999999999997
2809,46355307,2023-02-02,174.13,165.22
7825,46355307,2023-02-14,-987.9,-822.68
1212,46442210,2023-01-31,,732.14
112,46442210,2023-02-02,-118.22,613.92
2439,46442210,2023-02-06,80.8,694.72
7475,46442210,2023-02-09,-899.8,-205.07999999999993
5622,46442210,2023-02-11,-23.58,-228.6599999999999
8111,46442210,2023-02-14,34.84,-193.81999999999994
1213,46479025,2023-01-31,,323.03
3188,46479025,2023-02-04,88.89,411.91999999999996
5631,46479025,2023-02-04,-45.51,366.40999999999997
6314,46479025,2023-02-11,-90.03,276.38
4075,46479025,2023-02-12,100.49,376.86999999999995
7594,46479025,2023-02-14,-172.38,204.48999999999995
1214,46525458,2023-01-31,,938.4
7604,46525458,2023-02-05,-1748.6,-810.1999999999999
3461,46525458,2023-02-07,1225.0,414.80000000000007
7348,46525458,2023-02-07,153.96,568.7600000000001
6072,46525458,2023-02-10,86.14,654.9000000000001
6358,46525458,2023-02-11,-38.25,616.6500000000001
4374,46525458,2023-02-13,-116.37,500.2800000000001
1215,46552077,2023-01-31,,672.51
7550,46552077,2023-02-02,-54.94,617.5699999999999
6664,46552077,2023-02-06,-153.53,464.03999999999996
1216,46561814,2023-01-31,,216.29
6971,46561814,2023-02-01,70.34,286.63
280,46561814,2023-02-06,-106.0,180.63
3298,46561814,2023-02-07,93.93,274.56
3824,46561814,2023-02-07,-185.39,89.17000000000002
4743,46561814,2023-02-07,-214.17,-124.99999999999997
3915,46561814,2023-02-09,124.56,-0.4399999999999693
507,46561814,2023-02-13,-159.46,-159.89999999999998
1217,46597215,2023-01-31,,455.5
3006,46597215,2023-02-06,73.5,529.0
5325,46597215,2023-02-07,165.34,694.34
7967,46597215,2023-02-08,1123.1,1817.44
736,46597215,2023-02-09,-11.47,1805.97
1218,46597728,2023-01-31,,920.72
3992,46597728,2023-02-04,110.99,1031.71
1290,46597728,2023-02-05,749.9,1781.6100000000001
577,46597728,2023-02-06,111.94,1893.55
2251,46597728,2023-02-13,-165.07,1728.48
5408,46597728,2023-02-13,-1856.7,-128.22000000000003
1219,46643937,2023-01-31,,751.73
4439,46643937,2023-02-03,61.92,813.65
8336,46643937,2023-02-07,67.88,881.53
3526,46643937,2023-02-07,-74.11,807.4200000000001
2049,46643937,2023-02-07,-1348.3,-540.8799999999999
2408,46643937,2023-02-11,226.92,-313.9599999999999
7861,46643937,2023-02-12,1041.9,727.9400000000002
395,46643937,2023-02-12,76.94,804.8800000000001
1869,46643937,2023-02-14,-110.66,694.2200000000001
1220,46663039,2023-01-31,,989.43
4184,46663039,2023-02-01,49.37,1038.8
5320,46663039,2023-02-03,-52.27,986.53
6403,46663039,2023-02-03,-119.2,867.3299999999999
66,46663039,2023-02-06,161.03,1028.36
7744,46663039,2023-02-06,34.2,1062.56
7413,46663039,2023-02-09,-813.0,249.55999999999995
1487,46663039,2023-02-12,120.86,370.41999999999996
8357,46663039,2023-02-14,-112.47,257.94999999999993
1221,46730484,2023-01-31,,398.49
3004,46730484,2023-02-04,111.88,510.37
2499,46730484,2023-02-10,-111.05,399.32
4286,46730484,2023-02-11,-63.08,336.24
5345,46730484,2023-02-13,80.9,417.14
3133,46730484,2023-02-14,-79.28,337.86
1222,46741126,2023-01-31,,393.18
8613,46741126,2023-02-02,-114.87,278.31
4400,46741126,2023-02-03,-169.26,109.05000000000001
7064,46741126,2023-02-06,-46.16,62.890000000000015
695,46741126,2023-02-07,-60.76,2.1300000000000168
2393,46741126,2023-02-10,184.75,186.88000000000002
4664,46741126,2023-02-13,-116.37,70.51000000000002
1223,46768821,2023-01-31,,458.81
6210,46768821,2023-02-03,90.12,548.9300000000001
4554,46768821,2023-02-04,135.11,684.04
4948,46768821,2023-02-06,124.41,808.45
6350,46768821,2023-02-08,-132.61,675.84
5738,46768821,2023-02-13,129.28,805.12
1224,46790294,2023-01-31,,855.42
4419,46790294,2023-02-01,-55.85,799.5699999999999
6695,46790294,2023-02-01,-156.88,642.6899999999999
2064,46790294,2023-02-03,-72.41,570.28
268,46790294,2023-02-07,87.09,657.37
989,46790294,2023-02-08,-98.38,558.99
3699,46790294,2023-02-09,37.65,596.64
1225,46792863,2023-01-31,,843.5
4060,46792863,2023-02-01,-81.07,762.4300000000001
2113,46792863,2023-02-03,87.36,849.79
6405,46792863,2023-02-06,159.47,1009.26
3330,46792863,2023-02-07,-84.66,924.6
1226,46851905,2023-01-31,,18.23
1088,46851905,2023-02-01,216.49,234.72
8598,46851905,2023-02-01,-123.29,111.42999999999999
6543,46851905,2023-02-04,196.98,308.40999999999997
8097,46851905,2023-02-05,140.22,448.63
2580,46851905,2023-02-06,441.4,890.03
6648,46851905,2023-02-09,50.63,940.66
1227,46854962,2023-01-31,,364.03
150,46854962,2023-02-01,35.88,399.90999999999997
6345,46854962,2023-02-01,-81.49,318.41999999999996
8140,46854962,2023-02-02,93.7,412.12
4884,46854962,2023-02-13,104.27,516.39
1474,46854962,2023-02-14,111.83,628.22
4631,46854962,2023-02-14,-544.0,84.22000000000003
1228,46879333,2023-01-31,,462.44
6377,46879333,2023-02-06,-135.77,326.66999999999996
2566,46879333,2023-02-10,38.95,365.62
4858,46879333,2023-02-14,-79.28,286.34
6268,46879333,2023-02-14,-128.86,157.47999999999996
1229,46913859,2023-01-31,,410.19
5342,46913859,2023-02-01,-119.68,290.51
2640,46913859,2023-02-05,88.7,379.21
5834,46913859,2023-02-07,126.94,506.15
3421,46913859,2023-02-08,1127.1,1633.25
2007,46913859,2023-02-09,-107.84,1525.41
1230,46920610,2023-01-31,,124.16
5413,46920610,2023-02-01,124.86,249.01999999999998
7321,46920610,2023-02-02,25.85,274.87
8646,46920610,2023-02-05,36.13,311.0
7746,46920610,2023-02-05,-161.25,149.75
7214,46920610,2023-02-08,-30.53,119.22
3035,46920610,2023-02-09,-93.51,25.709999999999994
1231,46925211,2023-01-31,,509.25
308,46925211,2023-02-01,189.46,698.71
6677,46925211,2023-02-09,4.38,703.09
3155,46925211,2023-02-12,-205.26,497.83000000000004
7182,46925211,2023-02-13,49.89,547.72
1232,47040996,2023-01-31,,462.95
6471,47040996,2023-02-01,-130.83,332.12
7618,47040996,2023-02-02,173.89,506.01
778,47040996,2023-02-03,121.3,627.31
5773,47040996,2023-02-04,-98.52,528.79
491,47040996,2023-02-07,-89.73,439.05999999999995
2382,47040996,2023-02-09,-76.61,362.44999999999993
2508,47040996,2023-02-12,7.66,370.10999999999996
1233,47091705,2023-01-31,,54.6
8244,47091705,2023-02-01,-75.52,-20.919999999999995
8380,47091705,2023-02-02,41.88,20.960000000000008
1545,47091705,2023-02-02,-88.29,-67.33
2746,47091705,2023-02-03,-67.38,-134.70999999999998
3447,47091705,2023-02-04,95.6,-39.11
3246,47091705,2023-02-05,1195.0,1155.89
4302,47091705,2023-02-05,-142.28,1013.6100000000001
5339,47091705,2023-02-06,92.29,1105.9
6783,47091705,2023-02-09,1340.1,2446.0
6584,47091705,2023-02-14,96.17,2542.17
1234,47115177,2023-01-31,,759.59
2983,47115177,2023-02-01,81.36,840.95
1767,47115177,2023-02-01,-137.75,703.2
969,47115177,2023-02-04,110.0,813.2
551,47115177,2023-02-06,-527.4,285.80000000000007
2695,47115177,2023-02-09,-136.48,149.32000000000008
367,47115177,2023-02-11,120.95,270.2700000000001
5823,47115177,2023-02-13,167.82,438.0900000000001
2251,47115177,2023-02-13,165.07,603.1600000000001
2828,47115177,2023-02-13,72.13,675.2900000000001
968,47115177,2023-02-14,123.42,798.71
1235,47127756,2023-01-31,,300.02
8044,47127756,2023-02-02,-101.47,198.54999999999998
5793,47127756,2023-02-12,-84.03,114.51999999999998
1236,47133143,2023-01-31,,723.52
2321,47133143,2023-02-01,-182.36,541.16
6497,47133143,2023-02-03,33.17,574.3299999999999
402,47133143,2023-02-07,-57.45,516.88
2125,47133143,2023-02-13,-31.07,485.80999999999995
7896,47133143,2023-02-14,-41.25,444.55999999999995
1237,47172665,2023-01-31,,11.06
2253,47172665,2023-02-08,-80.13,-69.07
2215,47172665,2023-02-08,-130.56,-199.63
394,47172665,2023-02-13,56.41,-143.22
1747,47172665,2023-02-13,-25.59,-168.81
54,47172665,2023-02-14,135.61,-33.19999999999999
1238,47226769,2023-01-31,,449.88
1050,47226769,2023-02-01,126.5,576.38
549,47226769,2023-02-04,-132.93,443.45
2567,47226769,2023-02-06,1065.6,1509.05
5301,47226769,2023-02-06,-125.82,1383.23
7036,47226769,2023-02-07,169.12,1552.35
1239,47232232,2023-01-31,,53.44
3891,47232232,2023-02-01,126.4,179.84
7912,47232232,2023-02-07,-134.29,45.55000000000001
2976,47232232,2023-02-10,-136.1,-90.54999999999998
3064,47232232,2023-02-12,153.41,62.860000000000014
7686,47232232,2023-02-12,-117.55,-54.68999999999998
6799,47232232,2023-02-12,-157.46,-212.14999999999998
1240,47266645,2023-01-31,,207.15
1665,47266645,2023-02-02,876.4,1083.55
1142,47266645,2023-02-02,-190.68,892.8699999999999
6083,47266645,2023-02-06,122.69,1015.56
159,47266645,2023-02-07,-484.1,531.4599999999999
1263,47266645,2023-02-13,138.4,669.8599999999999
1241,47313428,2023-01-31,,204.67
7959,47313428,2023-02-03,965.4,1170.07
3300,47313428,2023-02-08,-113.3,1056.77
6607,47313428,2023-02-13,-127.61,929.16
1242,47356348,2023-01-31,,65.95
4918,47356348,2023-02-03,1223.8,1289.75
6723,47356348,2023-02-13,-139.98,1149.77
1243,47406737,2023-01-31,,963.14
1260,47406737,2023-02-01,844.6,1807.74
6222,47406737,2023-02-03,-68.61,1739.13
4755,47406737,2023-02-06,-1204.5,534.6300000000001
1466,47406737,2023-02-08,24.94,559.5700000000002
8456,47406737,2023-02-09,179.26,738.8300000000002
3183,47406737,2023-02-09,-115.75,623.0800000000002
3195,47406737,2023-02-12,144.32,767.4000000000001
8510,47406737,2023-02-12,128.61,896.0100000000001
85,47406737,2023-02-12,52.46,948.4700000000001
2763,47406737,2023-02-14,-129.18,819.2900000000001
1244,47414258,2023-01-31,,900.7
8513,47414258,2023-02-06,-27.94,872.76
615,47414258,2023-02-06,-123.37,749.3900000000001
6667,47414258,2023-02-06,-184.01,565.3800000000001
5479,47414258,2023-02-07,-1277.4,-712.02
3156,47414258,2023-02-08,-63.1,-775.12
7104,47414258,2023-02-11,108.92,-666.2
6218,47414258,2023-02-13,-134.58,-800.78
1245,47473145,2023-01-31,,801.43
817,47473145,2023-02-12,132.48,933.91
810,47473145,2023-02-12,-35.17,898.7399999999999
1246,47483982,2023-01-31,,661.58
4791,47483982,2023-02-08,-76.6,584.98
5846,47483982,2023-02-10,74.87,659.85
3453,47483982,2023-02-11,159.08,818.9300000000001
3445,47483982,2023-02-13,1017.6,1836.5300000000002
1247,47582488,2023-01-31,,744.99
6781,47582488,2023-02-02,-124.68,620.31
7378,47582488,2023-02-03,-55.81,564.5
751,47582488,2023-02-05,1.11,565.61
3838,47582488,2023-02-05,-88.27,477.34000000000003
6221,47582488,2023-02-05,-110.72,366.62
6082,47582488,2023-02-06,87.2,453.82
4275,47582488,2023-02-07,114.74,568.56
375,47582488,2023-02-12,-7.97,560.59
1789,47582488,2023-02-13,-101.4,459.19
1248,47654093,2023-01-31,,294.0
5939,47654093,2023-02-04,-63.26,230.74
991,47654093,2023-02-05,161.8,392.54
7584,47654093,2023-02-10,88.04,480.58000000000004
2003,47654093,2023-02-12,109.8,590.38
5601,47654093,2023-02-12,-191.46,398.92
1249,47763906,2023-01-31,,980.42
7621,47763906,2023-02-02,-20.57,959.8499999999999
80,47763906,2023-02-02,-187.19,772.66
4454,47763906,2023-02-07,99.56,872.22
375,47763906,2023-02-12,7.97,880.1899999999999
3764,47763906,2023-02-12,-210.36,669.8299999999999
1250,47781255,2023-01-31,,462.62
200,47781255,2023-02-02,133.0,595.62
6994,47781255,2023-02-02,-24.87,570.75
8105,47781255,2023-02-02,-78.61,492.14
635,47781255,2023-02-03,101.07,593.21
3256,47781255,2023-02-05,-67.95,525.26
748,47781255,2023-02-08,63.9,589.16
3418,47781255,2023-02-10,34.35,623.51
7903,47781255,2023-02-14,124.48,747.99
1251,47808992,2023-01-31,,885.16
2869,47808992,2023-02-09,197.63,1082.79
1769,47808992,2023-02-10,106.19,1188.98
3229,47808992,2023-02-11,-121.09,1067.8899999999999
3724,47808992,2023-02-12,-44.96,1022.93
1252,47824990,2023-01-31,,704.97
1415,47824990,2023-02-12,86.17,791.14
1784,47824990,2023-02-13,113.91,905.0500000000001
1253,47886866,2023-01-31,,399.75
6694,47886866,2023-02-02,-25.61,374.14
6341,47886866,2023-02-04,105.17,479.31
5029,47886866,2023-02-07,-110.79,368.52
6260,47886866,2023-02-10,51.82,420.34
1750,47886866,2023-02-11,125.01,545.35
4502,47886866,2023-02-11,-133.59,411.76
2975,47886866,2023-02-14,-32.8,378.96
1254,47902339,2023-01-31,,919.92
1578,47902339,2023-02-05,-65.25,854.67
6145,47902339,2023-02-06,-80.92,773.75
4014,47902339,2023-02-10,165.02,938.77
1255,47932460,2023-01-31,,785.05
5945,47932460,2023-02-01,-99.41,685.64
1580,47932460,2023-02-04,204.89,890.53
6351,47932460,2023-02-04,-220.77,669.76
8490,47932460,2023-02-07,-81.45,588.31
8337,47932460,2023-02-08,-124.98,463.3299999999999
7129,47932460,2023-02-09,-27.53,435.79999999999995
1785,47932460,2023-02-11,909.1,1344.9
1256,47964895,2023-01-31,,982.97
3004,47964895,2023-02-04,-111.88,871.09
1554,47964895,2023-02-05,-184.78,686.3100000000001
3381,47964895,2023-02-07,-46.27,640.0400000000001
481,47964895,2023-02-14,-109.46,530.58
1257,48018851,2023-01-31,,288.26
8462,48018851,2023-02-05,897.5,1185.76
223,48018851,2023-02-07,-101.82,1083.94
4981,48018851,2023-02-13,85.75,1169.69
5330,48018851,2023-02-14,144.57,1314.26
1258,48029032,2023-01-31,,422.88
7886,48029032,2023-02-06,69.2,492.08
1788,48029032,2023-02-06,27.93,520.01
7338,48029032,2023-02-09,98.06,618.0699999999999
3216,48029032,2023-02-09,15.37,633.4399999999999
6549,48029032,2023-02-09,-168.19,465.25
8019,48029032,2023-02-10,-65.29,399.96
3610,48029032,2023-02-12,92.12,492.08
2508,48029032,2023-02-12,-7.66,484.42
7091,48029032,2023-02-13,142.2,626.62
1259,48050578,2023-01-31,,203.26
3934,48050578,2023-02-06,60.08,263.34
7605,48050578,2023-02-07,101.89,365.23
1260,48056301,2023-01-31,,943.28
6178,48056301,2023-02-03,85.06,1028.34
4751,48056301,2023-02-03,-98.24,930.1
6600,48056301,2023-02-13,52.77,982.87
6843,48056301,2023-02-13,-114.39,868.48
1261,48071843,2023-01-31,,997.62
2919,48071843,2023-02-01,-387.9,609.72
6875,48071843,2023-02-02,159.22,768.94
1133,48071843,2023-02-09,-1877.3,-1108.36
1262,48075275,2023-01-31,,881.31
7355,48075275,2023-02-01,-77.94,803.3699999999999
4172,48075275,2023-02-01,-98.75,704.6199999999999
4279,48075275,2023-02-04,117.79,822.41
5636,48075275,2023-02-09,85.81,908.2199999999999
1326,48075275,2023-02-10,142.07,1050.29
5522,48075275,2023-02-14,-1209.0,-158.71000000000004
1263,48081999,2023-01-31,,290.89
3257,48081999,2023-02-02,96.07,386.96
3909,48081999,2023-02-04,189.06,576.02
6550,48081999,2023-02-05,111.66,687.68
6465,48081999,2023-02-06,27.72,715.4
3050,48081999,2023-02-11,72.7,788.1
4154,48081999,2023-02-11,-132.19,655.91
5644,48081999,2023-02-12,1291.9,1947.81
2962,48081999,2023-02-12,-89.43,1858.3799999999999
7753,48081999,2023-02-12,-168.57,1689.81
2644,48081999,2023-02-13,-104.18,1585.6299999999999
1264,48131431,2023-01-31,,809.8
2337,48131431,2023-02-01,-128.93,680.8699999999999
7200,48131431,2023-02-14,404.9,1085.77
1265,48185625,2023-01-31,,822.11
3898,48185625,2023-02-02,-74.49,747.62
2183,48185625,2023-02-03,-106.8,640.82
2401,48185625,2023-02-07,185.51,826.33
7052,48185625,2023-02-13,-98.9,727.4300000000001
1266,48186857,2023-01-31,,518.26
1607,48186857,2023-02-03,145.32,663.5799999999999
6334,48186857,2023-02-06,98.85,762.43
115,48186857,2023-02-09,97.62,860.05
6381,48186857,2023-02-09,69.39,929.4399999999999
8300,48186857,2023-02-12,110.79,1040.23
1267,48271608,2023-01-31,,343.94
14,48271608,2023-02-01,54.71,398.65
7946,48271608,2023-02-03,164.56,563.21
5013,48271608,2023-02-07,140.12,703.33
6159,48271608,2023-02-10,55.38,758.71
613,48271608,2023-02-10,47.4,806.11
1218,48271608,2023-02-10,-111.12,694.99
873,48271608,2023-02-13,1665.4,2360.3900000000003
5097,48271608,2023-02-14,153.15,2513.54
1268,48318402,2023-01-31,,965.28
3173,48318402,2023-02-04,-44.62,920.66
2091,48318402,2023-02-04,-111.18,809.48
8340,48318402,2023-02-08,-96.4,713.0799999999999
4870,48318402,2023-02-09,30.36,743.4399999999999
5485,48318402,2023-02-14,101.59,845.03
1269,48350476,2023-01-31,,305.2
3189,48350476,2023-02-02,95.1,400.29999999999995
3828,48350476,2023-02-02,-38.74,361.56
6715,48350476,2023-02-03,-82.71,278.85
4448,48350476,2023-02-04,-152.03,126.82
25,48350476,2023-02-05,-92.4,34.41999999999999
5102,48350476,2023-02-06,39.91,74.32999999999998
3858,48350476,2023-02-10,213.83,288.15999999999997
2642,48350476,2023-02-10,-57.64,230.51999999999998
1270,48399121,2023-01-31,,984.98
4357,48399121,2023-02-09,233.91,1218.89
1261,48399121,2023-02-14,-104.64,1114.25
1271,48429255,2023-01-31,,79.7
4000,48429255,2023-02-06,-110.9,-31.200000000000003
6146,48429255,2023-02-11,99.36,68.16
1746,48429255,2023-02-12,128.19,196.35
6352,48429255,2023-02-14,-88.32,108.03
1272,48434572,2023-01-31,,351.7
4841,48434572,2023-02-01,-113.69,238.01
3104,48434572,2023-02-03,28.45,266.46
2046,48434572,2023-02-04,72.42,338.88
4159,48434572,2023-02-10,75.71,414.59
1330,48434572,2023-02-11,720.7,1135.29
5725,48434572,2023-02-12,-118.43,1016.8599999999999
1273,48444386,2023-01-31,,962.57
616,48444386,2023-02-05,-91.73,870.84
4528,48444386,2023-02-06,94.25,965.09
588,48444386,2023-02-11,152.17,1117.26
2877,48444386,2023-02-14,73.36,1190.6200000000001
1274,48491614,2023-01-31,,754.45
4699,48491614,2023-02-01,120.88,875.33
4085,48491614,2023-02-06,-738.2,137.13
142,48491614,2023-02-11,-6.19,130.94
1275,48500030,2023-01-31,,917.05
5249,48500030,2023-02-09,-125.13,791.92
4980,48500030,2023-02-13,56.68,848.5999999999999
7481,48500030,2023-02-14,-148.05,700.55
1276,48507357,2023-01-31,,980.8
3734,48507357,2023-02-03,80.54,1061.34
2899,48507357,2023-02-06,-80.07,981.27
4810,48507357,2023-02-11,-81.26,900.01
1277,48524535,2023-01-31,,265.03
6361,48524535,2023-02-01,32.75,297.78
5893,48524535,2023-02-02,50.17,347.95
3290,48524535,2023-02-03,-76.66,271.28999999999996
6455,48524535,2023-02-06,-50.95,220.33999999999997
4543,48524535,2023-02-06,-78.99,141.34999999999997
2533,48524535,2023-02-07,-126.03,15.319999999999979
1859,48524535,2023-02-08,43.73,59.049999999999976
7780,48524535,2023-02-08,-65.85,-6.8000000000000185
2349,48524535,2023-02-10,-71.44,-78.24000000000001
2152,48524535,2023-02-11,-24.18,-102.42000000000002
2812,48524535,2023-02-14,120.62,18.19999999999999
2862,48524535,2023-02-14,-50.36,-32.16000000000001
1278,48532894,2023-01-31,,662.86
4514,48532894,2023-02-02,109.57,772.4300000000001
7590,48532894,2023-02-03,79.16,851.59
7216,48532894,2023-02-11,91.38,942.97
1489,48532894,2023-02-14,597.7,1540.67
1279,48553648,2023-01-31,,80.62
4358,48553648,2023-02-02,-122.23,-41.61
2923,48553648,2023-02-05,-12.08,-53.69
5103,48553648,2023-02-13,89.1,35.41
1280,48569537,2023-01-31,,374.69
4289,48569537,2023-02-01,-1153.0,-778.31
5872,48569537,2023-02-05,-178.08,-956.39
8368,48569537,2023-02-07,-173.79,-1130.1799999999998
5291,48569537,2023-02-07,-230.31,-1360.49
4238,48569537,2023-02-09,938.3,-422.19000000000005
703,48569537,2023-02-10,-92.21,-514.4000000000001
4434,48569537,2023-02-11,818.2,303.79999999999995
3879,48569537,2023-02-13,-46.16,257.64
2862,48569537,2023-02-14,50.36,307.99999999999994
1281,48591774,2023-01-31,,422.94
604,48591774,2023-02-01,84.03,506.97
1101,48591774,2023-02-03,-91.97,415.0
4770,48591774,2023-02-08,146.43,561.4300000000001
4679,48591774,2023-02-09,117.1,678.53
7084,48591774,2023-02-10,-90.33,588.2
6845,48591774,2023-02-10,-121.67,466.53
4392,48591774,2023-02-14,-139.74,326.78999999999996
1282,48625559,2023-01-31,,797.88
515,48625559,2023-02-03,88.02,885.9
2487,48625559,2023-02-04,-146.29,739.61
6539,48625559,2023-02-07,105.97,845.58
8173,48625559,2023-02-08,147.08,992.6600000000001
7153,48625559,2023-02-08,-129.99,862.6700000000001
3021,48625559,2023-02-09,44.19,906.86
2256,48625559,2023-02-10,-93.87,812.99
6360,48625559,2023-02-11,187.8,1000.79
5942,48625559,2023-02-12,85.27,1086.06
7566,48625559,2023-02-14,-53.72,1032.34
1283,48654969,2023-01-31,,83.93
1728,48654969,2023-02-03,43.31,127.24000000000001
3046,48654969,2023-02-08,-119.16,8.080000000000013
2345,48654969,2023-02-10,951.2,959.2800000000001
4936,48654969,2023-02-10,747.3,1706.58
1284,48722022,2023-01-31,,586.44
6778,48722022,2023-02-01,123.96,710.4000000000001
7310,48722022,2023-02-05,-45.1,665.3000000000001
4597,48722022,2023-02-07,148.28,813.58
1838,48722022,2023-02-12,93.42,907.0
174,48722022,2023-02-12,-61.43,845.57
1285,48733708,2023-01-31,,370.74
5347,48733708,2023-02-01,-60.93,309.81
3880,48733708,2023-02-01,-212.62,97.19
3304,48733708,2023-02-02,6.47,103.66
4641,48733708,2023-02-03,87.65,191.31
378,48733708,2023-02-04,5.54,196.85
4667,48733708,2023-02-05,-118.28,78.57000000000001
4651,48733708,2023-02-08,-105.76,-27.189999999999998
2043,48733708,2023-02-09,123.28,96.09
1286,48757991,2023-01-31,,676.6
6509,48757991,2023-02-01,141.6,818.2
7581,48757991,2023-02-07,136.97,955.1700000000001
117,48757991,2023-02-11,86.98,1042.15
1287,48781678,2023-01-31,,401.55
2700,48781678,2023-02-01,-856.5,-454.95
4258,48781678,2023-02-05,150.73,-304.22
1288,48783408,2023-01-31,,278.34
2224,48783408,2023-02-03,140.36,418.7
4191,48783408,2023-02-04,101.75,520.45
5741,48783408,2023-02-07,185.47,705.92
7353,48783408,2023-02-08,105.53,811.45
3793,48783408,2023-02-09,163.2,974.65
5191,48783408,2023-02-11,87.63,1062.28
1289,48799650,2023-01-31,,160.75
1655,48799650,2023-02-01,83.35,244.1
4107,48799650,2023-02-08,-154.93,89.16999999999999
1290,48831634,2023-01-31,,146.94
2736,48831634,2023-02-04,-90.91,56.03
1931,48831634,2023-02-04,-1593.8,-1537.77
1338,48831634,2023-02-06,141.38,-1396.3899999999999
4776,48831634,2023-02-09,91.85,-1304.54
29,48831634,2023-02-09,69.64,-1234.9
4099,48831634,2023-02-11,-103.93,-1338.83
3705,48831634,2023-02-11,-1243.0,-2581.83
5850,48831634,2023-02-13,35.46,-2546.37
8420,48831634,2023-02-13,-148.74,-2695.11
1291,48860469,2023-01-31,,730.37
7655,48860469,2023-02-01,-166.48,563.89
4391,48860469,2023-02-07,195.55,759.44
2194,48860469,2023-02-08,-55.57,703.87
8163,48860469,2023-02-08,-103.37,600.5
7630,48860469,2023-02-10,-167.13,433.37
1292,48875351,2023-01-31,,239.7
1401,48875351,2023-02-12,100.25,339.95
1293,48886521,2023-01-31,,827.29
1520,48886521,2023-02-01,134.06,961.3499999999999
8234,48886521,2023-02-03,98.44,1059.79
6333,48886521,2023-02-04,184.38,1244.17
2823,48886521,2023-02-05,-101.6,1142.57
3944,48886521,2023-02-08,33.64,1176.21
1294,48906756,2023-01-31,,996.87
1083,48906756,2023-02-02,36.6,1033.47
376,48906756,2023-02-02,-34.56,998.91
5469,48906756,2023-02-05,637.3,1636.21
6168,48906756,2023-02-09,-229.85,1406.36
1295,48911149,2023-01-31,,580.54
2829,48911149,2023-02-05,144.63,725.17
8630,48911149,2023-02-09,82.08,807.25
6004,48911149,2023-02-11,-518.1,289.15
1296,48930319,2023-01-31,,595.65
1192,48930319,2023-02-01,167.53,763.18
3773,48930319,2023-02-04,76.06,839.24
4340,48930319,2023-02-05,-68.53,770.71
777,48930319,2023-02-05,-177.45,593.26
6793,48930319,2023-02-08,23.59,616.85
6903,48930319,2023-02-12,51.05,667.9
1297,48940493,2023-01-31,,394.19
839,48940493,2023-02-02,217.51,611.7
7722,48940493,2023-02-02,-22.64,589.06
2587,48940493,2023-02-04,125.73,714.79
7067,48940493,2023-02-04,90.44,805.23
7761,48940493,2023-02-05,216.4,1021.63
1103,48940493,2023-02-05,174.7,1196.33
7293,48940493,2023-02-07,-106.64,1089.69
7565,48940493,2023-02-08,149.31,1239.0
7864,48940493,2023-02-08,-66.57,1172.43
617,48940493,2023-02-08,-967.3,205.1300000000001
230,48940493,2023-02-12,970.8,1175.93
4681,48940493,2023-02-12,-175.32,1000.6100000000001
1298,48976336,2023-01-31,,400.12
6409,48976336,2023-02-01,-2027.7,-1627.58
3361,48976336,2023-02-03,-59.2,-1686.7800000000002
5573,48976336,2023-02-06,58.17,-1628.6100000000001
1790,48976336,2023-02-07,-218.78,-1847.39
1981,48976336,2023-02-08,-91.24,-1938.63
705,48976336,2023-02-10,117.56,-1821.0700000000002
1299,49031081,2023-01-31,,788.18
8592,49031081,2023-02-02,131.8,919.98
6796,49031081,2023-02-03,127.58,1047.56
219,49031081,2023-02-04,-97.05,950.51
3488,49031081,2023-02-08,76.81,1027.32
2894,49031081,2023-02-09,-94.81,932.51
8213,49031081,2023-02-10,134.24,1066.75
4501,49031081,2023-02-10,81.26,1148.01
3977,49031081,2023-02-12,-137.83,1010.18
3692,49031081,2023-02-14,-58.59,951.5899999999999
1300,49031379,2023-01-31,,373.63
1235,49031379,2023-02-01,67.01,440.64
937,49031379,2023-02-03,135.44,576.0799999999999
2482,49031379,2023-02-03,96.51,672.59
7662,49031379,2023-02-07,46.14,718.73
6359,49031379,2023-02-08,-119.48,599.25
5809,49031379,2023-02-10,-129.69,469.56
1301,49039474,2023-01-31,,574.7
1775,49039474,2023-02-01,89.56,664.26
901,49039474,2023-02-03,143.42,807.6800000000001
772,49039474,2023-02-04,56.75,864.4300000000001
6417,49039474,2023-02-05,-1168.4,-303.97
8459,49039474,2023-02-07,24.41,-279.56
6787,49039474,2023-02-11,-1815.0,-2094.56
1302,49071892,2023-01-31,,909.58
3654,49071892,2023-02-04,132.12,1041.7
8674,49071892,2023-02-04,-95.76,945.94
304,49071892,2023-02-06,50.78,996.72
3300,49071892,2023-02-08,113.3,1110.02
3685,49071892,2023-02-09,-93.18,1016.84
7713,49071892,2023-02-10,-141.83,875.01
1303,49075324,2023-01-31,,301.39
3483,49075324,2023-02-03,-40.55,260.84
8342,49075324,2023-02-03,-716.6,-455.76000000000005
4277,49075324,2023-02-06,73.4,-382.36
1913,49075324,2023-02-10,55.08,-327.28000000000003
1304,49095464,2023-01-31,,1.3
7952,49095464,2023-02-01,91.66,92.96
4047,49095464,2023-02-01,-146.39,-53.42999999999999
7173,49095464,2023-02-06,-149.41,-202.83999999999997
1715,49095464,2023-02-06,-168.59,-371.43
5537,49095464,2023-02-11,43.12,-328.31
2314,49095464,2023-02-11,-155.81,-484.12
1589,49095464,2023-02-12,-140.22,-624.34
1990,49095464,2023-02-13,140.3,-484.03999999999996
7038,49095464,2023-02-13,119.03,-365.01
3931,49095464,2023-02-13,-1237.4,-1602.41
1305,49127699,2023-01-31,,155.53
195,49127699,2023-02-01,83.63,239.16
4418,49127699,2023-02-07,89.31,328.47
5264,49127699,2023-02-08,110.78,439.25
4147,49127699,2023-02-08,-122.65,316.6
7755,49127699,2023-02-09,108.53,425.13
4807,49127699,2023-02-11,-130.19,294.94
1306,49157903,2023-01-31,,601.62
1233,49157903,2023-02-03,-993.7,-392.08000000000004
3783,49157903,2023-02-05,175.05,-217.03000000000003
2665,49157903,2023-02-06,-103.08,-320.11
1820,49157903,2023-02-12,94.16,-225.95000000000005
1307,49172838,2023-01-31,,136.96
4895,49172838,2023-02-03,-113.68,23.28
8162,49172838,2023-02-10,24.85,48.13
61,49172838,2023-02-11,-96.47,-48.339999999999996
7741,49172838,2023-02-13,1545.5,1497.16
1829,49172838,2023-02-14,141.48,1638.64
1308,49186099,2023-01-31,,208.24
6054,49186099,2023-02-01,118.24,326.48
7187,49186099,2023-02-01,90.07,416.55
5365,49186099,2023-02-04,92.27,508.82
1309,49216581,2023-01-31,,911.91
999,49216581,2023-02-01,-754.9,157.01
5428,49216581,2023-02-07,1147.4,1304.41
2242,49216581,2023-02-10,-1812.5,-508.0899999999999
8529,49216581,2023-02-13,138.94,-369.1499999999999
1861,49216581,2023-02-13,-127.19,-496.3399999999999
8197,49216581,2023-02-13,-569.6,-1065.94
1310,49253709,2023-01-31,,473.46
7482,49253709,2023-02-01,65.02,538.48
4699,49253709,2023-02-01,-120.88,417.59999999999997
8491,49253709,2023-02-03,134.37,551.97
1667,49253709,2023-02-04,129.16,681.13
4508,49253709,2023-02-04,107.78,788.91
6561,49253709,2023-02-05,-209.45,579.46
7642,49253709,2023-02-07,129.29,708.75
2418,49253709,2023-02-12,151.37,860.12
7973,49253709,2023-02-12,-52.81,807.31
2698,49253709,2023-02-12,-87.33,719.98
2250,49253709,2023-02-13,-109.33,610.65
1311,49310474,2023-01-31,,929.16
8633,49310474,2023-02-01,131.27,1060.43
5700,49310474,2023-02-01,-84.68,975.75
1282,49310474,2023-02-06,-79.45,896.3
1025,49310474,2023-02-07,124.51,1020.81
8227,49310474,2023-02-07,-49.81,971.0
4968,49310474,2023-02-13,165.82,1136.82
4777,49310474,2023-02-14,32.96,1169.78
955,49310474,2023-02-14,-88.77,1081.01
1312,49400211,2023-01-31,,460.24
3880,49400211,2023-02-01,212.62,672.86
3516,49400211,2023-02-02,155.92,828.78
1944,49400211,2023-02-08,192.5,1021.28
5098,49400211,2023-02-09,67.33,1088.61
1906,49400211,2023-02-10,-102.74,985.87
1313,49410021,2023-01-31,,508.72
7927,49410021,2023-02-01,112.52,621.24
4067,49410021,2023-02-06,-121.6,499.64000000000004
7461,49410021,2023-02-12,-129.45,370.19000000000005
2542,49410021,2023-02-14,-72.61,297.58000000000004
1314,49427302,2023-01-31,,468.73
3276,49427302,2023-02-03,79.37,548.1
6160,49427302,2023-02-04,-76.17,471.93
1895,49427302,2023-02-06,1045.4,1517.3300000000002
3712,49427302,2023-02-06,-93.16,1424.17
1265,49427302,2023-02-07,51.11,1475.2800000000002
4581,49427302,2023-02-08,81.34,1556.6200000000001
5941,49427302,2023-02-11,-112.24,1444.38
1999,49427302,2023-02-12,49.41,1493.7900000000002
1315,49441522,2023-01-31,,75.3
7596,49441522,2023-02-01,159.64,234.94
1716,49441522,2023-02-02,-132.64,102.30000000000001
5740,49441522,2023-02-03,183.44,285.74
8621,49441522,2023-02-09,35.02,320.76
7049,49441522,2023-02-10,10.96,331.72
2818,49441522,2023-02-11,-152.11,179.61
1316,49454023,2023-01-31,,798.72
4372,49454023,2023-02-01,780.9,1579.62
5893,49454023,2023-02-02,-50.17,1529.45
8160,49454023,2023-02-02,-92.61,1436.84
1278,49454023,2023-02-02,-123.95,1312.89
882,49454023,2023-02-03,111.24,1424.13
1537,49454023,2023-02-06,155.88,1580.01
1331,49454023,2023-02-07,1070.1,2650.1099999999997
2105,49454023,2023-02-08,-751.9,1898.21
4166,49454023,2023-02-10,-86.78,1811.4299999999998
605,49454023,2023-02-12,57.5,1868.9299999999998
1317,49459559,2023-01-31,,467.56
4350,49459559,2023-02-07,808.1,1275.66
2305,49459559,2023-02-11,-96.16,1179.5
1694,49459559,2023-02-12,-144.16,1035.34
3470,49459559,2023-02-13,-107.55,927.79
8411,49459559,2023-02-14,68.56,996.35
1318,49467252,2023-01-31,,444.92
2965,49467252,2023-02-04,64.43,509.35
6298,49467252,2023-02-05,59.15,568.5
864,49467252,2023-02-06,-51.78,516.72
1193,49467252,2023-02-10,-17.18,499.54
1319,49516533,2023-01-31,,7.4
2541,49516533,2023-02-02,-65.53,-58.13
4785,49516533,2023-02-02,-65.93,-124.06
3261,49516533,2023-02-04,-578.6,-702.6600000000001
1549,49516533,2023-02-05,61.84,-640.8199999999999
862,49516533,2023-02-07,42.04,-598.78
6458,49516533,2023-02-08,-141.86,-740.64
1851,49516533,2023-02-09,-106.29,-846.93
953,49516533,2023-02-11,187.53,-659.4
2520,49516533,2023-02-11,-20.99,-680.39
7651,49516533,2023-02-13,-1188.4,-1868.79
1320,49520335,2023-01-31,,198.79
6682,49520335,2023-02-01,77.78,276.57
2277,49520335,2023-02-03,-104.62,171.95
4917,49520335,2023-02-08,-14.84,157.10999999999999
5049,49520335,2023-02-10,1795.9,1953.01
5145,49520335,2023-02-12,88.2,2041.21
1213,49520335,2023-02-14,-88.67,1952.54
1321,49533543,2023-01-31,,190.64
2456,49533543,2023-02-04,-45.03,145.60999999999999
2940,49533543,2023-02-04,-164.38,-18.77000000000001
7817,49533543,2023-02-05,-986.7,-1005.47
7290,49533543,2023-02-11,57.11,-948.36
7380,49533543,2023-02-11,-77.77,-1026.13
8579,49533543,2023-02-11,-139.2,-1165.33
1322,49534905,2023-01-31,,383.91
3147,49534905,2023-02-07,106.1,490.01
1323,49536707,2023-01-31,,37.3
7060,49536707,2023-02-01,-136.75,-99.45
5457,49536707,2023-02-02,-104.98,-204.43
665,49536707,2023-02-03,-120.86,-325.29
981,49536707,2023-02-03,-173.01,-498.3
7352,49536707,2023-02-05,147.37,-350.93
1240,49536707,2023-02-08,35.81,-315.12
5161,49536707,2023-02-11,-113.2,-428.32
8220,49536707,2023-02-14,-101.69,-530.01
846,49536707,2023-02-14,-120.83,-650.84
1856,49536707,2023-02-14,-228.87,-879.71
1324,49540328,2023-01-31,,458.12
2352,49540328,2023-02-02,-98.11,360.01
5245,49540328,2023-02-04,-122.19,237.82
891,49540328,2023-02-05,-93.03,144.79000000000002
180,49540328,2023-02-09,110.51,255.3
944,49540328,2023-02-13,-172.54,82.76000000000002
1325,49550154,2023-01-31,,178.14
7204,49550154,2023-02-01,-122.7,55.43999999999998
7720,49550154,2023-02-05,76.04,131.48
8096,49550154,2023-02-08,-63.41,68.07
7054,49550154,2023-02-08,-79.16,-11.090000000000003
16,49550154,2023-02-10,-179.95,-191.04
2867,49550154,2023-02-13,151.76,-39.28
6107,49550154,2023-02-14,166.38,127.1
1326,49581833,2023-01-31,,117.56
6992,49581833,2023-02-01,-52.0,65.56
1124,49581833,2023-02-02,-185.74,-120.18
1411,49581833,2023-02-02,-1640.2,-1760.38
772,49581833,2023-02-04,-56.75,-1817.13
1230,49581833,2023-02-13,1013.4,-803.7300000000001
1089,49581833,2023-02-14,-138.71,-942.4400000000002
1327,49696722,2023-01-31,,142.69
7407,49696722,2023-02-02,153.46,296.15
998,49696722,2023-02-04,-88.15,208.0
6956,49696722,2023-02-07,-127.37,80.63
3542,49696722,2023-02-11,126.93,207.56
4221,49696722,2023-02-13,1291.4,1498.96
2968,49696722,2023-02-13,-44.2,1454.76
1328,49834565,2023-01-31,,51.12
8611,49834565,2023-02-03,72.44,123.56
7358,49834565,2023-02-12,-76.93,46.629999999999995
1329,49840526,2023-01-31,,461.64
3266,49840526,2023-02-03,95.71,557.35
2844,49840526,2023-02-05,-200.77,356.58
8525,49840526,2023-02-08,2591.7,2948.2799999999997
2475,49840526,2023-02-09,1530.9,4479.18
6168,49840526,2023-02-09,229.85,4709.03
3012,49840526,2023-02-09,168.65,4877.68
1315,49840526,2023-02-09,-58.39,4819.29
1460,49840526,2023-02-10,107.56,4926.849999999999
1330,49941860,2023-01-31,,655.66
5347,49941860,2023-02-01,60.93,716.5899999999999
2808,49941860,2023-02-03,66.9,783.49
8243,49941860,2023-02-08,-34.93,748.56
1331,49961732,2023-01-31,,673.71
5498,49961732,2023-02-01,99.06,772.77
4326,49961732,2023-02-01,49.48,822.25
4643,49961732,2023-02-08,48.01,870.26
5722,49961732,2023-02-08,-133.54,736.72
3203,49961732,2023-02-09,22.93,759.65
6662,49961732,2023-02-11,107.51,867.1600000000001
6282,49961732,2023-02-11,-68.14,799.02
1332,49966528,2023-01-31,,641.18
2524,49966528,2023-02-01,133.29,774.4699999999999
2875,49966528,2023-02-03,-92.73,681.7399999999999
3805,49966528,2023-02-04,-115.54,566.1999999999999
4706,49966528,2023-02-05,176.37,742.5699999999999
4304,49966528,2023-02-06,152.43,895.0
3010,49966528,2023-02-06,-161.12,733.8799999999999
8095,49966528,2023-02-07,180.28,914.16
7174,49966528,2023-02-09,115.5,1029.6599999999999
7844,49966528,2023-02-12,114.03,1143.69
1333,50018070,2023-01-31,,450.64
5977,50018070,2023-02-03,-656.3,-205.65999999999997
4458,50018070,2023-02-05,112.93,-92.72999999999996
4960,50018070,2023-02-08,-92.25,-184.97999999999996
4525,50018070,2023-02-10,-90.3,-275.28
1334,50024545,2023-01-31,,867.21
7322,50024545,2023-02-03,84.79,952.0
6642,50024545,2023-02-07,-113.13,838.87
6844,50024545,2023-02-07,-605.2,233.66999999999996
5138,50024545,2023-02-09,180.04,413.7099999999999
2495,50024545,2023-02-11,-122.19,291.52
6907,50024545,2023-02-11,-1733.6,-1442.08
3555,50024545,2023-02-13,-37.47,-1479.55
98,50024545,2023-02-13,-71.7,-1551.25
1335,50031425,2023-01-31,,695.18
555,50031425,2023-02-03,493.5,1188.6799999999998
6878,50031425,2023-02-03,115.16,1303.84
1976,50031425,2023-02-07,124.56,1428.3999999999999
8485,50031425,2023-02-10,180.01,1608.4099999999999
8639,50031425,2023-02-12,-124.59,1483.82
3690,50031425,2023-02-14,42.03,1525.85
1336,50114041,2023-01-31,,60.83
4304,50114041,2023-02-06,-152.43,-91.60000000000001
1337,50115324,2023-01-31,,329.32
67,50115324,2023-02-01,80.86,410.18
6169,50115324,2023-02-03,46.85,457.03
7167,50115324,2023-02-03,-130.53,326.5
1615,50115324,2023-02-08,120.55,447.05
7975,50115324,2023-02-12,170.71,617.76
2781,50115324,2023-02-13,33.78,651.54
118,50115324,2023-02-13,-130.18,521.36
6272,50115324,2023-02-13,-813.5,-292.14
1338,50122119,2023-01-31,,264.61
2981,50122119,2023-02-01,774.6,1039.21
6497,50122119,2023-02-03,-33.17,1006.0400000000001
5351,50122119,2023-02-12,18.99,1025.03
230,50122119,2023-02-12,-970.8,54.23000000000013
1339,50132654,2023-01-31,,562.17
7459,50132654,2023-02-02,177.5,739.67
2583,50132654,2023-02-04,-97.84,641.8299999999999
7024,50132654,2023-02-05,168.74,810.5699999999999
8008,50132654,2023-02-07,88.86,899.43
3156,50132654,2023-02-08,63.1,962.53
3767,50132654,2023-02-09,-89.08,873.4499999999999
8261,50132654,2023-02-12,117.48,990.93
979,50132654,2023-02-14,-88.1,902.8299999999999
1340,50150279,2023-01-31,,567.24
450,50150279,2023-02-05,-74.52,492.72
1453,50150279,2023-02-06,106.53,599.25
4111,50150279,2023-02-09,62.92,662.1700000000001
1341,50161801,2023-01-31,,180.69
7163,50161801,2023-02-02,174.75,355.44
8534,50161801,2023-02-02,100.46,455.9
6929,50161801,2023-02-03,172.24,628.14
3739,50161801,2023-02-03,108.09,736.23
2084,50161801,2023-02-03,89.51,825.74
8135,50161801,2023-02-07,113.43,939.17
3443,50161801,2023-02-08,78.98,1018.15
3632,50161801,2023-02-09,-188.3,829.85
2297,50161801,2023-02-10,144.1,973.95
6540,50161801,2023-02-11,105.27,1079.22
4226,50161801,2023-02-14,1674.0,2753.2200000000003
1342,50217872,2023-01-31,,667.95
4785,50217872,2023-02-02,65.93,733.8800000000001
4591,50217872,2023-02-03,-625.5,108.38000000000011
1599,50217872,2023-02-07,-70.62,37.760000000000105
2643,50217872,2023-02-08,-120.31,-82.5499999999999
1113,50217872,2023-02-10,-63.32,-145.8699999999999
7676,50217872,2023-02-11,139.07,-6.799999999999898
5979,50217872,2023-02-11,-47.32,-54.1199999999999
7038,50217872,2023-02-13,-119.03,-173.1499999999999
7492,50217872,2023-02-14,735.5,562.3500000000001
1343,50219545,2023-01-31,,548.12
2996,50219545,2023-02-01,1057.7,1605.8200000000002
2002,50219545,2023-02-06,-50.67,1555.1499999999999
3980,50219545,2023-02-07,124.42,1679.57
4434,50219545,2023-02-11,-818.2,861.3699999999999
5522,50219545,2023-02-14,1209.0,2070.37
1344,50231864,2023-01-31,,117.34
3287,50231864,2023-02-02,135.95,253.29
7198,50231864,2023-02-02,-128.36,124.92999999999998
833,50231864,2023-02-04,-134.46,-9.53000000000003
4315,50231864,2023-02-07,150.57,141.03999999999996
1188,50231864,2023-02-07,29.79,170.82999999999996
4081,50231864,2023-02-10,148.04,318.86999999999995
365,50231864,2023-02-14,178.04,496.90999999999997
1345,50276595,2023-01-31,,686.91
1858,50276595,2023-02-01,-102.6,584.31
2682,50276595,2023-02-03,-88.33,495.97999999999996
1583,50276595,2023-02-03,-98.41,397.57
4190,50276595,2023-02-04,86.9,484.46999999999997
5411,50276595,2023-02-06,1107.9,1592.3700000000001
8559,50276595,2023-02-11,88.16,1680.5300000000002
6933,50276595,2023-02-11,-81.2,1599.3300000000002
3260,50276595,2023-02-11,-146.95,1452.38
8637,50276595,2023-02-12,-55.85,1396.5300000000002
1346,50324230,2023-01-31,,945.15
3665,50324230,2023-02-05,-64.51,880.64
7143,50324230,2023-02-05,-145.13,735.51
8452,50324230,2023-02-07,-1380.5,-644.99
2102,50324230,2023-02-09,-95.64,-740.63
1347,50335174,2023-01-31,,650.98
4737,50335174,2023-02-05,-99.24,551.74
5565,50335174,2023-02-09,176.84,728.58
6989,50335174,2023-02-09,157.79,886.37
1345,50335174,2023-02-11,194.38,1080.75
7098,50335174,2023-02-14,14.98,1095.73
1348,50360111,2023-01-31,,193.83
6444,50360111,2023-02-02,40.94,234.77
433,50360111,2023-02-05,183.09,417.86
4024,50360111,2023-02-12,26.59,444.45
1349,50402197,2023-01-31,,717.07
7482,50402197,2023-02-01,-65.02,652.0500000000001
3277,50402197,2023-02-01,-469.6,182.45000000000005
7767,50402197,2023-02-02,-962.8,-780.3499999999999
1096,50402197,2023-02-05,75.06,-705.29
4276,50402197,2023-02-05,69.93,-635.3599999999999
3034,50402197,2023-02-11,167.56,-467.7999999999999
3224,50402197,2023-02-11,66.39,-401.4099999999999
5167,50402197,2023-02-12,-109.08,-510.4899999999999
1350,50428641,2023-01-31,,271.51
7373,50428641,2023-02-05,-102.38,169.13
2225,50428641,2023-02-07,62.85,231.98
6651,50428641,2023-02-07,-119.18,112.79999999999998
774,50428641,2023-02-09,-126.46,-13.66000000000001
1731,50428641,2023-02-10,186.7,173.03999999999996
6126,50428641,2023-02-13,101.21,274.24999999999994
1351,50463777,2023-01-31,,143.45
5127,50463777,2023-02-04,-83.95,59.499999999999986
100,50463777,2023-02-08,64.87,124.36999999999999
3780,50463777,2023-02-09,-90.79,33.579999999999984
5345,50463777,2023-02-13,-80.9,-47.32000000000002
2288,50463777,2023-02-14,-73.71,-121.03000000000002
4156,50463777,2023-02-14,-150.33,-271.36
3509,50463777,2023-02-14,-154.58,-425.94000000000005
1352,50520009,2023-01-31,,892.55
1878,50520009,2023-02-04,-68.1,824.4499999999999
7429,50520009,2023-02-06,-136.61,687.8399999999999
8131,50520009,2023-02-08,1808.4,2496.24
8498,50520009,2023-02-12,-68.89,2427.35
5770,50520009,2023-02-13,145.1,2572.45
6941,50520009,2023-02-14,137.73,2710.18
1353,50547726,2023-01-31,,675.06
1086,50547726,2023-02-04,143.88,818.9399999999999
7199,50547726,2023-02-04,46.13,865.0699999999999
1331,50547726,2023-02-07,-1070.1,-205.02999999999997
2999,50547726,2023-02-08,-121.72,-326.75
1769,50547726,2023-02-10,-106.19,-432.93999999999994
4262,50547726,2023-02-11,-132.76,-565.6999999999999
1354,50610780,2023-01-31,,536.41
670,50610780,2023-02-02,133.59,670.0
2987,50610780,2023-02-02,-166.35,503.65
2554,50610780,2023-02-05,-2112.8,-1609.15
1058,50610780,2023-02-06,-436.1,-2045.25
4733,50610780,2023-02-07,737.4,-1307.8500000000001
4019,50610780,2023-02-08,-251.9,-1559.7500000000002
6737,50610780,2023-02-10,-127.71,-1687.46
3843,50610780,2023-02-12,81.53,-1605.93
6804,50610780,2023-02-13,89.42,-1516.5100000000002
1355,50624960,2023-01-31,,5.03
8191,50624960,2023-02-04,-26.76,-21.73
4483,50624960,2023-02-11,159.09,137.36
3199,50624960,2023-02-11,-119.87,17.49000000000001
5228,50624960,2023-02-12,-113.72,-96.22999999999999
4911,50624960,2023-02-13,167.76,71.53
191,50624960,2023-02-13,-126.46,-54.92999999999999
1356,50627436,2023-01-31,,183.41
288,50627436,2023-02-02,30.52,213.93
3766,50627436,2023-02-04,48.4,262.33
310,50627436,2023-02-05,-103.36,158.97
5924,50627436,2023-02-07,146.5,305.47
5732,50627436,2023-02-07,62.35,367.82
7666,50627436,2023-02-08,473.2,841.02
3341,50627436,2023-02-08,-162.59,678.43
6,50627436,2023-02-09,-113.82,564.61
3103,50627436,2023-02-10,-90.73,473.88
109,50627436,2023-02-14,105.03,578.91
1357,50647892,2023-01-31,,540.71
4316,50647892,2023-02-03,121.58,662.2900000000001
386,50647892,2023-02-04,-180.29,482.00000000000006
3976,50647892,2023-02-05,212.21,694.21
1503,50647892,2023-02-05,95.98,790.19
4165,50647892,2023-02-05,23.88,814.07
7809,50647892,2023-02-06,120.78,934.85
4032,50647892,2023-02-10,94.84,1029.69
1358,50693024,2023-01-31,,171.87
6384,50693024,2023-02-02,147.71,319.58000000000004
584,50693024,2023-02-05,-100.33,219.25
3895,50693024,2023-02-09,115.1,334.35
3240,50693024,2023-02-09,-54.92,279.43
6707,50693024,2023-02-10,-98.76,180.67000000000002
2363,50693024,2023-02-13,35.47,216.14
1509,50693024,2023-02-14,139.82,355.96
1359,50756739,2023-01-31,,177.65
7663,50756739,2023-02-02,79.3,256.95
2005,50756739,2023-02-06,-159.04,97.91000000000003
7116,50756739,2023-02-07,94.27,192.18
5271,50756739,2023-02-07,78.73,270.91
2045,50756739,2023-02-09,167.25,438.16
4890,50756739,2023-02-12,20.21,458.37
5559,50756739,2023-02-13,106.08,564.45
4942,50756739,2023-02-13,25.66,590.11
1360,50772829,2023-01-31,,47.57
1523,50772829,2023-02-10,115.74,163.31
3014,50772829,2023-02-11,-63.01,100.29999999999998
7862,50772829,2023-02-12,200.04,300.34
3651,50772829,2023-02-12,76.84,377.17999999999995
3030,50772829,2023-02-12,-1278.9,-901.7200000000001
19,50772829,2023-02-13,79.92,-821.8000000000002
8574,50772829,2023-02-13,66.5,-755.3000000000002
188,50772829,2023-02-14,836.0,80.69999999999982
1361,50813708,2023-01-31,,339.04
7508,50813708,2023-02-01,172.78,511.82000000000005
2224,50813708,2023-02-03,-140.36,371.46000000000004
2625,50813708,2023-02-04,-97.67,273.79
4944,50813708,2023-02-05,45.47,319.26
3584,50813708,2023-02-05,-108.33,210.93
6500,50813708,2023-02-06,-28.34,182.59
1149,50813708,2023-02-08,167.66,350.25
254,50813708,2023-02-10,9.75,360.0
7917,50813708,2023-02-13,-84.2,275.8
1362,50837270,2023-01-31,,613.53
6278,50837270,2023-02-02,147.44,760.97
6408,50837270,2023-02-04,-105.81,655.16
3684,50837270,2023-02-12,114.06,769.22
157,50837270,2023-02-13,-437.5,331.71999999999997
1017,50837270,2023-02-14,66.68,398.4
1363,50880352,2023-01-31,,12.46
5703,50880352,2023-02-05,-133.1,-120.63999999999999
764,50880352,2023-02-06,-59.59,-180.23
3382,50880352,2023-02-08,19.59,-160.64
1926,50880352,2023-02-09,205.74,45.10000000000002
1364,50887252,2023-01-31,,464.78
6865,50887252,2023-02-03,56.35,521.13
1690,50887252,2023-02-04,-119.53,401.59999999999997
2906,50887252,2023-02-05,772.5,1174.1
4806,50887252,2023-02-06,210.36,1384.46
6782,50887252,2023-02-09,175.48,1559.9399999999998
2296,50887252,2023-02-09,137.17,1697.11
8051,50887252,2023-02-10,104.93,1802.04
4336,50887252,2023-02-14,-129.59,1672.4499999999998
1365,50893310,2023-01-31,,185.13
5208,50893310,2023-02-06,90.19,275.32
935,50893310,2023-02-08,104.32,379.64
7354,50893310,2023-02-12,130.06,509.7
2332,50893310,2023-02-13,-69.71,439.99
1366,50959802,2023-01-31,,821.37
4540,50959802,2023-02-01,-97.11,724.26
1309,50959802,2023-02-02,1436.3,2160.56
5594,50959802,2023-02-10,-221.22,1939.34
1641,50959802,2023-02-14,1157.1,3096.4399999999996
1367,51079213,2023-01-31,,783.58
5187,51079213,2023-02-01,-70.27,713.3100000000001
6424,51079213,2023-02-03,80.5,793.8100000000001
6440,51079213,2023-02-05,-144.1,649.71
3972,51079213,2023-02-05,-184.06,465.65000000000003
3990,51079213,2023-02-07,-61.01,404.64000000000004
8080,51079213,2023-02-08,187.24,591.8800000000001
8506,51079213,2023-02-11,-26.87,565.0100000000001
1722,51079213,2023-02-14,-70.52,494.49000000000007
1368,51102699,2023-01-31,,626.91
8256,51102699,2023-02-02,-56.94,569.97
2680,51102699,2023-02-08,-168.14,401.83
6215,51102699,2023-02-10,94.45,496.28
7171,51102699,2023-02-12,-66.33,429.95
1432,51102699,2023-02-13,38.04,467.99
1369,51122335,2023-01-31,,219.24
1672,51122335,2023-02-02,-150.2,69.04000000000002
291,51122335,2023-02-08,42.88,111.92000000000002
7584,51122335,2023-02-10,-88.04,23.880000000000024
1370,51198722,2023-01-31,,559.63
3599,51198722,2023-02-06,-995.2,-435.57000000000005
1895,51198722,2023-02-06,-1045.4,-1480.9700000000003
6893,51198722,2023-02-07,1035.2,-445.7700000000002
917,51198722,2023-02-07,-19.21,-464.9800000000002
1371,51266306,2023-01-31,,163.99
845,51266306,2023-02-01,1187.7,1351.69
4157,51266306,2023-02-01,-92.86,1258.8300000000002
6827,51266306,2023-02-04,118.6,1377.43
3162,51266306,2023-02-05,-118.23,1259.2
1372,51272805,2023-01-31,,135.47
4821,51272805,2023-02-01,153.9,289.37
1442,51272805,2023-02-01,-103.94,185.43
4412,51272805,2023-02-03,-718.2,-532.77
47,51272805,2023-02-05,43.28,-489.49
5106,51272805,2023-02-12,-82.2,-571.6899999999999
7368,51272805,2023-02-13,105.95,-465.74
1373,51298007,2023-01-31,,427.17
682,51298007,2023-02-04,73.7,500.87
2411,51298007,2023-02-05,-848.7,-347.83000000000004
2824,51298007,2023-02-07,-1613.2,-1961.0300000000002
3397,51298007,2023-02-09,137.44,-1823.59
2855,51298007,2023-02-09,96.82,-1726.77
5873,51298007,2023-02-12,89.55,-1637.22
274,51298007,2023-02-12,-104.78,-1742.0
1374,51313899,2023-01-31,,189.04
8100,51313899,2023-02-01,-1072.7,-883.6600000000001
7215,51313899,2023-02-02,-52.11,-935.7700000000001
8068,51313899,2023-02-03,1488.0,552.2299999999999
2169,51313899,2023-02-04,128.26,680.4899999999999
3359,51313899,2023-02-05,-119.88,560.6099999999999
2117,51313899,2023-02-06,-91.53,469.0799999999999
1504,51313899,2023-02-07,283.4,752.4799999999999
8505,51313899,2023-02-09,1653.1,2405.58
1375,51325070,2023-01-31,,933.4
3593,51325070,2023-02-01,104.85,1038.25
7796,51325070,2023-02-01,-83.77,954.48
7756,51325070,2023-02-02,-154.85,799.63
1177,51325070,2023-02-03,61.29,860.92
3655,51325070,2023-02-03,4.02,864.9399999999999
903,51325070,2023-02-04,183.25,1048.19
6297,51325070,2023-02-05,40.03,1088.22
1889,51325070,2023-02-06,53.53,1141.75
5461,51325070,2023-02-06,28.71,1170.46
2639,51325070,2023-02-06,-8.04,1162.42
976,51325070,2023-02-07,-99.21,1063.21
6306,51325070,2023-02-08,96.43,1159.64
3016,51325070,2023-02-08,31.2,1190.84
3713,51325070,2023-02-11,106.02,1296.8600000000001
3221,51325070,2023-02-12,-99.56,1197.3
1376,51353910,2023-01-31,,523.88
7081,51353910,2023-02-07,-146.17,377.71000000000004
4575,51353910,2023-02-09,40.77,418.48
1377,51358248,2023-01-31,,222.93
2205,51358248,2023-02-02,-179.19,43.74000000000001
6737,51358248,2023-02-10,127.71,171.45
5448,51358248,2023-02-14,130.09,301.54
1010,51358248,2023-02-14,42.94,344.48
1378,51389636,2023-01-31,,917.98
4425,51389636,2023-02-02,-109.29,808.69
8309,51389636,2023-02-02,-177.36,631.3299999999999
4473,51389636,2023-02-09,-79.33,552.0
1379,51398784,2023-01-31,,909.2
5450,51398784,2023-02-07,313.5,1222.7
6537,51398784,2023-02-13,11.11,1233.81
1380,51401655,2023-01-31,,877.47
1928,51401655,2023-02-02,-121.58,755.89
6680,51401655,2023-02-04,97.26,853.1500000000001
3900,51401655,2023-02-04,62.69,915.84
2844,51401655,2023-02-05,200.77,1116.6100000000001
1381,51435617,2023-01-31,,140.46
7107,51435617,2023-02-03,110.67,251.13
8406,51435617,2023-02-05,-87.66,163.47000000000003
3087,51435617,2023-02-06,133.2,296.67
6575,51435617,2023-02-12,-55.39,241.28000000000003
2309,51435617,2023-02-12,-76.51,164.77
7284,51435617,2023-02-13,18.93,183.70000000000002
1382,51450938,2023-01-31,,157.37
2489,51450938,2023-02-06,98.21,255.57999999999998
2630,51450938,2023-02-07,150.92,406.5
2264,51450938,2023-02-10,-67.01,339.49
1383,51471469,2023-01-31,,611.19
1111,51471469,2023-02-05,-103.21,507.9800000000001
1804,51471469,2023-02-10,-1725.1,-1217.12
1947,51471469,2023-02-12,-50.94,-1268.06
1384,51493379,2023-01-31,,436.15
8416,51493379,2023-02-01,69.52,505.66999999999996
7072,51493379,2023-02-08,-49.64,456.03
1385,51504474,2023-01-31,,153.25
3939,51504474,2023-02-01,219.71,372.96000000000004
4782,51504474,2023-02-04,68.14,441.1
2421,51504474,2023-02-04,18.25,459.35
3850,51504474,2023-02-07,-123.24,336.11
3680,51504474,2023-02-08,-1254.7,-918.59
3086,51504474,2023-02-09,134.52,-784.07
4774,51504474,2023-02-12,-126.99,-911.0600000000001
3792,51504474,2023-02-13,-69.63,-980.69
1386,51653690,2023-01-31,,280.41
1135,51653690,2023-02-01,-78.4,202.01000000000002
3028,51653690,2023-02-02,127.6,329.61
4136,51653690,2023-02-06,-179.58,150.03
93,51653690,2023-02-08,837.3,987.3299999999999
1387,51653868,2023-01-31,,410.88
7450,51653868,2023-02-02,-179.94,230.94
7614,51653868,2023-02-03,104.0,334.94
5163,51653868,2023-02-04,77.66,412.6
892,51653868,2023-02-06,-138.83,273.77
5800,51653868,2023-02-07,89.6,363.37
3095,51653868,2023-02-07,-43.63,319.73999999999995
5667,51653868,2023-02-09,53.97,373.71
5068,51653868,2023-02-10,1046.8,1420.51
2881,51653868,2023-02-10,-91.66,1328.85
1481,51653868,2023-02-10,-624.8,704.0500000000001
7292,51653868,2023-02-12,-48.09,655.96
3116,51653868,2023-02-13,30.31,686.2700000000001
7983,51653868,2023-02-14,159.73,846.0
1206,51653868,2023-02-14,-132.75,713.25
1388,51718829,2023-01-31,,260.45
4535,51718829,2023-02-04,-905.4,-644.95
7125,51718829,2023-02-05,181.23,-463.7199999999999
2705,51718829,2023-02-05,-860.7,-1324.42
7400,51718829,2023-02-06,-58.84,-1383.26
3193,51718829,2023-02-08,189.92,-1193.34
5997,51718829,2023-02-09,-1043.8,-2237.14
6272,51718829,2023-02-13,813.5,-1423.6399999999999
1201,51718829,2023-02-14,-99.88,-1523.52
1389,51771015,2023-01-31,,876.29
3270,51771015,2023-02-04,87.1,963.39
8681,51771015,2023-02-05,-159.59,803.8
4934,51771015,2023-02-07,100.32,904.1199999999999
8230,51771015,2023-02-11,1035.1,1939.2199999999998
3605,51771015,2023-02-11,147.31,2086.5299999999997
3118,51771015,2023-02-12,115.87,2202.3999999999996
3751,51771015,2023-02-14,-85.81,2116.5899999999997
1390,51774315,2023-01-31,,291.01
4605,51774315,2023-02-06,98.97,389.98
4490,51774315,2023-02-07,38.62,428.59999999999997
5036,51774315,2023-02-10,55.88,484.48
226,51774315,2023-02-11,-101.84,382.64
2034,51774315,2023-02-12,-78.98,303.65999999999997
1391,51793205,2023-01-31,,715.25
7100,51793205,2023-02-02,1902.2,2617.45
8209,51793205,2023-02-07,-176.26,2441.19
7865,51793205,2023-02-08,-133.59,2307.6
1392,51906599,2023-01-31,,174.48
3995,51906599,2023-02-01,-125.14,49.33999999999999
8648,51906599,2023-02-04,36.24,85.57999999999998
1162,51906599,2023-02-06,-55.84,29.739999999999988
1196,51906599,2023-02-06,-84.58,-54.84000000000001
3153,51906599,2023-02-08,53.25,-1.5900000000000105
2949,51906599,2023-02-10,-86.75,-88.34
5361,51906599,2023-02-13,157.9,69.56
1393,52104303,2023-01-31,,810.97
1018,52104303,2023-02-03,99.85,910.82
1358,52104303,2023-02-04,-77.13,833.69
2,52104303,2023-02-06,-87.57,746.12
2475,52104303,2023-02-09,-1530.9,-784.7800000000001
1394,52117174,2023-01-31,,932.96
2711,52117174,2023-02-03,-120.56,812.4000000000001
1181,52117174,2023-02-05,-91.78,720.62
1859,52117174,2023-02-08,-43.73,676.89
6978,52117174,2023-02-09,-59.54,617.35
4124,52117174,2023-02-09,-1131.6,-514.2499999999999
1395,52125171,2023-01-31,,973.17
5926,52125171,2023-02-01,112.77,1085.94
4876,52125171,2023-02-02,132.64,1218.58
2823,52125171,2023-02-05,101.6,1320.1799999999998
3890,52125171,2023-02-09,-63.75,1256.4299999999998
1396,52127978,2023-01-31,,84.8
8069,52127978,2023-02-08,-603.0,-518.2
8480,52127978,2023-02-09,-25.95,-544.1500000000001
6614,52127978,2023-02-12,13.57,-530.58
1371,52127978,2023-02-12,-134.36,-664.94
1397,52141048,2023-01-31,,102.68
1812,52141048,2023-02-03,153.58,256.26
3951,52141048,2023-02-04,31.94,288.20000000000005
2265,52141048,2023-02-07,852.6,1140.8000000000002
3668,52141048,2023-02-08,122.19,1262.99
4088,52141048,2023-02-11,144.17,1407.16
1398,52146995,2023-01-31,,322.52
8281,52146995,2023-02-01,69.4,391.91999999999996
7212,52146995,2023-02-02,507.1,899.02
501,52146995,2023-02-02,-71.52,827.5
5584,52146995,2023-02-05,-49.2,778.3
948,52146995,2023-02-05,-108.08,670.22
4869,52146995,2023-02-07,135.72,805.94
102,52146995,2023-02-09,36.71,842.65
1477,52146995,2023-02-11,-93.53,749.12
2902,52146995,2023-02-12,-934.0,-184.88
3547,52146995,2023-02-14,108.65,-76.22999999999999
1399,52203356,2023-01-31,,899.39
7792,52203356,2023-02-03,83.25,982.64
2543,52203356,2023-02-05,189.35,1171.99
7024,52203356,2023-02-05,-168.74,1003.25
6399,52203356,2023-02-08,1316.4,2319.65
6855,52203356,2023-02-11,51.73,2371.38
1400,52213806,2023-01-31,,597.62
7044,52213806,2023-02-12,54.1,651.72
5241,52213806,2023-02-14,97.06,748.78
7932,52213806,2023-02-14,10.22,759.0
1401,52230539,2023-01-31,,394.34
6199,52230539,2023-02-03,-23.24,371.09999999999997
4530,52230539,2023-02-12,197.45,568.55
4097,52230539,2023-02-13,-149.9,418.65
4824,52230539,2023-02-14,-87.3,331.34999999999997
1402,52264506,2023-01-31,,934.07
5159,52264506,2023-02-02,-12.87,921.2
3377,52264506,2023-02-05,139.1,1060.3
3996,52264506,2023-02-06,-105.25,955.0500000000001
8075,52264506,2023-02-08,132.78,1087.83
5406,52264506,2023-02-09,139.7,1227.53
8217,52264506,2023-02-09,-57.45,1170.08
5850,52264506,2023-02-13,-35.46,1134.6200000000001
6167,52264506,2023-02-14,60.97,1195.59
1403,52310499,2023-01-31,,954.51
1696,52310499,2023-02-02,53.0,1007.51
3208,52310499,2023-02-06,81.6,1089.11
956,52310499,2023-02-14,73.19,1162.3
1404,52317175,2023-01-31,,25.94
6631,52317175,2023-02-10,-90.04,-64.10000000000001
5190,52317175,2023-02-12,-145.55,-209.65000000000003
1900,52317175,2023-02-12,-1145.7,-1355.3500000000001
105,52317175,2023-02-14,-92.17,-1447.5200000000002
1405,52365238,2023-01-31,,822.17
8526,52365238,2023-02-09,85.45,907.62
5714,52365238,2023-02-12,92.42,1000.04
1406,52366360,2023-01-31,,465.67
7323,52366360,2023-02-02,-61.66,404.01
7628,52366360,2023-02-03,88.74,492.75
5963,52366360,2023-02-06,172.68,665.4300000000001
8623,52366360,2023-02-06,-72.88,592.55
2062,52366360,2023-02-07,-64.41,528.14
1407,52390463,2023-01-31,,172.82
7065,52390463,2023-02-01,147.58,320.4
624,52390463,2023-02-02,-534.5,-214.10000000000002
7590,52390463,2023-02-03,-79.16,-293.26
7736,52390463,2023-02-03,-220.83,-514.09
6136,52390463,2023-02-04,-30.36,-544.45
1527,52390463,2023-02-14,-117.12,-661.57
1408,52436120,2023-01-31,,904.47
3487,52436120,2023-02-03,109.66,1014.13
4730,52436120,2023-02-07,115.4,1129.53
2478,52436120,2023-02-11,-560.2,569.3299999999999
1409,52442629,2023-01-31,,617.92
7327,52442629,2023-02-03,196.73,814.65
3268,52442629,2023-02-03,-1462.8,-648.15
7420,52442629,2023-02-11,-145.45,-793.5999999999999
3693,52442629,2023-02-12,90.28,-703.3199999999999
6085,52442629,2023-02-14,1290.4,587.0800000000002
1410,52461586,2023-01-31,,596.3
4891,52461586,2023-02-02,755.8,1352.1
7779,52461586,2023-02-06,-59.42,1292.6799999999998
672,52461586,2023-02-08,101.89,1394.57
5100,52461586,2023-02-08,-1026.8,367.77
1411,52468167,2023-01-31,,369.42
8226,52468167,2023-02-01,-102.76,266.66
3956,52468167,2023-02-02,162.4,429.06
7059,52468167,2023-02-10,48.91,477.97
1412,52480554,2023-01-31,,263.38
1227,52480554,2023-02-04,-130.57,132.81
6791,52480554,2023-02-06,-629.3,-496.48999999999995
8477,52480554,2023-02-10,-85.31,-581.8
8454,52480554,2023-02-11,122.42,-459.37999999999994
7737,52480554,2023-02-12,68.07,-391.30999999999995
1413,52560688,2023-01-31,,622.16
7378,52560688,2023-02-03,55.81,677.97
3805,52560688,2023-02-04,115.54,793.51
2530,52560688,2023-02-10,-1220.5,-426.99
7155,52560688,2023-02-11,-108.41,-535.4
6963,52560688,2023-02-11,-1058.7,-1594.1
7022,52560688,2023-02-12,127.2,-1466.9
5396,52560688,2023-02-12,-115.87,-1582.7700000000002
1414,52747145,2023-01-31,,546.71
7224,52747145,2023-02-02,-107.8,438.91
7306,52747145,2023-02-04,163.28,602.19
4625,52747145,2023-02-09,-155.0,447.19000000000005
315,52747145,2023-02-11,-107.54,339.65000000000003
1286,52747145,2023-02-12,-165.18,174.47000000000003
1415,52756904,2023-01-31,,428.77
7009,52756904,2023-02-04,-118.08,310.69
1436,52756904,2023-02-05,114.03,424.71999999999997
6427,52756904,2023-02-13,-51.57,373.15
8634,52756904,2023-02-13,-87.03,286.12
5625,52756904,2023-02-14,-67.55,218.57
1416,52805510,2023-01-31,,580.66
276,52805510,2023-02-09,35.39,616.05
4186,52805510,2023-02-09,-85.32,530.73
4580,52805510,2023-02-10,-153.19,377.53999999999996
2212,52805510,2023-02-13,851.7,1229.24
1417,52814597,2023-01-31,,899.39
1738,52814597,2023-02-01,-1821.6,-922.2099999999999
205,52814597,2023-02-06,-25.86,-948.0699999999999
6889,52814597,2023-02-10,-831.4,-1779.4699999999998
2023,52814597,2023-02-11,43.89,-1735.58
2615,52814597,2023-02-11,-1129.9,-2865.48
5967,52814597,2023-02-14,7.09,-2858.39
1418,52835507,2023-01-31,,306.68
667,52835507,2023-02-01,-86.91,219.77
2574,52835507,2023-02-03,-32.77,187.0
6016,52835507,2023-02-05,109.41,296.40999999999997
6048,52835507,2023-02-05,-806.2,-509.7900000000001
1060,52835507,2023-02-08,95.66,-414.1300000000001
3752,52835507,2023-02-10,1098.2,684.0699999999999
8232,52835507,2023-02-13,-262.4,421.66999999999996
8371,52835507,2023-02-14,1053.5,1475.17
1419,52840001,2023-01-31,,746.12
6480,52840001,2023-02-01,88.19,834.31
5324,52840001,2023-02-04,-101.52,732.79
7568,52840001,2023-02-07,814.4,1547.19
1420,52855120,2023-01-31,,880.21
5804,52855120,2023-02-01,160.48,1040.69
6912,52855120,2023-02-02,161.91,1202.6
910,52855120,2023-02-04,-72.24,1130.3600000000001
8339,52855120,2023-02-09,105.82,1236.18
6705,52855120,2023-02-10,-61.16,1175.02
728,52855120,2023-02-11,-174.19,1000.83
4365,52855120,2023-02-12,-1640.8,-639.9699999999999
1421,52911248,2023-01-31,,430.16
614,52911248,2023-02-01,-161.89,268.27000000000004
4640,52911248,2023-02-03,-105.36,162.91000000000003
2546,52911248,2023-02-05,-131.72,31.190000000000055
2449,52911248,2023-02-07,-162.23,-131.03999999999994
7194,52911248,2023-02-08,72.19,-58.84999999999994
5695,52911248,2023-02-10,-83.95,-142.79999999999995
2806,52911248,2023-02-10,-134.99,-277.78999999999996
2345,52911248,2023-02-10,-951.2,-1228.99
6857,52911248,2023-02-10,-2084.1,-3313.09
3530,52911248,2023-02-12,-125.47,-3438.5599999999995
7554,52911248,2023-02-12,-129.73,-3568.2899999999995
7992,52911248,2023-02-13,63.98,-3504.3099999999995
1422,52973634,2023-01-31,,417.09
5457,52973634,2023-02-02,104.98,522.0699999999999
3264,52973634,2023-02-02,80.01,602.0799999999999
7881,52973634,2023-02-03,372.2,974.28
5501,52973634,2023-02-11,6.54,980.8199999999999
4310,52973634,2023-02-11,-129.35,851.47
1117,52973634,2023-02-12,172.13,1023.5999999999999
6218,52973634,2023-02-13,134.58,1158.18
1423,52996436,2023-01-31,,883.35
1073,52996436,2023-02-01,86.03,969.38
1307,52996436,2023-02-03,-173.67,795.71
1060,52996436,2023-02-08,-95.66,700.0500000000001
6085,52996436,2023-02-14,-1290.4,-590.35
1424,53006272,2023-01-31,,761.95
5728,53006272,2023-02-03,134.35,896.3000000000001
5729,53006272,2023-02-06,-90.64,805.6600000000001
836,53006272,2023-02-08,160.1,965.76
3967,53006272,2023-02-08,-88.99,876.7700000000001
3689,53006272,2023-02-14,157.14,1033.91
1425,53010345,2023-01-31,,131.63
5373,53010345,2023-02-06,-123.61,8.019999999999996
1817,53010345,2023-02-10,169.0,177.01999999999998
8641,53010345,2023-02-10,-145.54,31.47999999999999
955,53010345,2023-02-14,88.77,120.24999999999999
1426,53046005,2023-01-31,,669.82
3433,53046005,2023-02-01,36.43,706.25
762,53046005,2023-02-02,52.25,758.5
4301,53046005,2023-02-04,-58.03,700.47
2192,53046005,2023-02-06,-129.51,570.96
3870,53046005,2023-02-13,157.27,728.23
5132,53046005,2023-02-13,74.51,802.7400000000001
1890,53046005,2023-02-13,-125.85,676.8900000000001
1427,53059420,2023-01-31,,531.72
3794,53059420,2023-02-01,-97.79,433.93
6807,53059420,2023-02-02,-129.83,304.1
8455,53059420,2023-02-07,198.21,502.31000000000006
3982,53059420,2023-02-07,140.37,642.6800000000001
1428,53079883,2023-01-31,,489.35
6271,53079883,2023-02-05,-115.08,374.27000000000004
4258,53079883,2023-02-05,-150.73,223.54000000000002
1281,53079883,2023-02-09,-257.1,-33.56
4682,53079883,2023-02-10,-550.8,-584.3599999999999
2095,53079883,2023-02-14,10.57,-573.7899999999998
1429,53085668,2023-01-31,,199.11
8239,53085668,2023-02-05,106.54,305.65000000000003
1096,53085668,2023-02-05,-75.06,230.59000000000003
4229,53085668,2023-02-07,-945.2,-714.61
4117,53085668,2023-02-10,-101.56,-816.1700000000001
4267,53085668,2023-02-11,-117.16,-933.33
7896,53085668,2023-02-14,41.25,-892.08
4616,53085668,2023-02-14,-24.04,-916.12
1430,53086727,2023-01-31,,408.74
7777,53086727,2023-02-02,115.29,524.03
7940,53086727,2023-02-10,-1362.1,-838.0699999999999
1431,53089607,2023-01-31,,567.87
614,53089607,2023-02-01,161.89,729.76
2942,53089607,2023-02-02,147.42,877.18
3923,53089607,2023-02-05,-176.88,700.3
120,53089607,2023-02-11,161.33,861.63
2514,53089607,2023-02-12,-137.14,724.49
4897,53089607,2023-02-13,71.18,795.6700000000001
1432,53091928,2023-01-31,,235.6
3075,53091928,2023-02-02,-248.7,-13.099999999999994
3424,53091928,2023-02-06,-128.13,-141.23
8071,53091928,2023-02-07,1741.9,1600.67
700,53091928,2023-02-07,-166.24,1434.43
8032,53091928,2023-02-09,-114.01,1320.42
1072,53091928,2023-02-11,28.8,1349.22
5581,53091928,2023-02-12,37.22,1386.44
1433,53107499,2023-01-31,,237.09
3997,53107499,2023-02-01,83.86,320.95
252,53107499,2023-02-09,-58.86,262.09000000000003
7600,53107499,2023-02-13,168.68,430.77
2463,53107499,2023-02-13,-70.54,360.23
4095,53107499,2023-02-14,-40.13,320.1
1434,53161068,2023-01-31,,945.53
7767,53161068,2023-02-02,962.8,1908.33
8309,53161068,2023-02-02,177.36,2085.69
1669,53161068,2023-02-03,62.59,2148.2799999999997
8614,53161068,2023-02-03,-1566.6,581.6800000000001
8367,53161068,2023-02-04,-69.83,511.8500000000001
3532,53161068,2023-02-05,91.56,603.4100000000001
4343,53161068,2023-02-05,-81.18,522.23
7931,53161068,2023-02-05,-480.6,41.63000000000005
3785,53161068,2023-02-07,108.31,149.94000000000005
4748,53161068,2023-02-10,107.66,257.6
8012,53161068,2023-02-10,50.5,308.1
1435,53170488,2023-01-31,,219.2
3955,53170488,2023-02-04,-73.5,145.7
7055,53170488,2023-02-08,50.31,196.01
1436,53192110,2023-01-31,,588.04
962,53192110,2023-02-06,117.46,705.5
8168,53192110,2023-02-07,-53.78,651.7199999999999
6942,53192110,2023-02-14,-88.36,563.3599999999999
1437,53204515,2023-01-31,,689.65
317,53204515,2023-02-02,83.33,772.98
6233,53204515,2023-02-04,-136.51,636.47
6574,53204515,2023-02-06,114.15,750.62
1438,53211412,2023-01-31,,69.51
3269,53211412,2023-02-05,93.57,163.07999999999998
293,53211412,2023-02-07,-101.5,61.58
6436,53211412,2023-02-09,-20.18,41.4
1145,53211412,2023-02-11,41.89,83.28999999999999
2488,53211412,2023-02-11,-197.9,-114.61000000000001
2195,53211412,2023-02-12,121.68,7.069999999999993
4128,53211412,2023-02-13,902.0,909.0699999999999
4674,53211412,2023-02-13,-50.68,858.39
1439,53234515,2023-01-31,,854.67
91,53234515,2023-02-01,-70.5,784.17
3625,53234515,2023-02-02,54.57,838.74
4183,53234515,2023-02-04,1349.2,2187.94
3031,53234515,2023-02-05,148.33,2336.27
7961,53234515,2023-02-06,8.35,2344.62
1440,53240505,2023-01-31,,188.87
7056,53240505,2023-02-03,119.64,308.51
592,53240505,2023-02-14,-37.21,271.3
6300,53240505,2023-02-14,-88.35,182.95000000000002
1441,53260868,2023-01-31,,966.85
1339,53260868,2023-02-01,208.23,1175.08
3380,53260868,2023-02-02,134.24,1309.32
3908,53260868,2023-02-07,-1429.1,-119.77999999999997
5491,53260868,2023-02-10,97.78,-21.99999999999997
6315,53260868,2023-02-12,-25.98,-47.979999999999976
1442,53332086,2023-01-31,,273.51
8234,53332086,2023-02-03,-98.44,175.07
2142,53332086,2023-02-06,116.99,292.06
1943,53332086,2023-02-06,114.95,407.01
8526,53332086,2023-02-09,-85.45,321.56
8172,53332086,2023-02-12,-79.05,242.51
5797,53332086,2023-02-14,-59.91,182.6
1443,53366488,2023-01-31,,337.18
5871,53366488,2023-02-01,115.41,452.59000000000003
4241,53366488,2023-02-02,-104.72,347.87
1813,53366488,2023-02-03,110.54,458.41
1550,53366488,2023-02-04,-134.24,324.17
5547,53366488,2023-02-07,107.54,431.71000000000004
3714,53366488,2023-02-10,-102.92,328.79
7219,53366488,2023-02-13,76.11,404.90000000000003
1444,53376344,2023-01-31,,228.65
4040,53376344,2023-02-02,81.01,309.66
7800,53376344,2023-02-03,-133.94,175.72000000000003
7730,53376344,2023-02-04,35.52,211.24000000000004
627,53376344,2023-02-05,85.78,297.02000000000004
8302,53376344,2023-02-14,1365.0,1662.02
1445,53380359,2023-01-31,,0.81
2524,53380359,2023-02-01,-133.29,-132.48
5612,53380359,2023-02-04,78.39,-54.08999999999999
5375,53380359,2023-02-08,134.23,80.14
2502,53380359,2023-02-08,-49.6,30.54
6977,53380359,2023-02-08,-113.92,-83.38
3750,53380359,2023-02-08,-128.8,-212.18
2691,53380359,2023-02-13,767.3,555.1199999999999
985,53380359,2023-02-13,384.8,939.9199999999998
1446,53421312,2023-01-31,,937.86
2493,53421312,2023-02-03,-40.39,897.47
7228,53421312,2023-02-04,44.37,941.84
2859,53421312,2023-02-04,-199.43,742.41
6326,53421312,2023-02-07,-13.71,728.7
7154,53421312,2023-02-08,135.45,864.15
3091,53421312,2023-02-11,-69.79,794.36
4774,53421312,2023-02-12,126.99,921.3499999999999
1447,53496996,2023-01-31,,303.15
5509,53496996,2023-02-01,146.28,449.42999999999995
7325,53496996,2023-02-02,74.71,524.14
62,53496996,2023-02-05,-106.43,417.71
3628,53496996,2023-02-07,95.78,513.49
3837,53496996,2023-02-11,149.19,662.68
3772,53496996,2023-02-12,107.03,769.7099999999999
1448,53502347,2023-01-31,,18.89
8054,53502347,2023-02-01,84.14,103.03
1887,53502347,2023-02-01,-490.9,-387.87
1129,53502347,2023-02-08,-123.06,-510.93
4758,53502347,2023-02-10,133.46,-377.47
2653,53502347,2023-02-14,-208.0,-585.47
1246,53502347,2023-02-14,-1469.3,-2054.77
1449,53513558,2023-01-31,,235.44
2111,53513558,2023-02-02,-100.89,134.55
8537,53513558,2023-02-04,-155.63,-21.079999999999984
7356,53513558,2023-02-05,-700.4,-721.48
3832,53513558,2023-02-08,161.43,-560.05
464,53513558,2023-02-09,59.28,-500.76999999999987
1450,53518299,2023-01-31,,953.96
4009,53518299,2023-02-01,-116.27,837.69
3239,53518299,2023-02-08,46.43,884.12
5906,53518299,2023-02-10,-134.33,749.79
1451,53538823,2023-01-31,,750.37
5113,53538823,2023-02-05,-78.82,671.55
3477,53538823,2023-02-06,23.13,694.6800000000001
2485,53538823,2023-02-06,-405.7,288.98
3202,53538823,2023-02-08,-57.77,231.21
1452,53634705,2023-01-31,,853.12
776,53634705,2023-02-05,151.27,1004.39
8384,53634705,2023-02-05,63.21,1067.6
499,53634705,2023-02-14,-223.99,843.61
1453,53665038,2023-01-31,,624.95
3648,53665038,2023-02-02,27.52,652.47
3952,53665038,2023-02-07,-27.75,624.72
7063,53665038,2023-02-09,-255.62,369.1
7366,53665038,2023-02-13,113.04,482.14000000000004
1454,53727603,2023-01-31,,517.25
6781,53727603,2023-02-02,124.68,641.9300000000001
6984,53727603,2023-02-04,92.05,733.98
5815,53727603,2023-02-08,63.18,797.16
2396,53727603,2023-02-10,-2476.1,-1678.94
22,53727603,2023-02-11,-1137.9,-2816.84
7249,53727603,2023-02-13,66.54,-2750.3
6015,53727603,2023-02-13,-75.37,-2825.67
1455,53753986,2023-01-31,,252.69
4563,53753986,2023-02-03,-120.33,132.36
3578,53753986,2023-02-04,-1059.1,-926.7399999999999
153,53753986,2023-02-06,-165.67,-1092.4099999999999
2921,53753986,2023-02-11,80.75,-1011.6599999999999
3740,53753986,2023-02-12,860.8,-150.8599999999999
1456,53754887,2023-01-31,,162.05
5051,53754887,2023-02-02,102.25,264.3
1027,53754887,2023-02-06,149.07,413.37
3240,53754887,2023-02-09,54.92,468.29
1457,53762957,2023-01-31,,245.78
2386,53762957,2023-02-01,-101.12,144.66
6379,53762957,2023-02-09,-179.65,-34.99000000000001
2415,53762957,2023-02-10,149.19,114.19999999999999
5805,53762957,2023-02-10,-100.16,14.039999999999992
3521,53762957,2023-02-11,134.16,148.2
7104,53762957,2023-02-11,-108.92,39.27999999999999
4394,53762957,2023-02-11,-142.72,-103.44000000000001
3940,53762957,2023-02-12,-150.86,-254.3
1649,53762957,2023-02-14,51.9,-202.4
784,53762957,2023-02-14,-155.82,-358.22
1458,53764356,2023-01-31,,447.88
3370,53764356,2023-02-01,83.37,531.25
6340,53764356,2023-02-02,197.62,728.87
4546,53764356,2023-02-02,-74.82,654.05
5808,53764356,2023-02-04,136.2,790.25
6487,53764356,2023-02-04,-75.94,714.31
8153,53764356,2023-02-07,-84.19,630.12
3857,53764356,2023-02-08,-144.78,485.34000000000003
4168,53764356,2023-02-10,65.52,550.86
92,53764356,2023-02-11,-159.34,391.52
8235,53764356,2023-02-12,-179.93,211.58999999999997
1459,53831793,2023-01-31,,799.66
965,53831793,2023-02-06,-143.57,656.0899999999999
724,53831793,2023-02-08,-110.44,545.65
8304,53831793,2023-02-08,-159.35,386.29999999999995
6370,53831793,2023-02-09,103.19,489.49
4843,53831793,2023-02-10,135.89,625.38
4707,53831793,2023-02-13,1226.1,1851.48
2791,53831793,2023-02-13,127.43,1978.91
1460,53845552,2023-01-31,,285.52
1884,53845552,2023-02-06,967.8,1253.32
6524,53845552,2023-02-09,-82.54,1170.78
1461,53845615,2023-01-31,,597.04
7551,53845615,2023-02-05,-47.51,549.53
2391,53845615,2023-02-06,71.0,620.53
4598,53845615,2023-02-06,-63.7,556.8299999999999
7758,53845615,2023-02-07,-100.78,456.04999999999995
307,53845615,2023-02-07,-151.21,304.84
7416,53845615,2023-02-10,7.29,312.13
8589,53845615,2023-02-10,-1052.9,-740.7700000000001
1462,53858816,2023-01-31,,539.38
3777,53858816,2023-02-01,-92.2,447.18
7665,53858816,2023-02-03,-98.53,348.65
1793,53858816,2023-02-05,33.32,381.96999999999997
1833,53858816,2023-02-05,-105.91,276.06
1630,53858816,2023-02-09,-156.03,120.03
4726,53858816,2023-02-11,1231.3,1351.33
20,53858816,2023-02-12,-113.78,1237.55
1463,53884266,2023-01-31,,21.72
7502,53884266,2023-02-12,185.51,207.23
5151,53884266,2023-02-13,-85.84,121.38999999999999
8497,53884266,2023-02-13,-107.98,13.409999999999982
1464,53884626,2023-01-31,,478.38
8169,53884626,2023-02-02,-1413.6,-935.2199999999999
8144,53884626,2023-02-03,115.71,-819.5099999999999
8008,53884626,2023-02-07,-88.86,-908.3699999999999
5620,53884626,2023-02-09,134.0,-774.3699999999999
7836,53884626,2023-02-13,1525.2,750.8300000000002
3859,53884626,2023-02-13,74.01,824.8400000000001
1465,53887772,2023-01-31,,541.43
940,53887772,2023-02-02,65.2,606.63
8216,53887772,2023-02-02,-109.3,497.3299999999999
5808,53887772,2023-02-04,-136.2,361.13
2937,53887772,2023-02-06,-55.36,305.77
1943,53887772,2023-02-06,-114.95,190.81999999999996
7285,53887772,2023-02-11,-42.19,148.62999999999997
792,53887772,2023-02-11,-142.53,6.099999999999966
7821,53887772,2023-02-14,102.09,108.18999999999997
1466,53959112,2023-01-31,,103.99
8472,53959112,2023-02-06,159.06,263.05
4920,53959112,2023-02-06,60.77,323.82
1160,53959112,2023-02-07,135.7,459.52
832,53959112,2023-02-07,-71.14,388.38
7231,53959112,2023-02-08,52.99,441.37
1748,53959112,2023-02-09,102.59,543.96
3745,53959112,2023-02-10,-74.94,469.02
1467,53960481,2023-01-31,,490.82
5282,53960481,2023-02-04,103.05,593.87
3062,53960481,2023-02-06,102.12,695.99
1314,53960481,2023-02-08,74.39,770.38
1468,53971767,2023-01-31,,958.87
122,53971767,2023-02-01,-124.24,834.63
6566,53971767,2023-02-02,-61.97,772.66
1469,53977562,2023-01-31,,398.76
1828,53977562,2023-02-02,-15.93,382.83
164,53977562,2023-02-06,-140.83,241.99999999999997
6529,53977562,2023-02-06,-173.03,68.96999999999997
766,53977562,2023-02-07,113.03,181.99999999999997
7565,53977562,2023-02-08,-149.31,32.68999999999997
106,53977562,2023-02-14,145.08,177.76999999999998
827,53977562,2023-02-14,-25.28,152.48999999999998
1470,54032229,2023-01-31,,176.12
8151,54032229,2023-02-03,-87.5,88.62
5920,54032229,2023-02-05,148.46,237.08
32,54032229,2023-02-08,74.13,311.21000000000004
8636,54032229,2023-02-09,-96.2,215.01
7906,54032229,2023-02-13,-1503.4,-1288.39
1471,54033811,2023-01-31,,534.83
1996,54033811,2023-02-01,-188.33,346.5
5580,54033811,2023-02-03,-62.89,283.61
257,54033811,2023-02-03,-148.95,134.66000000000003
414,54033811,2023-02-06,114.86,249.52000000000004
5430,54033811,2023-02-06,28.63,278.15000000000003
7865,54033811,2023-02-08,133.59,411.74
7472,54033811,2023-02-09,64.47,476.21000000000004
1472,54067346,2023-01-31,,180.91
7140,54067346,2023-02-02,96.8,277.71
2585,54067346,2023-02-08,91.53,369.24
3862,54067346,2023-02-10,57.19,426.43
7682,54067346,2023-02-11,1635.6,2062.0299999999997
1056,54067346,2023-02-11,-158.58,1903.45
2133,54067346,2023-02-12,-25.82,1877.6299999999999
1473,54071589,2023-01-31,,765.81
3244,54071589,2023-02-03,-117.22,648.5899999999999
8518,54071589,2023-02-09,-107.22,541.3699999999999
1932,54071589,2023-02-11,119.83,661.1999999999999
2029,54071589,2023-02-11,58.94,720.14
8005,54071589,2023-02-11,-726.2,-6.060000000000059
1474,54137851,2023-01-31,,30.67
362,54137851,2023-02-05,-81.18,-50.510000000000005
3080,54137851,2023-02-13,71.54,21.03
1475,54154999,2023-01-31,,962.14
4564,54154999,2023-02-01,107.18,1069.32
6608,54154999,2023-02-02,-49.14,1020.18
503,54154999,2023-02-03,-41.91,978.27
7592,54154999,2023-02-05,27.88,1006.15
8196,54154999,2023-02-05,-142.79,863.36
7747,54154999,2023-02-07,102.54,965.9
3641,54154999,2023-02-07,39.54,1005.44
1199,54154999,2023-02-08,35.13,1040.57
1476,54189995,2023-01-31,,401.27
4161,54189995,2023-02-03,-13.61,387.65999999999997
2625,54189995,2023-02-04,97.67,485.33
4811,54189995,2023-02-09,158.61,643.94
3502,54189995,2023-02-14,117.23,761.17
7037,54189995,2023-02-14,-143.03,618.14
1477,54230889,2023-01-31,,597.31
5752,54230889,2023-02-09,-12.69,584.6199999999999
7723,54230889,2023-02-11,75.03,659.65
1478,54278560,2023-01-31,,161.8
4622,54278560,2023-02-01,-167.46,-5.659999999999997
3553,54278560,2023-02-07,92.55,86.89
5375,54278560,2023-02-08,-134.23,-47.33999999999999
1479,54288062,2023-01-31,,336.75
7868,54288062,2023-02-03,104.89,441.64
410,54288062,2023-02-03,-46.54,395.1
2207,54288062,2023-02-04,153.16,548.26
6368,54288062,2023-02-04,-1266.4,-718.1400000000001
4084,54288062,2023-02-07,152.25,-565.8900000000001
8649,54288062,2023-02-14,120.16,-445.73000000000013
7637,54288062,2023-02-14,-136.73,-582.46
1480,54300071,2023-01-31,,317.35
6380,54300071,2023-02-01,588.3,905.65
6676,54300071,2023-02-03,111.46,1017.11
797,54300071,2023-02-03,87.44,1104.55
4022,54300071,2023-02-05,58.45,1163.0
3802,54300071,2023-02-05,-82.64,1080.36
1070,54300071,2023-02-06,-93.21,987.15
7372,54300071,2023-02-08,154.2,1141.35
942,54300071,2023-02-09,1576.6,2717.95
6578,54300071,2023-02-12,-117.45,2600.5
3449,54300071,2023-02-12,-134.97,2465.5299999999997
1646,54300071,2023-02-13,1535.7,4001.2299999999996
924,54300071,2023-02-13,173.36,4174.59
1481,54301151,2023-01-31,,408.16
3460,54301151,2023-02-07,-480.0,-71.83999999999997
5638,54301151,2023-02-12,1619.3,1547.46
1482,54307382,2023-01-31,,452.52
5555,54307382,2023-02-02,97.69,550.21
4601,54307382,2023-02-03,-160.1,390.11
398,54307382,2023-02-07,-114.28,275.83
6970,54307382,2023-02-07,-153.27,122.55999999999997
59,54307382,2023-02-13,-535.9,-413.34000000000003
1483,54349805,2023-01-31,,752.49
1897,54349805,2023-02-02,-96.32,656.1700000000001
1777,54349805,2023-02-04,99.5,755.6700000000001
5329,54349805,2023-02-07,-115.39,640.28
4902,54349805,2023-02-08,687.1,1327.38
8035,54349805,2023-02-09,62.59,1389.97
2154,54349805,2023-02-09,10.05,1400.02
7887,54349805,2023-02-09,-148.56,1251.46
7598,54349805,2023-02-10,-149.81,1101.65
7033,54349805,2023-02-13,59.45,1161.1
1484,54377130,2023-01-31,,425.86
7105,54377130,2023-02-03,-91.66,334.20000000000005
1631,54377130,2023-02-04,-16.51,317.69
1005,54377130,2023-02-05,124.37,442.06
615,54377130,2023-02-06,123.37,565.4300000000001
905,54377130,2023-02-08,-1119.6,-554.1699999999998
6638,54377130,2023-02-11,27.58,-526.5899999999998
6916,54377130,2023-02-12,-183.41,-709.9999999999998
1485,54377538,2023-01-31,,845.93
7754,54377538,2023-02-02,75.99,921.92
8074,54377538,2023-02-02,-91.57,830.3499999999999
4352,54377538,2023-02-02,-1145.1,-314.75
1601,54377538,2023-02-07,178.2,-136.55
1163,54377538,2023-02-11,112.1,-24.450000000000017
1486,54405539,2023-01-31,,397.2
2183,54405539,2023-02-03,106.8,504.0
8017,54405539,2023-02-03,87.6,591.6
5287,54405539,2023-02-04,-80.75,510.84999999999997
6760,54405539,2023-02-10,189.51,700.3599999999999
6447,54405539,2023-02-11,-78.29,622.0699999999999
4100,54405539,2023-02-13,-84.66,537.41
1487,54452317,2023-01-31,,358.39
1375,54452317,2023-02-04,-33.69,324.7
5239,54452317,2023-02-05,56.72,381.41999999999996
1356,54452317,2023-02-06,140.78,522.2
6868,54452317,2023-02-07,106.48,628.68
914,54452317,2023-02-07,-98.66,530.02
217,54452317,2023-02-09,-859.1,-329.08000000000004
2239,54452317,2023-02-11,139.14,-189.94000000000005
1488,54458410,2023-01-31,,973.1
1410,54458410,2023-02-04,-129.56,843.54
8687,54458410,2023-02-09,138.8,982.34
2944,54458410,2023-02-10,-87.63,894.71
2703,54458410,2023-02-12,68.8,963.51
1776,54458410,2023-02-13,-97.77,865.74
1489,54541943,2023-01-31,,433.92
5505,54541943,2023-02-02,156.5,590.4200000000001
4303,54541943,2023-02-03,-77.36,513.0600000000001
6112,54541943,2023-02-08,1686.0,2199.06
4905,54541943,2023-02-09,-74.96,2124.1
4896,54541943,2023-02-10,202.69,2326.79
3229,54541943,2023-02-11,121.09,2447.88
7493,54541943,2023-02-14,58.63,2506.5099999999998
1490,54565625,2023-01-31,,472.76
8555,54565625,2023-02-01,148.64,621.4
4854,54565625,2023-02-03,-79.68,541.72
135,54565625,2023-02-06,1947.3,2489.02
8657,54565625,2023-02-07,-62.17,2426.85
5697,54565625,2023-02-08,104.18,2531.03
7557,54565625,2023-02-09,-109.08,2421.95
3958,54565625,2023-02-10,-152.17,2269.78
1437,54565625,2023-02-11,42.95,2312.73
1929,54565625,2023-02-11,-170.89,2141.84
3999,54565625,2023-02-11,-246.42,1895.42
2838,54565625,2023-02-13,70.85,1966.27
7138,54565625,2023-02-13,-77.52,1888.75
146,54565625,2023-02-14,-100.41,1788.3400000000001
1491,54570251,2023-01-31,,430.68
6592,54570251,2023-02-03,109.86,540.54
7949,54570251,2023-02-03,-79.51,461.03
2551,54570251,2023-02-04,25.74,486.77
5166,54570251,2023-02-06,-105.34,381.43
1561,54570251,2023-02-09,-129.85,251.57999999999998
6176,54570251,2023-02-09,-166.16,85.41999999999999
2479,54570251,2023-02-14,-51.9,33.51999999999999
1492,54589543,2023-01-31,,817.51
5980,54589543,2023-02-02,-1117.0,-299.49
4959,54589543,2023-02-06,977.0,677.51
6257,54589543,2023-02-08,96.45,773.96
3932,54589543,2023-02-10,154.39,928.3499999999999
5379,54589543,2023-02-12,-106.92,821.43
7513,54589543,2023-02-12,-180.17,641.26
6308,54589543,2023-02-13,-125.92,515.34
1493,54673873,2023-01-31,,71.58
309,54673873,2023-02-05,73.99,145.57
5610,54673873,2023-02-11,55.02,200.59
1384,54673873,2023-02-11,-32.2,168.39
1973,54673873,2023-02-14,134.69,303.08
1494,54720837,2023-01-31,,166.15
330,54720837,2023-02-04,133.55,299.70000000000005
5909,54720837,2023-02-05,-142.54,157.16000000000003
8547,54720837,2023-02-10,121.97,279.13
5234,54720837,2023-02-11,-409.8,-130.66999999999996
4624,54720837,2023-02-13,125.97,-4.69999999999996
8186,54720837,2023-02-13,93.53,88.83000000000004
1495,54786481,2023-01-31,,96.87
7270,54786481,2023-02-04,-146.68,-49.81
7912,54786481,2023-02-07,134.29,84.47999999999999
3925,54786481,2023-02-08,68.63,153.10999999999999
3027,54786481,2023-02-09,36.48,189.58999999999997
7385,54786481,2023-02-11,121.25,310.84
8560,54786481,2023-02-12,-37.05,273.78999999999996
5467,54786481,2023-02-13,-99.06,174.72999999999996
1496,54824933,2023-01-31,,721.47
484,54824933,2023-02-05,-130.71,590.76
7587,54824933,2023-02-09,1549.1,2139.8599999999997
2334,54824933,2023-02-10,106.03,2245.89
2760,54824933,2023-02-10,11.9,2257.79
4517,54824933,2023-02-12,-120.78,2137.0099999999998
1497,54852109,2023-01-31,,521.7
718,54852109,2023-02-09,993.4,1515.1
4236,54852109,2023-02-13,70.25,1585.35
1498,54868017,2023-01-31,,789.86
1428,54868017,2023-02-06,49.33,839.19
6547,54868017,2023-02-08,165.57,1004.76
3036,54868017,2023-02-08,-1024.6,-19.839999999999918
804,54868017,2023-02-10,158.94,139.10000000000008
7520,54868017,2023-02-11,181.68,320.7800000000001
161,54868017,2023-02-11,-143.78,177.00000000000009
4497,54868017,2023-02-13,-148.43,28.57000000000008
1499,54878364,2023-01-31,,80.24
5452,54878364,2023-02-03,85.24,165.48
7229,54878364,2023-02-07,-1689.7,-1524.22
4305,54878364,2023-02-08,63.42,-1460.8
1500,54910290,2023-01-31,,11.12
3597,54910290,2023-02-04,950.2,961.32
5521,54910290,2023-02-06,-48.88,912.44
5246,54910290,2023-02-06,-51.05,861.3900000000001
7573,54910290,2023-02-06,-120.17,741.22
5017,54910290,2023-02-07,-129.66,611.5600000000001
6087,54910290,2023-02-08,85.98,697.5400000000001
4111,54910290,2023-02-09,-62.92,634.6200000000001
6650,54910290,2023-02-12,165.42,800.0400000000001
1501,54932317,2023-01-31,,378.86
7360,54932317,2023-02-04,15.32,394.18
6134,54932317,2023-02-06,52.94,447.12
3656,54932317,2023-02-08,10.18,457.3
4553,54932317,2023-02-09,82.57,539.87
8292,54932317,2023-02-10,-116.53,423.34000000000003
8599,54932317,2023-02-11,-858.7,-435.36
6553,54932317,2023-02-13,44.84,-390.52
4052,54932317,2023-02-14,-158.33,-548.85
1502,54937975,2023-01-31,,218.66
5732,54937975,2023-02-07,-62.35,156.31
2611,54937975,2023-02-09,-37.53,118.78
5192,54937975,2023-02-11,-1507.4,-1388.6200000000001
1636,54937975,2023-02-14,195.92,-1192.7
7567,54937975,2023-02-14,96.78,-1095.92
1503,54958511,2023-01-31,,454.61
7971,54958511,2023-02-06,-157.18,297.43
6950,54958511,2023-02-08,-44.34,253.09
3561,54958511,2023-02-09,180.82,433.90999999999997
6094,54958511,2023-02-12,-81.37,352.53999999999996
1504,54958587,2023-01-31,,874.83
4437,54958587,2023-02-03,-106.51,768.32
4002,54958587,2023-02-04,-81.63,686.69
304,54958587,2023-02-06,-50.78,635.9100000000001
6900,54958587,2023-02-07,-117.45,518.46
2545,54958587,2023-02-08,110.15,628.61
925,54958587,2023-02-08,-50.71,577.9000000000001
4846,54958587,2023-02-14,-112.23,465.6700000000001
1505,54997427,2023-01-31,,825.84
1360,54997427,2023-02-02,-37.62,788.22
6393,54997427,2023-02-08,-110.6,677.62
1506,55009163,2023-01-31,,435.8
8072,55009163,2023-02-05,123.78,559.58
813,55009163,2023-02-07,-77.09,482.49
3913,55009163,2023-02-08,-44.05,438.44
3292,55009163,2023-02-08,-187.67,250.77000000000004
1565,55009163,2023-02-10,137.34,388.11
3389,55009163,2023-02-10,86.61,474.72
4690,55009163,2023-02-13,-23.17,451.55000000000007
1507,55022533,2023-01-31,,341.29
4178,55022533,2023-02-05,-35.44,305.85
1103,55022533,2023-02-05,-174.7,131.15000000000003
755,55022533,2023-02-07,140.77,271.9200000000001
436,55022533,2023-02-09,-98.03,173.89000000000004
1508,55088029,2023-01-31,,920.53
1506,55088029,2023-02-01,-152.86,767.67
8245,55088029,2023-02-03,556.5,1324.17
7841,55088029,2023-02-11,122.71,1446.8799999999999
1509,55106431,2023-01-31,,460.48
4672,55106431,2023-02-04,163.15,623.63
3070,55106431,2023-02-04,150.02,773.6500000000001
5759,55106431,2023-02-08,101.87,875.52
1510,55122249,2023-01-31,,43.86
6463,55122249,2023-02-11,-66.07,-22.209999999999994
644,55122249,2023-02-12,84.75,62.540000000000006
2086,55122249,2023-02-14,152.84,215.38
2730,55122249,2023-02-14,68.84,284.22
1511,55168205,2023-01-31,,578.4
8202,55168205,2023-02-01,-78.1,500.29999999999995
1915,55168205,2023-02-04,-120.38,379.91999999999996
5813,55168205,2023-02-06,95.11,475.03
4051,55168205,2023-02-07,88.15,563.18
4814,55168205,2023-02-13,66.15,629.33
4616,55168205,2023-02-14,24.04,653.37
6382,55168205,2023-02-14,-1137.7,-484.33000000000004
1512,55304418,2023-01-31,,968.71
4051,55304418,2023-02-07,-88.15,880.5600000000001
2592,55304418,2023-02-08,-107.41,773.1500000000001
5855,55304418,2023-02-09,57.36,830.51
5049,55304418,2023-02-10,-1795.9,-965.3900000000001
5129,55304418,2023-02-11,-1214.6,-2179.99
6919,55304418,2023-02-12,158.82,-2021.17
2880,55304418,2023-02-13,-871.5,-2892.67
1513,55341552,2023-01-31,,768.94
2544,55341552,2023-02-02,755.3,1524.24
1190,55341552,2023-02-02,48.35,1572.59
854,55341552,2023-02-04,567.7,2140.29
3012,55341552,2023-02-09,-168.65,1971.64
6698,55341552,2023-02-12,-70.46,1901.18
5390,55341552,2023-02-13,-142.04,1759.14
1514,55353228,2023-01-31,,923.38
1019,55353228,2023-02-05,-540.8,382.58000000000004
477,55353228,2023-02-09,-29.71,352.87000000000006
7962,55353228,2023-02-11,-132.96,219.91000000000003
7835,55353228,2023-02-13,105.18,325.09000000000003
1515,55397453,2023-01-31,,820.88
8188,55397453,2023-02-01,96.77,917.65
8169,55397453,2023-02-02,1413.6,2331.25
6616,55397453,2023-02-06,198.2,2529.45
3505,55397453,2023-02-07,121.46,2650.91
1078,55397453,2023-02-07,-132.91,2518.0
3279,55397453,2023-02-08,143.22,2661.22
6162,55397453,2023-02-08,80.46,2741.68
138,55397453,2023-02-08,-151.99,2589.69
4126,55397453,2023-02-14,194.38,2784.07
1516,55398856,2023-01-31,,663.43
3271,55398856,2023-02-01,-645.5,17.92999999999995
5243,55398856,2023-02-02,884.3,902.2299999999999
7462,55398856,2023-02-03,95.54,997.7699999999999
5279,55398856,2023-02-04,-19.13,978.6399999999999
1097,55398856,2023-02-07,47.31,1025.9499999999998
8559,55398856,2023-02-11,-88.16,937.79
5175,55398856,2023-02-12,139.58,1077.37
1517,55459151,2023-01-31,,451.21
6230,55459151,2023-02-02,-162.1,289.11
8658,55459151,2023-02-06,161.61,450.72
3883,55459151,2023-02-06,-78.08,372.64
5293,55459151,2023-02-09,-46.3,326.34000000000003
8247,55459151,2023-02-09,-897.0,-570.66
5744,55459151,2023-02-14,144.85,-425.80999999999995
236,55459151,2023-02-14,64.45,-361.35999999999996
1518,55472786,2023-01-31,,634.29
1519,55513887,2023-01-31,,722.45
57,55513887,2023-02-02,-116.43,606.02
768,55513887,2023-02-03,-74.5,531.52
5260,55513887,2023-02-11,218.81,750.33
6681,55513887,2023-02-11,-50.13,700.2
4664,55513887,2023-02-13,116.37,816.57
6639,55513887,2023-02-14,-76.32,740.25
1520,55552232,2023-01-31,,953.87
2090,55552232,2023-02-01,152.59,1106.46
3623,55552232,2023-02-06,51.75,1158.21
2866,55552232,2023-02-06,-167.46,990.75
334,55552232,2023-02-10,-679.8,310.95000000000005
6419,55552232,2023-02-12,-149.57,161.38000000000005
1521,55590263,2023-01-31,,605.12
1412,55590263,2023-02-01,189.32,794.44
6572,55590263,2023-02-03,-215.09,579.35
1734,55590263,2023-02-07,116.74,696.09
4044,55590263,2023-02-07,-76.2,619.89
1791,55590263,2023-02-09,78.22,698.11
1522,55607955,2023-01-31,,274.23
7822,55607955,2023-02-07,-89.17,185.06
4830,55607955,2023-02-12,-0.94,184.12
3146,55607955,2023-02-13,53.93,238.05
1523,55714753,2023-01-31,,703.59
2085,55714753,2023-02-03,-64.43,639.1600000000001
6259,55714753,2023-02-06,-30.38,608.78
3894,55714753,2023-02-07,38.04,646.82
2155,55714753,2023-02-10,-26.55,620.27
1524,55753843,2023-01-31,,524.57
3236,55753843,2023-02-04,-158.04,366.5300000000001
3346,55753843,2023-02-05,-147.75,218.78000000000006
2886,55753843,2023-02-10,-194.97,23.81000000000006
1645,55753843,2023-02-11,-127.25,-103.43999999999994
1525,55791547,2023-01-31,,758.17
5536,55791547,2023-02-07,-85.35,672.8199999999999
8267,55791547,2023-02-08,1565.7,2238.52
1315,55791547,2023-02-09,58.39,2296.91
2897,55791547,2023-02-11,-125.71,2171.2
6078,55791547,2023-02-13,188.62,2359.82
1526,55795603,2023-01-31,,241.17
7564,55795603,2023-02-02,-112.16,129.01
8266,55795603,2023-02-04,-482.7,-353.69
1914,55795603,2023-02-08,179.3,-174.39
2523,55795603,2023-02-10,-40.02,-214.41
6154,55795603,2023-02-12,-272.8,-487.21000000000004
1527,55819086,2023-01-31,,608.13
4836,55819086,2023-02-01,209.89,818.02
603,55819086,2023-02-01,90.71,908.73
6813,55819086,2023-02-03,510.1,1418.83
4054,55819086,2023-02-03,218.15,1636.98
4522,55819086,2023-02-03,-130.36,1506.62
2460,55819086,2023-02-04,88.18,1594.8
4179,55819086,2023-02-09,-135.23,1459.57
6251,55819086,2023-02-10,98.96,1558.53
5407,55819086,2023-02-13,-51.71,1506.82
6398,55819086,2023-02-14,84.96,1591.78
1528,55912413,2023-01-31,,297.61
3074,55912413,2023-02-03,77.0,374.61
296,55912413,2023-02-03,-90.58,284.03000000000003
2177,55912413,2023-02-11,-102.08,181.95000000000002
6905,55912413,2023-02-13,97.05,279.0
4942,55912413,2023-02-13,-25.66,253.34
1529,55916056,2023-01-31,,377.36
794,55916056,2023-02-06,1338.0,1715.3600000000001
2957,55916056,2023-02-06,143.44,1858.8000000000002
3934,55916056,2023-02-06,-60.08,1798.72
1473,55916056,2023-02-06,-178.4,1620.3200000000002
7993,55916056,2023-02-08,103.03,1723.3500000000001
434,55916056,2023-02-10,-79.86,1643.49
1530,55975906,2023-01-31,,112.69
575,55975906,2023-02-03,-94.79,17.89999999999999
2788,55975906,2023-02-04,-44.5,-26.60000000000001
1849,55975906,2023-02-05,74.28,47.67999999999999
4967,55975906,2023-02-14,148.63,196.31
1531,55986027,2023-01-31,,38.94
1692,55986027,2023-02-03,-100.38,-61.44
1271,55986027,2023-02-05,98.72,37.28
666,55986027,2023-02-06,-840.3,-803.02
2384,55986027,2023-02-09,-94.29,-897.31
2813,55986027,2023-02-11,-90.72,-988.03
4076,55986027,2023-02-12,-39.77,-1027.8
170,55986027,2023-02-13,-1619.8,-2647.6
1532,55986093,2023-01-31,,586.34
6179,55986093,2023-02-07,1298.9,1885.2400000000002
2960,55986093,2023-02-08,-88.74,1796.5000000000002
5220,55986093,2023-02-11,139.86,1936.3600000000001
8561,55986093,2023-02-14,-7.29,1929.0700000000002
54,55986093,2023-02-14,-135.61,1793.4600000000003
1533,56041976,2023-01-31,,56.45
8473,56041976,2023-02-04,55.94,112.39
1438,56041976,2023-02-07,-122.99,-10.599999999999994
5209,56041976,2023-02-08,107.83,97.23
3035,56041976,2023-02-09,93.51,190.74
7049,56041976,2023-02-10,-10.96,179.78
1534,56070421,2023-01-31,,286.85
7220,56070421,2023-02-03,-65.15,221.70000000000002
1965,56070421,2023-02-13,113.44,335.14
1535,56094156,2023-01-31,,531.43
755,56094156,2023-02-07,-140.77,390.65999999999997
4963,56094156,2023-02-08,258.6,649.26
336,56094156,2023-02-09,-45.07,604.1899999999999
6604,56094156,2023-02-10,193.16,797.35
3931,56094156,2023-02-13,1237.4,2034.75
1536,56116199,2023-01-31,,615.98
5010,56116199,2023-02-01,-129.83,486.15
3134,56116199,2023-02-03,-35.32,450.83
5938,56116199,2023-02-06,-126.54,324.28999999999996
7540,56116199,2023-02-10,91.04,415.33
1537,56120063,2023-01-31,,94.32
2295,56120063,2023-02-02,179.69,274.01
5577,56120063,2023-02-04,-89.11,184.89999999999998
8236,56120063,2023-02-06,137.1,322.0
4175,56120063,2023-02-07,122.13,444.13
4779,56120063,2023-02-07,98.42,542.55
513,56120063,2023-02-08,-174.24,368.31
5701,56120063,2023-02-11,-41.23,327.08
1538,56189750,2023-01-31,,365.48
3598,56189750,2023-02-07,-121.65,243.83
4962,56189750,2023-02-10,-50.54,193.29000000000002
6053,56189750,2023-02-12,155.17,348.46000000000004
1855,56189750,2023-02-14,2237.0,2585.46
1539,56297850,2023-01-31,,320.47
4285,56297850,2023-02-01,-114.68,205.79000000000002
3373,56297850,2023-02-05,52.34,258.13
7214,56297850,2023-02-08,30.53,288.66
2068,56297850,2023-02-12,-21.61,267.05
1540,56422161,2023-01-31,,990.84
5268,56422161,2023-02-07,46.29,1037.13
1686,56422161,2023-02-08,62.89,1100.02
5829,56422161,2023-02-09,110.83,1210.85
7956,56422161,2023-02-10,38.38,1249.23
8016,56422161,2023-02-14,195.84,1445.07
5760,56422161,2023-02-14,95.91,1540.98
1541,56453199,2023-01-31,,605.38
867,56453199,2023-02-01,-71.22,534.16
7353,56453199,2023-02-08,-105.53,428.63
8545,56453199,2023-02-08,-697.8,-269.16999999999996
4131,56453199,2023-02-10,-55.02,-324.18999999999994
1542,56458213,2023-01-31,,731.3
6380,56458213,2023-02-01,-588.3,143.0
3907,56458213,2023-02-02,-1351.2,-1208.2
342,56458213,2023-02-06,-141.23,-1349.43
6846,56458213,2023-02-10,-120.81,-1470.24
5709,56458213,2023-02-12,-121.0,-1591.24
478,56458213,2023-02-14,181.24,-1410.0
1543,56468624,2023-01-31,,655.33
900,56468624,2023-02-03,16.2,671.5300000000001
7628,56468624,2023-02-03,-88.74,582.7900000000001
1675,56468624,2023-02-08,92.38,675.1700000000001
8569,56468624,2023-02-12,910.1,1585.27
4145,56468624,2023-02-13,-68.93,1516.3400000000001
1544,56483442,2023-01-31,,151.85
3893,56483442,2023-02-02,-1298.8,-1146.95
4875,56483442,2023-02-10,163.18,-983.77
1545,56573058,2023-01-31,,34.66
2472,56573058,2023-02-01,129.52,164.18
7289,56573058,2023-02-02,-61.2,102.98
4452,56573058,2023-02-04,163.58,266.56
4976,56573058,2023-02-04,37.75,304.31000000000006
5521,56573058,2023-02-06,48.88,353.19000000000005
4645,56573058,2023-02-07,-137.57,215.62000000000003
6059,56573058,2023-02-09,-118.82,96.80000000000004
147,56573058,2023-02-12,907.1,1003.9000000000001
6485,56573058,2023-02-12,214.19,1218.0900000000001
7123,56573058,2023-02-13,-53.93,1164.16
1546,56609826,2023-01-31,,14.24
2901,56609826,2023-02-05,174.96,189.20000000000002
1872,56609826,2023-02-09,134.28,323.48
8070,56609826,2023-02-12,-136.93,186.55
4824,56609826,2023-02-14,87.3,273.85
1547,56723864,2023-01-31,,246.21
4388,56723864,2023-02-01,-128.49,117.72
8112,56723864,2023-02-02,137.59,255.31
816,56723864,2023-02-03,164.36,419.67
2866,56723864,2023-02-06,167.46,587.13
4015,56723864,2023-02-07,-76.84,510.29
495,56723864,2023-02-11,117.62,627.9100000000001
3091,56723864,2023-02-11,69.79,697.7
4038,56723864,2023-02-12,-104.46,593.24
8150,56723864,2023-02-14,-70.03,523.21
1548,56751728,2023-01-31,,610.52
8140,56751728,2023-02-02,-93.7,516.8199999999999
35,56751728,2023-02-02,-128.71,388.10999999999996
3729,56751728,2023-02-06,83.83,471.93999999999994
7425,56751728,2023-02-07,-63.12,408.81999999999994
4537,56751728,2023-02-08,-974.3,-565.48
6075,56751728,2023-02-13,-120.16,-685.64
1549,56759680,2023-01-31,,479.7
3554,56759680,2023-02-11,90.65,570.35
1550,56760248,2023-01-31,,571.55
5285,56760248,2023-02-03,56.89,628.4399999999999
249,56760248,2023-02-03,5.38,633.8199999999999
7121,56760248,2023-02-03,-49.32,584.5
3581,56760248,2023-02-06,111.41,695.91
7530,56760248,2023-02-06,-109.59,586.3199999999999
687,56760248,2023-02-06,-173.92,412.4
7041,56760248,2023-02-08,-38.27,374.13
3767,56760248,2023-02-09,89.08,463.21
6769,56760248,2023-02-12,-101.83,361.38
4865,56760248,2023-02-13,357.3,718.6800000000001
1551,56842874,2023-01-31,,22.02
7886,56842874,2023-02-06,-69.2,-47.18000000000001
7022,56842874,2023-02-12,-127.2,-174.38
1552,56843498,2023-01-31,,509.55
7204,56843498,2023-02-01,122.7,632.25
5394,56843498,2023-02-02,104.79,737.04
5324,56843498,2023-02-04,101.52,838.5600000000001
7648,56843498,2023-02-05,-160.23,678.33
7485,56843498,2023-02-05,-1345.1,-666.7699999999999
3844,56843498,2023-02-09,1156.9,490.1300000000002
4179,56843498,2023-02-09,135.23,625.3600000000002
757,56843498,2023-02-13,-121.9,503.4600000000002
1553,56875373,2023-01-31,,633.79
6563,56875373,2023-02-01,-71.73,562.06
4244,56875373,2023-02-03,103.79,665.8499999999999
1373,56875373,2023-02-04,-100.66,565.1899999999999
1107,56875373,2023-02-07,-69.39,495.79999999999995
5539,56875373,2023-02-11,159.77,655.5699999999999
1554,56878640,2023-01-31,,846.85
2834,56878640,2023-02-03,139.16,986.01
4737,56878640,2023-02-05,99.24,1085.25
4417,56878640,2023-02-10,121.71,1206.96
1779,56878640,2023-02-12,36.64,1243.6
5779,56878640,2023-02-12,-151.09,1092.51
1555,56899079,2023-01-31,,445.39
4914,56899079,2023-02-09,-827.3,-381.90999999999997
1556,56922739,2023-01-31,,174.07
1842,56922739,2023-02-03,-220.14,-46.06999999999999
5183,56922739,2023-02-05,102.17,56.10000000000001
5665,56922739,2023-02-07,-80.94,-24.83999999999999
2927,56922739,2023-02-11,-107.01,-131.85
1557,56936624,2023-01-31,,503.74
4300,56936624,2023-02-02,1921.4,2425.1400000000003
3285,56936624,2023-02-03,73.31,2498.4500000000003
4441,56936624,2023-02-03,-101.8,2396.65
648,56936624,2023-02-07,105.18,2501.83
2252,56936624,2023-02-12,125.27,2627.1
6107,56936624,2023-02-14,-166.38,2460.7200000000003
1558,56946115,2023-01-31,,298.13
1127,56946115,2023-02-02,-45.22,252.91
4925,56946115,2023-02-07,74.35,327.26
5714,56946115,2023-02-12,-92.42,234.83999999999997
1559,57027965,2023-01-31,,979.57
1918,57027965,2023-02-02,103.75,1083.3200000000002
6808,57027965,2023-02-02,-111.9,971.4200000000001
7777,57027965,2023-02-02,-115.29,856.13
6526,57027965,2023-02-05,-109.24,746.8900000000001
8664,57027965,2023-02-06,-197.61,549.28
6706,57027965,2023-02-08,-92.59,456.69000000000005
7176,57027965,2023-02-09,54.69,511.38
4773,57027965,2023-02-10,-210.62,300.76
4436,57027965,2023-02-11,151.02,451.78000000000003
3491,57027965,2023-02-14,-127.34,324.44000000000005
1560,57043647,2023-01-31,,552.06
6001,57043647,2023-02-01,-103.35,448.7099999999999
7701,57043647,2023-02-03,124.18,572.89
2804,57043647,2023-02-03,58.81,631.6999999999999
285,57043647,2023-02-09,-53.56,578.14
5299,57043647,2023-02-11,152.46,730.5999999999999
8033,57043647,2023-02-12,14.26,744.86
3408,57043647,2023-02-13,107.17,852.03
2022,57043647,2023-02-13,-1207.6,-355.56999999999994
1561,57063886,2023-01-31,,384.17
833,57063886,2023-02-04,134.46,518.63
4224,57063886,2023-02-07,33.98,552.61
6138,57063886,2023-02-09,-110.14,442.47
2832,57063886,2023-02-10,182.75,625.22
3177,57063886,2023-02-13,-98.44,526.78
1562,57071366,2023-01-31,,911.45
3527,57071366,2023-02-01,80.58,992.0300000000001
380,57071366,2023-02-01,76.18,1068.21
8438,57071366,2023-02-03,96.63,1164.8400000000001
1463,57071366,2023-02-03,-19.89,1144.95
6488,57071366,2023-02-08,88.56,1233.51
46,57071366,2023-02-09,-55.83,1177.68
7849,57071366,2023-02-09,-125.68,1052.0
5564,57071366,2023-02-11,49.96,1101.96
1563,57084496,2023-01-31,,58.05
3100,57084496,2023-02-01,1058.7,1116.75
7197,57084496,2023-02-01,802.6,1919.35
2614,57084496,2023-02-04,-121.83,1797.52
6255,57084496,2023-02-07,18.61,1816.13
8125,57084496,2023-02-10,8.85,1824.98
3338,57084496,2023-02-10,-82.33,1742.65
7312,57084496,2023-02-12,-1251.2,491.45000000000005
4493,57084496,2023-02-14,-63.0,428.45000000000005
1564,57096259,2023-01-31,,540.54
338,57096259,2023-02-02,168.98,709.52
8346,57096259,2023-02-03,101.3,810.8199999999999
5589,57096259,2023-02-05,77.95,888.77
3480,57096259,2023-02-05,-907.1,-18.33000000000004
2978,57096259,2023-02-06,-24.84,-43.170000000000044
2320,57096259,2023-02-09,97.89,54.719999999999956
1565,57108303,2023-01-31,,737.04
7726,57108303,2023-02-03,118.63,855.67
7980,57108303,2023-02-04,-1795.8,-940.13
3492,57108303,2023-02-05,49.78,-890.35
3872,57108303,2023-02-13,97.98,-792.37
1566,57121657,2023-01-31,,847.9
7434,57121657,2023-02-01,135.55,983.45
2441,57121657,2023-02-05,54.79,1038.24
5765,57121657,2023-02-08,796.3,1834.54
3534,57121657,2023-02-08,100.27,1934.81
7467,57121657,2023-02-08,-9.98,1924.83
587,57121657,2023-02-12,-65.93,1858.8999999999999
4413,57121657,2023-02-12,-134.36,1724.54
6468,57121657,2023-02-13,154.58,1879.12
7716,57121657,2023-02-14,96.98,1976.1
1567,57133159,2023-01-31,,734.4
5792,57133159,2023-02-09,102.35,836.75
6557,57133159,2023-02-13,128.11,964.86
1568,57145139,2023-01-31,,708.46
324,57145139,2023-02-02,-62.33,646.13
5683,57145139,2023-02-04,-186.01,460.12000000000006
1782,57145139,2023-02-05,-1233.7,-773.5799999999999
384,57145139,2023-02-07,143.04,-630.54
7735,57145139,2023-02-07,108.88,-521.66
6228,57145139,2023-02-07,-81.96,-603.6199999999999
3534,57145139,2023-02-08,-100.27,-703.8899999999999
1569,57148382,2023-01-31,,638.49
8143,57148382,2023-02-01,81.16,719.65
3791,57148382,2023-02-04,-126.18,593.47
3145,57148382,2023-02-05,-155.64,437.83000000000004
8030,57148382,2023-02-06,-876.5,-438.66999999999996
7433,57148382,2023-02-07,-85.25,-523.92
1987,57148382,2023-02-10,105.08,-418.84
1694,57148382,2023-02-12,144.16,-274.67999999999995
1570,57160773,2023-01-31,,802.9
1524,57160773,2023-02-01,96.2,899.1
7221,57160773,2023-02-03,-472.5,426.59999999999997
6280,57160773,2023-02-05,119.28,545.88
110,57160773,2023-02-08,-77.84,468.03999999999996
111,57160773,2023-02-10,167.51,635.55
6203,57160773,2023-02-13,-45.56,589.99
1571,57186194,2023-01-31,,824.69
640,57186194,2023-02-01,-106.33,718.36
5713,57186194,2023-02-02,-109.06,609.3000000000001
3741,57186194,2023-02-05,-111.92,497.38000000000005
770,57186194,2023-02-09,-181.31,316.07000000000005
4775,57186194,2023-02-13,48.13,364.20000000000005
2868,57186194,2023-02-14,158.38,522.58
7103,57186194,2023-02-14,-756.9,-234.31999999999994
1572,57224848,2023-01-31,,30.59
6505,57224848,2023-02-02,96.85,127.44
5286,57224848,2023-02-02,-74.5,52.94
3590,57224848,2023-02-05,-77.0,-24.060000000000002
5488,57224848,2023-02-07,85.73,61.67
1666,57224848,2023-02-10,-1987.3,-1925.6299999999999
37,57224848,2023-02-12,-27.74,-1953.37
3002,57224848,2023-02-12,-112.58,-2065.95
1573,57273397,2023-01-31,,403.21
529,57273397,2023-02-06,154.24,557.45
5061,57273397,2023-02-06,-134.08,423.37
8409,57273397,2023-02-09,36.49,459.85999999999996
4267,57273397,2023-02-11,117.16,577.02
4810,57273397,2023-02-11,81.26,658.28
2553,57273397,2023-02-13,-186.3,471.97999999999996
5302,57273397,2023-02-14,-97.09,374.89
1574,57300901,2023-01-31,,302.87
6832,57300901,2023-02-01,-65.35,237.52
1874,57300901,2023-02-03,108.13,345.65
3151,57300901,2023-02-03,-72.03,273.62
3807,57300901,2023-02-04,213.8,487.42
5309,57300901,2023-02-04,-1320.2,-832.78
2098,57300901,2023-02-09,-78.1,-910.88
6899,57300901,2023-02-10,-162.36,-1073.24
2514,57300901,2023-02-12,137.14,-936.1
4361,57300901,2023-02-12,100.81,-835.29
1575,57302841,2023-01-31,,341.02
6214,57302841,2023-02-01,72.19,413.21
7813,57302841,2023-02-08,152.99,566.2
6982,57302841,2023-02-08,-91.11,475.09
6915,57302841,2023-02-13,-134.97,340.12
1576,57372684,2023-01-31,,249.26
5528,57372684,2023-02-01,111.48,360.74
1109,57372684,2023-02-02,237.02,597.76
1338,57372684,2023-02-06,-141.38,456.38
514,57372684,2023-02-08,-52.45,403.93
3701,57372684,2023-02-10,121.29,525.22
7301,57372684,2023-02-10,-94.14,431.08
7427,57372684,2023-02-12,-93.57,337.51
1577,57395511,2023-01-31,,747.89
4850,57395511,2023-02-02,-151.59,596.3
5405,57395511,2023-02-06,-91.85,504.45
6717,57395511,2023-02-07,120.5,624.95
4553,57395511,2023-02-09,-82.57,542.38
3176,57395511,2023-02-11,85.36,627.74
390,57395511,2023-02-12,-95.25,532.49
5551,57395511,2023-02-13,123.69,656.18
6026,57395511,2023-02-14,-83.11,573.0699999999999
1578,57413609,2023-01-31,,219.01
132,57413609,2023-02-08,-30.21,188.79999999999998
1582,57413609,2023-02-12,-68.21,120.59
1579,57426365,2023-01-31,,606.03
8688,57426365,2023-02-01,123.23,729.26
512,57426365,2023-02-01,94.29,823.55
6832,57426365,2023-02-01,65.35,888.9
5320,57426365,2023-02-03,52.27,941.17
2498,57426365,2023-02-05,6.87,948.04
5067,57426365,2023-02-05,-76.24,871.8
4977,57426365,2023-02-06,-126.49,745.31
7392,57426365,2023-02-10,52.93,798.24
4539,57426365,2023-02-12,-100.61,697.63
3946,57426365,2023-02-14,37.59,735.22
1580,57436108,2023-01-31,,899.46
6870,57436108,2023-02-02,49.76,949.22
4390,57436108,2023-02-02,-98.78,850.44
4183,57436108,2023-02-04,-1349.2,-498.76
3013,57436108,2023-02-05,-129.49,-628.25
6612,57436108,2023-02-10,-103.49,-731.74
6607,57436108,2023-02-13,127.61,-604.13
1581,57446648,2023-01-31,,542.41
2205,57446648,2023-02-02,179.19,721.5999999999999
5085,57446648,2023-02-06,1201.1,1922.6999999999998
8222,57446648,2023-02-09,123.62,2046.3199999999997
6762,57446648,2023-02-12,129.84,2176.16
1582,57450523,2023-01-31,,609.41
7575,57450523,2023-02-03,82.41,691.8199999999999
6033,57450523,2023-02-06,-82.1,609.72
5421,57450523,2023-02-08,59.47,669.1899999999999
6148,57450523,2023-02-11,-77.75,591.4399999999999
2697,57450523,2023-02-11,-991.6,-400.1600000000001
3977,57450523,2023-02-12,137.83,-262.33000000000004
1583,57507102,2023-01-31,,374.17
8054,57507102,2023-02-01,-84.14,290.03000000000003
7488,57507102,2023-02-09,-31.87,258.16
1105,57507102,2023-02-11,-148.04,110.12000000000003
4882,57507102,2023-02-12,31.75,141.87000000000003
7090,57507102,2023-02-13,116.22,258.09000000000003
6579,57507102,2023-02-14,74.72,332.81000000000006
1584,57584855,2023-01-31,,37.86
3370,57584855,2023-02-01,-83.37,-45.510000000000005
5218,57584855,2023-02-07,-125.24,-170.75
4625,57584855,2023-02-09,155.0,-15.75
6933,57584855,2023-02-11,81.2,65.45
7111,57584855,2023-02-11,-51.18,14.270000000000003
6469,57584855,2023-02-12,-56.96,-42.69
1585,57610201,2023-01-31,,931.52
6187,57610201,2023-02-03,-676.5,255.01999999999998
1702,57610201,2023-02-04,97.9,352.91999999999996
1853,57610201,2023-02-06,-58.71,294.21
7707,57610201,2023-02-11,-56.37,237.83999999999997
6315,57610201,2023-02-12,25.98,263.82
8283,57610201,2023-02-12,-145.68,118.13999999999999
3725,57610201,2023-02-13,-158.29,-40.150000000000006
7417,57610201,2023-02-14,64.87,24.72
1586,57612494,2023-01-31,,499.3
5399,57612494,2023-02-05,109.6,608.9
6383,57612494,2023-02-12,103.32,712.22
415,57612494,2023-02-12,-44.09,668.13
1587,57675131,2023-01-31,,410.85
7298,57675131,2023-02-02,90.07,500.92
6874,57675131,2023-02-04,112.22,613.14
3850,57675131,2023-02-07,123.24,736.38
2630,57675131,2023-02-07,-150.92,585.46
1588,57687949,2023-01-31,,542.92
2540,57687949,2023-02-01,119.2,662.12
515,57687949,2023-02-03,-88.02,574.0999999999999
1426,57687949,2023-02-07,211.2,785.3
912,57687949,2023-02-08,-119.51,665.79
6441,57687949,2023-02-09,682.6,1348.3899999999999
3515,57687949,2023-02-12,143.47,1491.86
1917,57687949,2023-02-13,-94.69,1397.17
1589,57717550,2023-01-31,,832.39
4924,57717550,2023-02-01,119.21,951.6
6923,57717550,2023-02-01,-103.68,847.92
6792,57717550,2023-02-03,-125.77,722.15
5634,57717550,2023-02-09,61.13,783.28
1590,57790631,2023-01-31,,893.46
518,57790631,2023-02-01,-105.16,788.3000000000001
2576,57790631,2023-02-09,-71.26,717.0400000000001
2026,57790631,2023-02-11,166.8,883.84
5290,57790631,2023-02-14,-1139.7,-255.86
1591,57886631,2023-01-31,,369.6
8394,57886631,2023-02-05,61.09,430.69000000000005
322,57886631,2023-02-06,543.9,974.59
3390,57886631,2023-02-07,52.98,1027.57
7644,57886631,2023-02-08,-114.36,913.21
182,57886631,2023-02-11,110.5,1023.71
6185,57886631,2023-02-11,-154.67,869.0400000000001
3798,57886631,2023-02-12,-85.93,783.11
42,57886631,2023-02-13,-143.14,639.97
1592,57897038,2023-01-31,,399.72
5443,57897038,2023-02-01,-38.67,361.05
4181,57897038,2023-02-02,46.31,407.36
1407,57897038,2023-02-04,118.34,525.7
480,57897038,2023-02-06,119.61,645.3100000000001
8505,57897038,2023-02-09,-1653.1,-1007.7899999999998
3884,57897038,2023-02-11,-88.41,-1096.1999999999998
1593,57941886,2023-01-31,,270.81
6894,57941886,2023-02-02,224.12,494.93
601,57941886,2023-02-02,166.1,661.03
1819,57941886,2023-02-06,-154.07,506.96000000000004
3422,57941886,2023-02-08,-59.97,446.99
4660,57941886,2023-02-12,38.42,485.41
7969,57941886,2023-02-14,-37.37,448.04
1594,57948925,2023-01-31,,194.11
4115,57948925,2023-02-03,-95.29,98.82000000000001
7133,57948925,2023-02-04,-1465.5,-1366.68
8142,57948925,2023-02-07,182.69,-1183.99
1974,57948925,2023-02-09,-7.12,-1191.1100000000001
4649,57948925,2023-02-09,-96.17,-1287.28
7905,57948925,2023-02-13,-1505.7,-2792.98
1595,57975842,2023-01-31,,101.94
1762,57975842,2023-02-10,181.0,282.94
1596,58009817,2023-01-31,,887.22
1605,58009817,2023-02-02,121.1,1008.32
6824,58009817,2023-02-03,-144.92,863.4000000000001
5503,58009817,2023-02-04,150.76,1014.1600000000001
3065,58009817,2023-02-05,-56.62,957.5400000000001
7997,58009817,2023-02-06,-64.67,892.87
2783,58009817,2023-02-08,111.05,1003.9200000000001
2555,58009817,2023-02-08,-22.97,980.95
3562,58009817,2023-02-12,-1354.4,-373.45000000000005
1597,58099419,2023-01-31,,185.74
6132,58099419,2023-02-01,-152.29,33.45000000000002
8617,58099419,2023-02-05,144.17,177.62
7649,58099419,2023-02-14,-80.0,97.62
1598,58126511,2023-01-31,,940.27
8269,58126511,2023-02-03,76.11,1016.38
4912,58126511,2023-02-03,-85.3,931.0799999999999
3436,58126511,2023-02-04,1639.2,2570.2799999999997
3031,58126511,2023-02-05,-148.33,2421.95
2930,58126511,2023-02-07,-98.77,2323.18
3967,58126511,2023-02-08,88.99,2412.17
5915,58126511,2023-02-09,-45.7,2366.47
2980,58126511,2023-02-11,-121.16,2245.31
2903,58126511,2023-02-13,108.27,2353.58
3121,58126511,2023-02-14,90.11,2443.69
2333,58126511,2023-02-14,36.2,2479.89
1599,58176810,2023-01-31,,219.07
7321,58176810,2023-02-02,-25.85,193.22
7545,58176810,2023-02-03,-105.11,88.10999999999999
289,58176810,2023-02-05,113.3,201.40999999999997
8059,58176810,2023-02-09,-104.33,97.07999999999998
6173,58176810,2023-02-14,133.71,230.79
1600,58182495,2023-01-31,,223.57
591,58182495,2023-02-05,-949.6,-726.03
6919,58182495,2023-02-12,-158.82,-884.8500000000001
1601,58216756,2023-01-31,,642.13
4367,58216756,2023-02-02,115.09,757.22
1420,58216756,2023-02-02,51.0,808.22
4591,58216756,2023-02-03,625.5,1433.72
7573,58216756,2023-02-06,120.17,1553.89
1333,58216756,2023-02-09,-79.05,1474.8400000000001
7933,58216756,2023-02-11,-91.03,1383.81
6275,58216756,2023-02-12,-1690.9,-307.09000000000015
5823,58216756,2023-02-13,-167.82,-474.91000000000014
1602,58249518,2023-01-31,,14.63
379,58249518,2023-02-07,56.84,71.47
5436,58249518,2023-02-12,-84.03,-12.560000000000002
1603,58254002,2023-01-31,,94.53
7952,58254002,2023-02-01,-91.66,2.8700000000000045
5824,58254002,2023-02-11,184.66,187.53
5567,58254002,2023-02-11,161.25,348.78
5099,58254002,2023-02-11,45.84,394.62
4515,58254002,2023-02-11,-165.77,228.85
7645,58254002,2023-02-13,-1258.1,-1029.25
3946,58254002,2023-02-14,-37.59,-1066.84
3678,58254002,2023-02-14,-141.17,-1208.01
1604,58258401,2023-01-31,,873.05
7078,58258401,2023-02-03,154.95,1028.0
1249,58258401,2023-02-06,-119.58,908.42
8187,58258401,2023-02-06,-178.88,729.54
1025,58258401,2023-02-07,-124.51,605.03
3278,58258401,2023-02-12,-105.2,499.8299999999999
1605,58265755,2023-01-31,,494.05
7374,58265755,2023-02-01,156.89,650.94
7889,58265755,2023-02-02,-124.21,526.73
7634,58265755,2023-02-03,178.54,705.27
3132,58265755,2023-02-03,-127.44,577.8299999999999
7092,58265755,2023-02-07,-114.81,463.02
8031,58265755,2023-02-08,-173.81,289.21
2318,58265755,2023-02-14,116.74,405.95
1606,58290957,2023-01-31,,580.25
6027,58290957,2023-02-06,-157.11,423.14
8213,58290957,2023-02-10,-134.24,288.9
1607,58304487,2023-01-31,,5.31
3361,58304487,2023-02-03,59.2,64.51
6041,58304487,2023-02-03,-115.75,-51.239999999999995
6689,58304487,2023-02-04,95.13,43.89
8388,58304487,2023-02-09,-146.33,-102.44000000000001
2728,58304487,2023-02-13,-86.65,-189.09000000000003
1608,58305943,2023-01-31,,970.56
659,58305943,2023-02-01,58.02,1028.58
2056,58305943,2023-02-02,-164.6,863.98
7009,58305943,2023-02-04,118.08,982.06
1920,58305943,2023-02-04,99.93,1081.99
733,58305943,2023-02-07,-122.53,959.4599999999999
3980,58305943,2023-02-07,-124.42,835.04
1365,58305943,2023-02-08,-122.18,712.8599999999999
4590,58305943,2023-02-09,-138.85,574.01
7097,58305943,2023-02-10,-114.0,460.01
1609,58306431,2023-01-31,,576.56
2988,58306431,2023-02-01,-102.89,473.66999999999996
7435,58306431,2023-02-02,103.47,577.14
782,58306431,2023-02-03,-123.38,453.75999999999993
179,58306431,2023-02-04,35.39,489.15
2167,58306431,2023-02-06,742.3,1231.4499999999998
8284,58306431,2023-02-12,-78.91,1152.54
5531,58306431,2023-02-12,-202.22,950.3199999999999
692,58306431,2023-02-13,67.88,1018.1999999999999
4428,58306431,2023-02-14,-1485.6,-467.4
1610,58332273,2023-01-31,,299.3
2801,58332273,2023-02-06,-179.82,119.48000000000002
4589,58332273,2023-02-09,73.05,192.53000000000003
8682,58332273,2023-02-12,19.96,212.49
1611,58345258,2023-01-31,,749.07
5921,58345258,2023-02-02,144.51,893.58
7258,58345258,2023-02-06,561.3,1454.88
8029,58345258,2023-02-08,-947.8,507.08000000000004
6065,58345258,2023-02-11,69.7,576.7800000000001
5039,58345258,2023-02-13,817.7,1394.48
1612,58362636,2023-01-31,,89.45
2995,58362636,2023-02-06,-39.83,49.620000000000005
5017,58362636,2023-02-07,129.66,179.28
2643,58362636,2023-02-08,120.31,299.59000000000003
3888,58362636,2023-02-12,95.84,395.43
1613,58384131,2023-01-31,,327.68
329,58384131,2023-02-01,158.57,486.25
2934,58384131,2023-02-05,-72.1,414.15
3839,58384131,2023-02-09,-70.47,343.68
3391,58384131,2023-02-09,-147.12,196.56
1614,58385320,2023-01-31,,693.52
185,58385320,2023-02-05,-89.23,604.29
7811,58385320,2023-02-05,-121.41,482.88
8437,58385320,2023-02-05,-197.01,285.87
196,58385320,2023-02-06,583.7,869.57
8157,58385320,2023-02-10,-79.87,789.7
1615,58400012,2023-01-31,,606.79
6563,58400012,2023-02-01,71.73,678.52
7650,58400012,2023-02-11,59.1,737.62
1616,58434725,2023-01-31,,365.9
4926,58434725,2023-02-03,-47.74,318.15999999999997
4641,58434725,2023-02-03,-87.65,230.50999999999996
4666,58434725,2023-02-09,-69.99,160.51999999999998
7165,58434725,2023-02-11,62.47,222.98999999999995
1602,58434725,2023-02-14,91.73,314.71999999999997
1617,58458443,2023-01-31,,903.64
6518,58458443,2023-02-03,-87.05,816.59
6811,58458443,2023-02-07,-180.63,635.96
1618,58489789,2023-01-31,,460.5
1450,58489789,2023-02-02,39.87,500.37
8635,58489789,2023-02-02,-120.72,379.65
7095,58489789,2023-02-04,-54.57,325.08
2925,58489789,2023-02-06,-97.09,227.99
3604,58489789,2023-02-07,-109.32,118.67000000000002
8003,58489789,2023-02-10,98.63,217.3
4565,58489789,2023-02-14,-108.48,108.82000000000001
1619,58491429,2023-01-31,,937.47
5589,58491429,2023-02-05,-77.95,859.52
7479,58491429,2023-02-06,-1486.9,-627.3800000000001
5669,58491429,2023-02-07,-103.74,-731.1200000000001
1341,58491429,2023-02-10,-93.02,-824.1400000000001
1620,58533748,2023-01-31,,490.86
5338,58533748,2023-02-04,-113.49,377.37
7579,58533748,2023-02-08,-80.13,297.24
4406,58533748,2023-02-14,90.86,388.1
1509,58533748,2023-02-14,-139.82,248.28000000000003
6193,58533748,2023-02-14,-321.9,-73.61999999999995
1621,58547184,2023-01-31,,218.22
7050,58547184,2023-02-02,1586.6,1804.82
7323,58547184,2023-02-02,61.66,1866.48
5412,58547184,2023-02-04,-14.63,1851.85
6125,58547184,2023-02-05,83.83,1935.6799999999998
7632,58547184,2023-02-06,107.61,2043.29
7079,58547184,2023-02-11,-69.84,1973.4499999999998
6679,58547184,2023-02-11,-142.41,1831.04
1622,58558145,2023-01-31,,495.35
3916,58558145,2023-02-10,-114.24,381.11
7216,58558145,2023-02-11,-91.38,289.73
6011,58558145,2023-02-13,91.8,381.53000000000003
1623,58586275,2023-01-31,,916.97
7731,58586275,2023-02-07,979.3,1896.27
4138,58586275,2023-02-07,-41.64,1854.6299999999999
1011,58586275,2023-02-10,-102.06,1752.57
2195,58586275,2023-02-12,-121.68,1630.8899999999999
1624,58668564,2023-01-31,,813.28
1577,58668564,2023-02-01,-105.85,707.43
1106,58668564,2023-02-08,-90.09,617.3399999999999
758,58668564,2023-02-11,1125.0,1742.34
287,58668564,2023-02-12,-108.96,1633.3799999999999
6312,58668564,2023-02-14,57.83,1691.21
1625,58683711,2023-01-31,,12.76
3005,58683711,2023-02-01,-115.4,-102.64
7470,58683711,2023-02-05,41.55,-61.09
7365,58683711,2023-02-10,126.49,65.39999999999999
5258,58683711,2023-02-10,88.53,153.93
8373,58683711,2023-02-14,0.36,154.29
1626,58703801,2023-01-31,,520.81
679,58703801,2023-02-09,-100.78,420.03
4398,58703801,2023-02-10,165.41,585.4399999999999
2246,58703801,2023-02-12,-166.9,418.53999999999996
7123,58703801,2023-02-13,53.93,472.4699999999999
1627,58720727,2023-01-31,,471.56
2946,58720727,2023-02-03,-142.86,328.7
2839,58720727,2023-02-04,108.24,436.94
4049,58720727,2023-02-05,-62.37,374.57
4965,58720727,2023-02-08,-92.11,282.46
5564,58720727,2023-02-11,-49.96,232.49999999999997
571,58720727,2023-02-11,-142.67,89.82999999999998
6730,58720727,2023-02-12,-113.6,-23.77000000000001
4459,58720727,2023-02-13,-80.64,-104.41000000000001
6327,58720727,2023-02-14,-1650.9,-1755.3100000000002
1628,58728550,2023-01-31,,250.26
6161,58728550,2023-02-04,-37.8,212.45999999999998
8632,58728550,2023-02-11,114.61,327.07
1629,58785108,2023-01-31,,473.41
8619,58785108,2023-02-01,61.87,535.28
1924,58785108,2023-02-04,104.53,639.8100000000001
2965,58785108,2023-02-04,-64.43,575.38
3154,58785108,2023-02-07,-883.6,-308.22
469,58785108,2023-02-11,-32.04,-340.26000000000005
2553,58785108,2023-02-13,186.3,-153.96
1630,58810775,2023-01-31,,747.44
1209,58810775,2023-02-01,-62.0,685.44
3465,58810775,2023-02-05,114.97,800.4100000000001
2053,58810775,2023-02-05,-20.17,780.24
307,58810775,2023-02-07,151.21,931.45
5870,58810775,2023-02-13,-97.59,833.86
1631,58811985,2023-01-31,,616.7
3036,58811985,2023-02-08,1024.6,1641.3
2683,58811985,2023-02-09,155.76,1797.06
1954,58811985,2023-02-12,-126.97,1670.09
7977,58811985,2023-02-14,85.37,1755.46
1632,58822254,2023-01-31,,79.7
4318,58822254,2023-02-02,-1559.2,-1479.5
1468,58822254,2023-02-03,-436.5,-1916.0
1410,58822254,2023-02-04,129.56,-1786.44
4757,58822254,2023-02-08,42.43,-1744.01
2830,58822254,2023-02-10,129.11,-1614.9
1633,58830897,2023-01-31,,834.24
5754,58830897,2023-02-02,-22.54,811.7
8473,58830897,2023-02-04,-55.94,755.76
6090,58830897,2023-02-05,-110.92,644.84
7406,58830897,2023-02-06,-117.02,527.82
4853,58830897,2023-02-11,152.47,680.29
6485,58830897,2023-02-12,-214.19,466.1
2628,58830897,2023-02-14,137.92,604.02
1634,58837121,2023-01-31,,160.48
4929,58837121,2023-02-04,97.06,257.53999999999996
1518,58837121,2023-02-05,-163.32,94.22
3444,58837121,2023-02-07,75.03,169.25
2365,58837121,2023-02-08,-80.72,88.53
5487,58837121,2023-02-11,111.96,200.49
7549,58837121,2023-02-11,-50.91,149.57999999999998
7909,58837121,2023-02-14,103.18,252.76
1635,58873428,2023-01-31,,191.58
5358,58873428,2023-02-07,39.09,230.67000000000002
1636,58874842,2023-01-31,,347.73
2857,58874842,2023-02-01,-53.09,294.64
7616,58874842,2023-02-07,-183.11,111.53
8090,58874842,2023-02-08,106.37,217.9
6678,58874842,2023-02-09,154.04,371.94
2642,58874842,2023-02-10,57.64,429.58
2916,58874842,2023-02-14,86.86,516.44
1637,58897654,2023-01-31,,210.05
8113,58897654,2023-02-04,113.97,324.02
2513,58897654,2023-02-05,193.2,517.22
1638,58925998,2023-01-31,,855.45
3681,58925998,2023-02-05,166.03,1021.48
1178,58925998,2023-02-09,56.12,1077.6000000000001
1063,58925998,2023-02-10,155.67,1233.27
5654,58925998,2023-02-11,100.88,1334.15
1626,58925998,2023-02-12,1261.6,2595.75
1639,58930654,2023-01-31,,661.48
232,58930654,2023-02-03,136.43,797.9100000000001
8410,58930654,2023-02-04,-158.41,639.5
8504,58930654,2023-02-09,-45.0,594.5
6749,58930654,2023-02-13,-93.39,501.11
7608,58930654,2023-02-13,-109.04,392.07000000000005
1640,58937028,2023-01-31,,626.96
802,58937028,2023-02-12,86.73,713.69
1641,58995891,2023-01-31,,12.92
2662,58995891,2023-02-03,-118.76,-105.84
7055,58995891,2023-02-08,-50.31,-156.15
4950,58995891,2023-02-09,125.24,-30.91000000000001
7233,58995891,2023-02-10,-106.62,-137.53000000000003
1642,59110895,2023-01-31,,605.5
2678,59110895,2023-02-09,-1260.0,-654.5
1643,59128512,2023-01-31,,305.71
1059,59128512,2023-02-01,158.92,464.63
5767,59128512,2023-02-03,94.28,558.91
8452,59128512,2023-02-07,1380.5,1939.4099999999999
70,59128512,2023-02-08,122.81,2062.22
5194,59128512,2023-02-09,109.28,2171.5
1754,59128512,2023-02-10,70.74,2242.24
7810,59128512,2023-02-13,67.31,2309.5499999999997
7897,59128512,2023-02-13,-128.0,2181.5499999999997
1644,59135815,2023-01-31,,240.6
7759,59135815,2023-02-01,-800.0,-559.4
2846,59135815,2023-02-04,436.5,-122.89999999999998
6003,59135815,2023-02-06,-108.14,-231.03999999999996
6021,59135815,2023-02-10,-1202.5,-1433.54
1645,59152169,2023-01-31,,148.6
91,59152169,2023-02-01,70.5,219.1
1571,59152169,2023-02-05,124.52,343.62
4182,59152169,2023-02-05,-57.18,286.44
6434,59152169,2023-02-08,92.83,379.27
5200,59152169,2023-02-09,-1160.0,-780.73
7136,59152169,2023-02-12,89.7,-691.03
1646,59167707,2023-01-31,,904.43
108,59167707,2023-02-01,-109.32,795.1099999999999
2871,59167707,2023-02-06,49.47,844.5799999999999
6768,59167707,2023-02-06,-60.85,783.7299999999999
8240,59167707,2023-02-10,-95.08,688.65
1647,59198134,2023-01-31,,122.62
1715,59198134,2023-02-06,168.59,291.21000000000004
4630,59198134,2023-02-09,-104.28,186.93
6871,59198134,2023-02-13,-135.45,51.48000000000002
4221,59198134,2023-02-13,-1291.4,-1239.92
1648,59201002,2023-01-31,,780.85
4133,59201002,2023-02-01,199.99,980.84
2214,59201002,2023-02-01,96.35,1077.19
8460,59201002,2023-02-04,-44.05,1033.14
2969,59201002,2023-02-08,-163.95,869.19
3179,59201002,2023-02-12,-742.0,127.19000000000005
1649,59235925,2023-01-31,,647.8
3722,59235925,2023-02-01,-66.43,581.3699999999999
2091,59235925,2023-02-04,111.18,692.55
7477,59235925,2023-02-06,84.1,776.65
6227,59235925,2023-02-08,42.92,819.5699999999999
3661,59235925,2023-02-08,-64.27,755.3
3753,59235925,2023-02-09,-101.53,653.77
3383,59235925,2023-02-11,152.0,805.77
1650,59238438,2023-01-31,,105.1
6466,59238438,2023-02-01,12.97,118.07
6364,59238438,2023-02-07,-49.76,68.31
4186,59238438,2023-02-09,85.32,153.63
6630,59238438,2023-02-12,-1799.2,-1645.5700000000002
1651,59252971,2023-01-31,,803.65
8376,59252971,2023-02-05,85.62,889.27
8071,59252971,2023-02-07,-1741.9,-852.6300000000001
2575,59252971,2023-02-13,131.61,-721.0200000000001
1831,59252971,2023-02-14,-169.73,-890.7500000000001
1652,59265775,2023-01-31,,695.02
4419,59265775,2023-02-01,55.85,750.87
2424,59265775,2023-02-04,81.94,832.81
852,59265775,2023-02-05,74.37,907.18
2381,59265775,2023-02-11,68.33,975.51
7354,59265775,2023-02-12,-130.06,845.45
1891,59265775,2023-02-12,-153.05,692.4
8218,59265775,2023-02-14,142.86,835.26
1653,59379884,2023-01-31,,139.54
4343,59379884,2023-02-05,81.18,220.72
2569,59379884,2023-02-10,-156.94,63.78
7053,59379884,2023-02-11,-65.4,-1.6200000000000045
3600,59379884,2023-02-12,564.4,562.78
7086,59379884,2023-02-13,-84.91,477.87
1654,59405362,2023-01-31,,503.89
1069,59405362,2023-02-01,136.51,640.4
3574,59405362,2023-02-01,76.9,717.3
6486,59405362,2023-02-05,-144.79,572.51
1146,59405362,2023-02-08,-195.9,376.61
634,59405362,2023-02-09,645.9,1022.51
1374,59405362,2023-02-10,-66.94,955.5699999999999
1386,59405362,2023-02-11,43.44,999.01
1655,59432049,2023-01-31,,387.57
4792,59432049,2023-02-01,142.99,530.56
2459,59432049,2023-02-04,578.7,1109.26
8195,59432049,2023-02-05,1121.5,2230.76
3501,59432049,2023-02-06,129.93,2360.69
6597,59432049,2023-02-06,117.11,2477.8
4438,59432049,2023-02-06,-106.77,2371.03
4818,59432049,2023-02-08,66.67,2437.7
3386,59432049,2023-02-08,-125.79,2311.91
6481,59432049,2023-02-11,-175.69,2136.22
6158,59432049,2023-02-14,-34.07,2102.15
1656,59450573,2023-01-31,,888.65
4271,59450573,2023-02-05,80.26,968.91
373,59450573,2023-02-09,-47.96,920.9499999999999
2993,59450573,2023-02-10,-86.27,834.68
1657,59455653,2023-01-31,,4.64
4468,59455653,2023-02-04,7.74,12.379999999999999
3501,59455653,2023-02-06,-129.93,-117.55000000000001
1866,59455653,2023-02-11,148.32,30.769999999999982
6789,59455653,2023-02-12,-1261.7,-1230.93
1658,59510370,2023-01-31,,523.1
2574,59510370,2023-02-03,32.77,555.87
5532,59510370,2023-02-04,-97.19,458.68000000000006
3098,59510370,2023-02-06,12.77,471.45000000000005
4260,59510370,2023-02-10,-62.26,409.19000000000005
8177,59510370,2023-02-14,-53.96,355.23
1659,59529922,2023-01-31,,516.09
4982,59529922,2023-02-01,-129.91,386.18000000000006
7868,59529922,2023-02-03,-104.89,281.29
7142,59529922,2023-02-04,105.37,386.66
8318,59529922,2023-02-06,104.58,491.24
5114,59529922,2023-02-07,-1.77,489.47
8542,59529922,2023-02-09,36.06,525.5300000000001
2012,59529922,2023-02-10,-121.92,403.61
7877,59529922,2023-02-10,-156.22,247.39000000000004
1814,59529922,2023-02-13,-102.31,145.08000000000004
8043,59529922,2023-02-14,89.67,234.75000000000006
1660,59575867,2023-01-31,,576.66
2423,59575867,2023-02-03,5.14,581.8
7350,59575867,2023-02-10,-159.2,422.59999999999997
506,59575867,2023-02-13,103.44,526.04
1661,59591324,2023-01-31,,509.65
6048,59591324,2023-02-05,806.2,1315.85
3896,59591324,2023-02-05,-181.42,1134.43
4794,59591324,2023-02-12,53.98,1188.41
865,59591324,2023-02-13,156.89,1345.3
6871,59591324,2023-02-13,135.45,1480.75
1662,59640238,2023-01-31,,993.42
5875,59640238,2023-02-05,129.51,1122.9299999999998
6624,59640238,2023-02-08,-185.22,937.7099999999999
2893,59640238,2023-02-09,-127.23,810.4799999999999
7124,59640238,2023-02-11,137.43,947.91
1663,59653557,2023-01-31,,649.61
4370,59653557,2023-02-04,-106.46,543.15
1904,59653557,2023-02-06,-37.9,505.25
5111,59653557,2023-02-06,-1524.9,-1019.6500000000001
4922,59653557,2023-02-08,-117.35,-1137.0
1664,59663741,2023-01-31,,642.86
48,59663741,2023-02-03,68.43,711.29
2308,59663741,2023-02-05,118.22,829.51
3903,59663741,2023-02-05,113.1,942.61
3430,59663741,2023-02-06,97.36,1039.97
2103,59663741,2023-02-07,-199.41,840.56
8395,59663741,2023-02-09,127.72,968.28
593,59663741,2023-02-10,-51.27,917.01
6884,59663741,2023-02-10,-1484.2,-567.19
576,59663741,2023-02-11,-85.89,-653.08
2631,59663741,2023-02-14,30.0,-623.08
1665,59684752,2023-01-31,,14.43
368,59684752,2023-02-01,-119.45,-105.02000000000001
4825,59684752,2023-02-05,-108.03,-213.05
244,59684752,2023-02-05,-159.46,-372.51
1788,59684752,2023-02-06,-27.93,-400.44
5242,59684752,2023-02-06,-154.3,-554.74
806,59684752,2023-02-08,108.02,-446.72
6512,59684752,2023-02-08,-92.84,-539.5600000000001
1064,59684752,2023-02-09,-108.23,-647.79
6891,59684752,2023-02-12,-130.68,-778.47
1662,59684752,2023-02-13,2359.1,1580.6299999999999
1666,59705091,2023-01-31,,631.05
8396,59705091,2023-02-02,1091.2,1722.25
540,59705091,2023-02-04,-46.93,1675.32
8594,59705091,2023-02-04,-102.22,1573.1
2316,59705091,2023-02-07,111.37,1684.47
345,59705091,2023-02-08,62.19,1746.66
8457,59705091,2023-02-08,53.32,1799.98
6183,59705091,2023-02-11,-1677.5,122.48000000000002
4216,59705091,2023-02-13,-73.31,49.170000000000016
1667,59737910,2023-01-31,,523.19
6835,59737910,2023-02-03,99.14,622.33
6632,59737910,2023-02-09,132.58,754.9100000000001
6603,59737910,2023-02-11,80.51,835.4200000000001
5220,59737910,2023-02-11,-139.86,695.5600000000001
1668,59855808,2023-01-31,,172.54
1956,59855808,2023-02-02,-157.41,15.129999999999995
750,59855808,2023-02-05,100.23,115.36
6993,59855808,2023-02-06,-204.86,-89.50000000000001
4771,59855808,2023-02-09,53.95,-35.55000000000001
5497,59855808,2023-02-10,-905.0,-940.55
4291,59855808,2023-02-12,-58.39,-998.9399999999999
8324,59855808,2023-02-13,1397.6,398.65999999999997
871,59855808,2023-02-14,-179.57,219.08999999999997
1669,59867000,2023-01-31,,62.01
1911,59867000,2023-02-02,116.89,178.9
2650,59867000,2023-02-06,110.54,289.44
3024,59867000,2023-02-08,-36.78,252.66
3345,59867000,2023-02-08,-124.32,128.34
7426,59867000,2023-02-12,-845.0,-716.66
1670,59876714,2023-01-31,,938.46
3277,59876714,2023-02-01,469.6,1408.06
8193,59876714,2023-02-02,132.84,1540.9
2429,59876714,2023-02-07,134.11,1675.01
7605,59876714,2023-02-07,-101.89,1573.1200000000001
6286,59876714,2023-02-11,117.41,1690.53
6577,59876714,2023-02-12,-166.15,1524.38
1646,59876714,2023-02-13,-1535.7,-11.319999999999936
1671,59933973,2023-01-31,,29.98
7901,59933973,2023-02-02,-144.06,-114.08
4597,59933973,2023-02-07,-148.28,-262.36
587,59933973,2023-02-12,65.93,-196.42999999999998
1672,59961433,2023-01-31,,267.05
2080,59961433,2023-02-01,47.33,314.38
1977,59961433,2023-02-01,-177.63,136.75
3480,59961433,2023-02-05,907.1,1043.85
4329,59961433,2023-02-09,-77.09,966.76
476,59961433,2023-02-14,147.72,1114.48
1673,59980709,2023-01-31,,781.42
1208,59980709,2023-02-01,99.56,880.98
7668,59980709,2023-02-03,-8.49,872.49
7855,59980709,2023-02-06,1194.9,2067.3900000000003
1674,59984692,2023-01-31,,818.03
4495,59984692,2023-02-03,-913.8,-95.76999999999998
2218,59984692,2023-02-05,33.96,-61.80999999999998
6550,59984692,2023-02-05,-111.66,-173.46999999999997
5619,59984692,2023-02-05,-175.68,-349.15
349,59984692,2023-02-10,119.92,-229.22999999999996
8561,59984692,2023-02-14,7.29,-221.93999999999997
1675,59989722,2023-01-31,,816.77
3585,59989722,2023-02-07,-853.6,-36.83000000000004
1791,59989722,2023-02-09,-78.22,-115.05000000000004
7839,59989722,2023-02-10,672.0,556.9499999999999
1676,60017511,2023-01-31,,859.48
503,60017511,2023-02-03,41.91,901.39
1982,60017511,2023-02-03,-60.17,841.22
1786,60017511,2023-02-04,1131.3,1972.52
5538,60017511,2023-02-04,-131.11,1841.4099999999999
6568,60017511,2023-02-05,678.7,2520.11
7012,60017511,2023-02-11,1363.6,3883.71
4290,60017511,2023-02-11,56.16,3939.87
2394,60017511,2023-02-13,69.25,4009.12
1677,60114464,2023-01-31,,972.56
8351,60114464,2023-02-03,-43.75,928.81
6918,60114464,2023-02-09,-178.61,750.1999999999999
5787,60114464,2023-02-10,1640.4,2390.6
4972,60114464,2023-02-10,1275.4,3666.0
2079,60114464,2023-02-10,1188.3,4854.3
6452,60114464,2023-02-11,-1777.8,3076.5
4010,60114464,2023-02-13,-153.62,2922.88
1678,60138058,2023-01-31,,686.46
522,60138058,2023-02-03,113.46,799.9200000000001
7509,60138058,2023-02-04,59.13,859.0500000000001
4507,60138058,2023-02-07,149.99,1009.0400000000001
2532,60138058,2023-02-08,14.01,1023.0500000000001
8504,60138058,2023-02-09,45.0,1068.05
2231,60138058,2023-02-09,-110.11,957.94
5491,60138058,2023-02-10,-97.78,860.1600000000001
4345,60138058,2023-02-10,-1526.7,-666.54
1679,60184250,2023-01-31,,70.89
7908,60184250,2023-02-03,-146.39,-75.49999999999999
5281,60184250,2023-02-04,106.07,30.570000000000007
3991,60184250,2023-02-05,1526.1,1556.6699999999998
2899,60184250,2023-02-06,80.07,1636.7399999999998
6704,60184250,2023-02-09,-73.11,1563.6299999999999
1386,60184250,2023-02-11,-43.44,1520.1899999999998
6646,60184250,2023-02-14,-114.54,1405.6499999999999
1680,60189055,2023-01-31,,814.54
501,60189055,2023-02-02,71.52,886.06
2619,60189055,2023-02-04,-629.0,257.05999999999995
5262,60189055,2023-02-05,-62.74,194.31999999999994
3878,60189055,2023-02-08,136.06,330.37999999999994
6939,60189055,2023-02-10,160.72,491.0999999999999
7461,60189055,2023-02-12,129.45,620.55
1681,60193174,2023-01-31,,740.53
3732,60193174,2023-02-02,1327.5,2068.0299999999997
8332,60193174,2023-02-04,-108.21,1959.82
1580,60193174,2023-02-04,-204.89,1754.93
3919,60193174,2023-02-05,-27.15,1727.78
4506,60193174,2023-02-10,101.72,1829.5
3981,60193174,2023-02-10,68.91,1898.41
49,60193174,2023-02-12,-127.05,1771.36
5407,60193174,2023-02-13,51.71,1823.07
1682,60202402,2023-01-31,,783.7
2696,60202402,2023-02-03,-18.28,765.4200000000001
1161,60202402,2023-02-05,-963.3,-197.87999999999988
2800,60202402,2023-02-12,82.91,-114.96999999999989
7595,60202402,2023-02-12,-89.48,-204.44999999999987
5873,60202402,2023-02-12,-89.55,-293.9999999999999
2092,60202402,2023-02-13,789.4,495.4000000000001
1683,60220702,2023-01-31,,937.23
4020,60220702,2023-02-03,-37.49,899.74
6295,60220702,2023-02-05,-102.96,796.78
7719,60220702,2023-02-07,98.61,895.39
3703,60220702,2023-02-10,-76.48,818.9100000000001
4603,60220702,2023-02-12,-128.94,689.97
1684,60222199,2023-01-31,,350.4
7177,60222199,2023-02-08,537.9,888.3
673,60222199,2023-02-11,83.49,971.79
796,60222199,2023-02-12,-893.8,77.99000000000001
1685,60238192,2023-01-31,,307.97
526,60238192,2023-02-02,120.45,428.42
3664,60238192,2023-02-03,-95.05,333.37
4472,60238192,2023-02-05,-62.49,270.88000000000005
5531,60238192,2023-02-12,202.22,473.1
7588,60238192,2023-02-13,-8.94,464.16
2223,60238192,2023-02-14,69.61,533.77
229,60238192,2023-02-14,58.12,591.89
1686,60367416,2023-01-31,,754.86
732,60367416,2023-02-03,-164.14,590.72
8183,60367416,2023-02-04,-96.78,493.94000000000005
2338,60367416,2023-02-05,154.98,648.9200000000001
4584,60367416,2023-02-07,-104.75,544.1700000000001
5696,60367416,2023-02-10,76.15,620.32
6701,60367416,2023-02-10,4.42,624.74
4542,60367416,2023-02-11,165.41,790.15
5916,60367416,2023-02-11,51.94,842.09
1687,60371134,2023-01-31,,444.57
7026,60371134,2023-02-04,125.07,569.64
7801,60371134,2023-02-07,93.89,663.53
5760,60371134,2023-02-14,-95.91,567.62
1688,60383549,2023-01-31,,268.15
5443,60383549,2023-02-01,38.67,306.82
5231,60383549,2023-02-06,141.54,448.35999999999996
6704,60383549,2023-02-09,73.11,521.4699999999999
2622,60383549,2023-02-14,131.83,653.3
1689,60417212,2023-01-31,,653.31
8281,60417212,2023-02-01,-69.4,583.91
771,60417212,2023-02-01,-974.4,-390.49
7653,60417212,2023-02-04,-117.96,-508.45
9,60417212,2023-02-05,471.4,-37.05000000000001
6243,60417212,2023-02-07,-26.93,-63.98000000000001
888,60417212,2023-02-09,-9.69,-73.67000000000002
6251,60417212,2023-02-10,-98.96,-172.63
2984,60417212,2023-02-11,134.17,-38.460000000000036
7028,60417212,2023-02-11,104.89,66.42999999999996
2586,60417212,2023-02-12,82.59,149.01999999999998
6007,60417212,2023-02-13,-145.9,3.1199999999999477
162,60417212,2023-02-14,-151.47,-148.35000000000005
1690,60459342,2023-01-31,,734.15
4796,60459342,2023-02-02,-108.85,625.3
1340,60459342,2023-02-03,-36.57,588.73
4325,60459342,2023-02-07,103.43,692.16
813,60459342,2023-02-07,77.09,769.25
7979,60459342,2023-02-10,-145.86,623.39
2984,60459342,2023-02-11,-134.17,489.22
7884,60459342,2023-02-12,-134.05,355.16999999999996
3116,60459342,2023-02-13,-30.31,324.86
1691,60522190,2023-01-31,,965.46
4469,60522190,2023-02-02,51.61,1017.07
3742,60522190,2023-02-08,1589.0,2606.07
6200,60522190,2023-02-10,-61.2,2544.8700000000003
1692,60659147,2023-01-31,,323.85
3053,60659147,2023-02-01,-140.1,183.75000000000003
7440,60659147,2023-02-03,-136.92,46.83000000000004
3710,60659147,2023-02-06,98.87,145.70000000000005
6612,60659147,2023-02-10,103.49,249.19000000000005
1461,60659147,2023-02-11,-99.35,149.84000000000003
508,60659147,2023-02-13,14.32,164.16000000000005
2828,60659147,2023-02-13,-72.13,92.03000000000006
1693,60667043,2023-01-31,,937.62
1991,60667043,2023-02-03,-19.83,917.79
6674,60667043,2023-02-04,-165.76,752.03
1159,60667043,2023-02-04,-861.1,-109.06999999999994
5932,60667043,2023-02-06,-308.7,-417.7699999999999
211,60667043,2023-02-09,96.08,-321.68999999999994
1512,60667043,2023-02-09,88.81,-232.87999999999994
6691,60667043,2023-02-09,-148.39,-381.2699999999999
3009,60667043,2023-02-11,-1199.0,-1580.27
3551,60667043,2023-02-14,122.9,-1457.37
1694,60684197,2023-01-31,,752.92
6564,60684197,2023-02-03,-179.13,573.79
7370,60684197,2023-02-04,140.43,714.22
7700,60684197,2023-02-06,76.95,791.17
7532,60684197,2023-02-11,60.22,851.39
3508,60684197,2023-02-12,-41.59,809.8
1695,60707792,2023-01-31,,220.35
8106,60707792,2023-02-01,122.51,342.86
4627,60707792,2023-02-01,-126.01,216.85
5592,60707792,2023-02-05,99.42,316.27
1761,60707792,2023-02-06,-154.81,161.45999999999998
6533,60707792,2023-02-14,-56.24,105.21999999999997
7983,60707792,2023-02-14,-159.73,-54.51000000000002
1696,60711202,2023-01-31,,869.92
8517,60711202,2023-02-03,-165.39,704.53
4379,60711202,2023-02-07,-260.82,443.71
855,60711202,2023-02-08,-191.64,252.07
650,60711202,2023-02-14,93.66,345.73
1697,60730902,2023-01-31,,243.72
6453,60730902,2023-02-01,-17.61,226.11
6507,60730902,2023-02-02,-85.17,140.94
1176,60730902,2023-02-03,-13.52,127.42
2438,60730902,2023-02-03,-56.31,71.11
4756,60730902,2023-02-03,-67.03,4.079999999999998
7066,60730902,2023-02-06,-44.47,-40.39
5830,60730902,2023-02-10,192.26,151.87
7275,60730902,2023-02-10,-88.33,63.540000000000006
8252,60730902,2023-02-12,-95.07,-31.529999999999987
1698,60751083,2023-01-31,,115.23
6517,60751083,2023-02-04,-129.92,-14.689999999999984
411,60751083,2023-02-05,129.71,115.02000000000002
4165,60751083,2023-02-05,-23.88,91.14000000000003
6274,60751083,2023-02-07,85.77,176.91000000000003
4449,60751083,2023-02-08,782.7,959.6100000000001
7996,60751083,2023-02-09,96.28,1055.89
8385,60751083,2023-02-10,123.72,1179.6100000000001
1699,60755797,2023-01-31,,207.78
7946,60755797,2023-02-03,-164.56,43.22
8083,60755797,2023-02-07,93.07,136.29
4113,60755797,2023-02-08,-33.32,102.97
2989,60755797,2023-02-12,-16.56,86.41
5408,60755797,2023-02-13,1856.7,1943.1100000000001
7417,60755797,2023-02-14,-64.87,1878.2400000000002
1700,60789634,2023-01-31,,379.4
5112,60789634,2023-02-03,174.25,553.65
6928,60789634,2023-02-05,116.03,669.68
1578,60789634,2023-02-05,65.25,734.93
2943,60789634,2023-02-09,161.02,895.95
1284,60789634,2023-02-12,146.05,1042.0
3105,60789634,2023-02-12,-49.38,992.62
2620,60789634,2023-02-12,-140.82,851.8
8686,60789634,2023-02-13,-78.14,773.66
1701,60819695,2023-01-31,,38.96
2875,60819695,2023-02-03,92.73,131.69
5311,60819695,2023-02-04,-121.97,9.720000000000013
1388,60819695,2023-02-04,-207.89,-198.16999999999996
835,60819695,2023-02-09,-96.94,-295.10999999999996
610,60819695,2023-02-11,88.2,-206.90999999999997
1864,60819695,2023-02-14,111.2,-95.70999999999995
1702,60860851,2023-01-31,,17.96
2206,60860851,2023-02-02,-15.19,2.7700000000000014
3592,60860851,2023-02-04,-142.92,-140.14999999999998
895,60860851,2023-02-07,-1372.5,-1512.65
2886,60860851,2023-02-10,194.97,-1317.68
1712,60860851,2023-02-10,-114.32,-1432.0
2143,60860851,2023-02-10,-152.92,-1584.92
1703,60866500,2023-01-31,,523.13
8190,60866500,2023-02-03,-77.14,445.99
6928,60866500,2023-02-05,-116.03,329.96
5742,60866500,2023-02-06,68.31,398.27
3052,60866500,2023-02-09,-125.74,272.53
4359,60866500,2023-02-11,156.49,429.02
2667,60866500,2023-02-11,-79.43,349.59000000000003
1704,60916657,2023-01-31,,893.41
2492,60916657,2023-02-03,117.51,1010.92
6324,60916657,2023-02-05,-76.57,934.35
6751,60916657,2023-02-06,-56.09,878.26
6073,60916657,2023-02-11,71.24,949.5
1947,60916657,2023-02-12,50.94,1000.4399999999999
1705,60930856,2023-01-31,,445.07
6169,60930856,2023-02-03,-46.85,398.21999999999997
2661,60930856,2023-02-04,-131.69,266.53
3390,60930856,2023-02-07,-52.98,213.55
6576,60930856,2023-02-12,123.5,337.05
1033,60930856,2023-02-12,68.26,405.31
5542,60930856,2023-02-14,64.87,470.18
1706,60955647,2023-01-31,,546.28
2172,60955647,2023-02-11,34.52,580.8
4389,60955647,2023-02-14,126.46,707.26
1707,60966485,2023-01-31,,774.41
3097,60966485,2023-02-01,63.28,837.6899999999999
1752,60966485,2023-02-01,-116.0,721.6899999999999
5831,60966485,2023-02-04,187.19,908.88
4935,60966485,2023-02-05,-151.29,757.5899999999999
5154,60966485,2023-02-06,-193.24,564.3499999999999
379,60966485,2023-02-07,-56.84,507.51
5451,60966485,2023-02-10,-155.39,352.12
3234,60966485,2023-02-12,57.89,410.01
1038,60966485,2023-02-14,149.95,559.96
1708,60996794,2023-01-31,,27.98
6420,60996794,2023-02-04,63.46,91.44
3363,60996794,2023-02-08,-903.3,-811.8599999999999
2959,60996794,2023-02-11,-66.62,-878.4799999999999
7836,60996794,2023-02-13,-1525.2,-2403.68
1709,61087394,2023-01-31,,112.81
6024,61087394,2023-02-01,121.69,234.5
5914,61087394,2023-02-07,156.4,390.9
5982,61087394,2023-02-07,-38.29,352.61
3808,61087394,2023-02-08,-1621.0,-1268.3899999999999
85,61087394,2023-02-12,-52.46,-1320.85
3054,61087394,2023-02-13,-101.58,-1422.4299999999998
7793,61087394,2023-02-13,-105.17,-1527.6
3218,61087394,2023-02-14,-1879.5,-3407.1
1710,61101757,2023-01-31,,992.2
1711,61152319,2023-01-31,,471.31
6002,61152319,2023-02-01,-75.45,395.86
4740,61152319,2023-02-04,-82.25,313.61
3990,61152319,2023-02-07,61.01,374.62
3011,61152319,2023-02-08,57.93,432.55
2885,61152319,2023-02-13,-79.81,352.74
1712,61178950,2023-01-31,,104.88
259,61178950,2023-02-04,79.62,184.5
2278,61178950,2023-02-09,-95.74,88.76
8606,61178950,2023-02-10,150.39,239.14999999999998
2517,61178950,2023-02-13,-1023.0,-783.85
7926,61178950,2023-02-14,-685.5,-1469.35
1713,61181609,2023-01-31,,44.55
5509,61181609,2023-02-01,-146.28,-101.73
8078,61181609,2023-02-03,-321.6,-423.33000000000004
4003,61181609,2023-02-04,-114.54,-537.87
5387,61181609,2023-02-09,-80.63,-618.5
5314,61181609,2023-02-11,-106.62,-725.12
8138,61181609,2023-02-12,-108.99,-834.11
2282,61181609,2023-02-14,-89.9,-924.01
1714,61279456,2023-01-31,,814.3
4587,61279456,2023-02-02,-93.31,720.99
7005,61279456,2023-02-04,133.05,854.04
2193,61279456,2023-02-04,-72.97,781.0699999999999
1304,61279456,2023-02-06,-22.45,758.62
3561,61279456,2023-02-09,-180.82,577.8
4212,61279456,2023-02-11,-94.12,483.67999999999995
3294,61279456,2023-02-12,134.18,617.86
5089,61279456,2023-02-12,-56.08,561.78
5060,61279456,2023-02-12,-81.44,480.34
8578,61279456,2023-02-13,-116.67,363.66999999999996
4955,61279456,2023-02-13,-1406.7,-1043.0300000000002
1715,61419726,2023-01-31,,932.41
729,61419726,2023-02-02,176.64,1109.05
5034,61419726,2023-02-03,131.74,1240.79
7395,61419726,2023-02-07,-105.53,1135.26
5636,61419726,2023-02-09,-85.81,1049.45
6851,61419726,2023-02-09,-149.64,899.81
7308,61419726,2023-02-10,-213.8,686.01
1716,61423373,2023-01-31,,87.17
3696,61423373,2023-02-09,-411.3,-324.13
4102,61423373,2023-02-10,-655.8,-979.93
90,61423373,2023-02-11,113.52,-866.41
1717,61450849,2023-01-31,,890.19
5227,61450849,2023-02-01,-646.2,243.99
3304,61450849,2023-02-02,-6.47,237.52
4873,61450849,2023-02-04,-121.04,116.48
7255,61450849,2023-02-06,-133.12,-16.64
3796,61450849,2023-02-07,-54.63,-71.27000000000001
3379,61450849,2023-02-08,94.96,23.689999999999998
2632,61450849,2023-02-08,68.6,92.28999999999999
6474,61450849,2023-02-08,-41.56,50.72999999999999
1718,61493381,2023-01-31,,569.94
6466,61493381,2023-02-01,-12.97,556.97
2521,61493381,2023-02-05,-54.53,502.44000000000005
3262,61493381,2023-02-06,-113.47,388.97
1867,61493381,2023-02-08,-203.33,185.64000000000004
1845,61493381,2023-02-09,-77.58,108.06000000000004
8494,61493381,2023-02-12,-182.63,-74.56999999999995
2188,61493381,2023-02-14,-81.5,-156.06999999999994
1719,61512912,2023-01-31,,328.0
812,61512912,2023-02-08,-138.88,189.12
3985,61512912,2023-02-11,-38.45,150.67000000000002
4542,61512912,2023-02-11,-165.41,-14.740000000000009
1720,61555609,2023-01-31,,505.76
2389,61555609,2023-02-02,-150.57,355.19
6210,61555609,2023-02-03,-90.12,265.07
6842,61555609,2023-02-09,77.33,342.4
7569,61555609,2023-02-13,1503.2,1845.6
1721,61578713,2023-01-31,,209.89
1328,61578713,2023-02-05,88.55,298.44
335,61578713,2023-02-05,34.76,333.2
2370,61578713,2023-02-07,-81.64,251.55999999999997
6868,61578713,2023-02-07,-106.48,145.07999999999998
266,61578713,2023-02-09,-112.05,33.02999999999997
4594,61578713,2023-02-10,-95.62,-62.59000000000003
1722,61582769,2023-01-31,,325.47
4293,61582769,2023-02-02,87.06,412.53000000000003
245,61582769,2023-02-08,69.56,482.09000000000003
2598,61582769,2023-02-11,-124.32,357.77000000000004
1259,61582769,2023-02-13,-123.64,234.13000000000005
7115,61582769,2023-02-14,167.84,401.97
1723,61593392,2023-01-31,,621.21
24,61593392,2023-02-10,-92.09,529.12
1145,61593392,2023-02-11,-41.89,487.23
1724,61634340,2023-01-31,,83.85
8555,61634340,2023-02-01,-148.64,-64.78999999999999
5768,61634340,2023-02-03,-60.33,-125.11999999999999
1852,61634340,2023-02-04,-238.96,-364.08
5219,61634340,2023-02-07,-109.13,-473.21000000000004
6461,61634340,2023-02-12,-94.0,-567.21
4236,61634340,2023-02-13,-70.25,-637.46
1725,61642813,2023-01-31,,760.74
177,61642813,2023-02-02,177.88,938.62
2501,61642813,2023-02-04,-73.67,864.95
5594,61642813,2023-02-10,221.22,1086.17
2366,61642813,2023-02-13,81.39,1167.56
8285,61642813,2023-02-13,-68.67,1098.89
1726,61644310,2023-01-31,,709.97
2046,61644310,2023-02-04,-72.42,637.5500000000001
5434,61644310,2023-02-05,-89.72,547.83
1200,61644310,2023-02-06,-110.71,437.12
8090,61644310,2023-02-08,-106.37,330.75
6595,61644310,2023-02-13,136.4,467.15000000000003
4526,61644310,2023-02-13,87.58,554.73
1727,61649729,2023-01-31,,848.76
2819,61649729,2023-02-03,-26.28,822.48
3846,61649729,2023-02-07,156.28,978.76
858,61649729,2023-02-10,149.53,1128.29
1728,61661386,2023-01-31,,524.42
4176,61661386,2023-02-07,-125.96,398.46
3506,61661386,2023-02-11,-126.05,272.40999999999997
1729,61676204,2023-01-31,,88.85
6666,61676204,2023-02-04,134.22,223.07
5600,61676204,2023-02-04,90.09,313.15999999999997
1349,61676204,2023-02-04,-75.65,237.51
6429,61676204,2023-02-06,-43.35,194.16
4338,61676204,2023-02-07,-7.57,186.58999999999997
2651,61676204,2023-02-09,49.06,235.64999999999998
4716,61676204,2023-02-13,89.3,324.95
1730,61682186,2023-01-31,,959.96
7756,61682186,2023-02-02,154.85,1114.81
5340,61682186,2023-02-10,-26.43,1088.38
4626,61682186,2023-02-10,-99.28,989.1
1066,61682186,2023-02-11,659.5,1648.6
5608,61682186,2023-02-12,-19.98,1628.6200000000001
2550,61682186,2023-02-12,-61.6,1567.02
155,61682186,2023-02-13,1132.5,2699.52
1731,61687835,2023-01-31,,739.0
992,61687835,2023-02-03,147.6,886.6
4628,61687835,2023-02-03,-102.16,784.44
7787,61687835,2023-02-06,-163.9,620.54
7258,61687835,2023-02-06,-561.3,59.24000000000001
5568,61687835,2023-02-08,56.13,115.37
5105,61687835,2023-02-08,9.19,124.56000000000002
602,61687835,2023-02-09,652.0,776.5600000000001
5992,61687835,2023-02-10,-212.1,564.46
4515,61687835,2023-02-11,165.77,730.23
7842,61687835,2023-02-11,142.29,872.5200000000001
5861,61687835,2023-02-12,62.63,935.1500000000001
1732,61720005,2023-01-31,,687.35
1792,61720005,2023-02-02,-49.63,637.72
4689,61720005,2023-02-03,-75.28,562.44
1186,61720005,2023-02-05,72.33,634.77
1774,61720005,2023-02-05,-0.49,634.28
8063,61720005,2023-02-08,-107.47,526.8100000000001
1413,61720005,2023-02-09,105.86,632.6700000000001
1125,61720005,2023-02-10,-204.71,427.96000000000004
6626,61720005,2023-02-12,-50.65,377.31000000000006
6521,61720005,2023-02-13,-38.26,339.05000000000007
1733,61724951,2023-01-31,,656.25
6357,61724951,2023-02-03,33.4,689.65
2412,61724951,2023-02-07,-99.73,589.92
5415,61724951,2023-02-08,-69.75,520.17
260,61724951,2023-02-09,139.86,660.03
811,61724951,2023-02-09,65.77,725.8
5403,61724951,2023-02-10,107.4,833.2
214,61724951,2023-02-12,207.6,1040.8
8362,61724951,2023-02-13,-1127.3,-86.5
1734,61781801,2023-01-31,,699.78
8608,61781801,2023-02-03,71.27,771.05
3423,61781801,2023-02-07,182.27,953.3199999999999
1262,61781801,2023-02-07,-84.97,868.35
1888,61781801,2023-02-08,1428.0,2296.35
2850,61781801,2023-02-08,1051.4,3347.75
7972,61781801,2023-02-09,49.68,3397.43
2188,61781801,2023-02-14,81.5,3478.93
1735,61847987,2023-01-31,,874.22
1349,61847987,2023-02-04,75.65,949.87
3106,61847987,2023-02-06,-86.9,862.97
3720,61847987,2023-02-08,-2017.7,-1154.73
7802,61847987,2023-02-11,-89.18,-1243.91
1267,61847987,2023-02-14,67.85,-1176.06
1736,61860337,2023-01-31,,892.77
1251,61860337,2023-02-05,-97.37,795.4
7997,61860337,2023-02-06,64.67,860.0699999999999
7156,61860337,2023-02-07,-132.98,727.0899999999999
7191,61860337,2023-02-09,-1679.2,-952.1100000000001
5435,61860337,2023-02-11,107.49,-844.6200000000001
3231,61860337,2023-02-12,-102.73,-947.3500000000001
1737,61884944,2023-01-31,,123.93
5139,61884944,2023-02-03,156.2,280.13
1618,61884944,2023-02-03,96.42,376.55
1431,61884944,2023-02-04,189.33,565.88
3524,61884944,2023-02-05,-997.4,-431.52
7968,61884944,2023-02-08,193.89,-237.63
5970,61884944,2023-02-10,-106.29,-343.92
3670,61884944,2023-02-12,985.9,641.98
1047,61884944,2023-02-14,131.36,773.3399999999999
1738,61941956,2023-01-31,,137.19
579,61941956,2023-02-03,-48.48,88.71000000000001
8640,61941956,2023-02-04,-64.48,24.22999999999999
6998,61941956,2023-02-09,52.73,76.95999999999998
6847,61941956,2023-02-09,-181.01,-104.05000000000001
1739,61979134,2023-01-31,,574.77
1648,61979134,2023-02-03,-15.12,559.65
5156,61979134,2023-02-03,-106.43,453.21999999999997
8103,61979134,2023-02-04,-101.39,351.83
1305,61979134,2023-02-09,143.27,495.09999999999997
1740,61999896,2023-01-31,,788.63
2964,61999896,2023-02-05,1475.4,2264.03
904,61999896,2023-02-05,106.71,2370.7400000000002
2120,61999896,2023-02-06,739.3,3110.04
1137,61999896,2023-02-06,-63.49,3046.55
5952,61999896,2023-02-06,-123.77,2922.78
1012,61999896,2023-02-08,51.04,2973.82
1310,61999896,2023-02-11,510.2,3484.0200000000004
4262,61999896,2023-02-11,132.76,3616.78
6906,61999896,2023-02-13,137.58,3754.36
1741,62077439,2023-01-31,,333.47
2339,62077439,2023-02-01,345.3,678.77
3681,62077439,2023-02-05,-166.03,512.74
4720,62077439,2023-02-06,-96.82,415.9200000000001
5029,62077439,2023-02-07,110.79,526.71
51,62077439,2023-02-08,-123.3,403.4100000000001
4150,62077439,2023-02-09,-121.95,281.46000000000004
2442,62077439,2023-02-10,-958.6,-677.14
6144,62077439,2023-02-12,491.6,-185.53999999999996
1742,62141083,2023-01-31,,17.63
1714,62141083,2023-02-02,104.03,121.66
6657,62141083,2023-02-05,168.21,289.87
1385,62141083,2023-02-07,94.93,384.8
5675,62141083,2023-02-11,-46.65,338.15000000000003
8642,62141083,2023-02-13,-113.41,224.74
1743,62147353,2023-01-31,,783.96
463,62147353,2023-02-04,-65.13,718.83
319,62147353,2023-02-10,54.73,773.5600000000001
6838,62147353,2023-02-12,109.65,883.21
4882,62147353,2023-02-12,-31.75,851.46
5744,62147353,2023-02-14,-144.85,706.61
1744,62158499,2023-01-31,,581.72
488,62158499,2023-02-02,89.46,671.1800000000001
3129,62158499,2023-02-04,89.95,761.13
8428,62158499,2023-02-05,-821.8,-60.66999999999996
2969,62158499,2023-02-08,163.95,103.28000000000003
6406,62158499,2023-02-11,-121.47,-18.18999999999997
58,62158499,2023-02-13,104.56,86.37000000000003
4431,62158499,2023-02-13,-17.92,68.45000000000003
5814,62158499,2023-02-13,-901.5,-833.05
1745,62191488,2023-01-31,,652.76
6098,62191488,2023-02-01,115.85,768.61
428,62191488,2023-02-01,-79.2,689.41
279,62191488,2023-02-03,115.62,805.03
5225,62191488,2023-02-08,14.52,819.55
543,62191488,2023-02-09,112.76,932.31
6677,62191488,2023-02-09,-4.38,927.93
1746,62213525,2023-01-31,,45.68
3929,62213525,2023-02-01,948.2,993.88
4232,62213525,2023-02-04,-143.01,850.87
7690,62213525,2023-02-04,-1702.7,-851.83
7453,62213525,2023-02-07,336.2,-515.6300000000001
2452,62213525,2023-02-07,-139.96,-655.59
1818,62213525,2023-02-10,90.86,-564.73
1807,62213525,2023-02-10,-114.59,-679.32
1747,62222306,2023-01-31,,304.45
6742,62222306,2023-02-02,-108.46,195.99
1743,62222306,2023-02-03,-60.47,135.51999999999998
1925,62222306,2023-02-03,-89.93,45.58999999999999
3436,62222306,2023-02-04,-1639.2,-1593.6100000000001
254,62222306,2023-02-10,-9.75,-1603.3600000000001
1748,62227017,2023-01-31,,177.72
5517,62227017,2023-02-02,128.31,306.03
1941,62227017,2023-02-09,-112.93,193.1
2579,62227017,2023-02-13,122.16,315.26
1749,62251465,2023-01-31,,304.55
2214,62251465,2023-02-01,-96.35,208.20000000000002
4997,62251465,2023-02-02,15.44,223.64000000000001
630,62251465,2023-02-06,187.58,411.22
5609,62251465,2023-02-07,37.9,449.12
4391,62251465,2023-02-07,-195.55,253.57000000000002
1645,62251465,2023-02-11,127.25,380.82000000000005
1750,62256127,2023-01-31,,784.39
776,62256127,2023-02-05,-151.27,633.12
95,62256127,2023-02-07,134.55,767.67
3397,62256127,2023-02-09,-137.44,630.23
2300,62256127,2023-02-11,-100.94,529.29
7012,62256127,2023-02-11,-1363.6,-834.31
4687,62256127,2023-02-12,-1491.7,-2326.01
1751,62276269,2023-01-31,,575.1
489,62276269,2023-02-02,-142.26,432.84000000000003
5495,62276269,2023-02-04,-126.83,306.01000000000005
925,62276269,2023-02-08,50.71,356.72
1752,62289297,2023-01-31,,802.44
6703,62289297,2023-02-11,-157.6,644.84
1753,62320219,2023-01-31,,178.4
5851,62320219,2023-02-05,141.51,319.90999999999997
6475,62320219,2023-02-05,112.45,432.36
1541,62320219,2023-02-05,-49.95,382.40999999999997
7402,62320219,2023-02-08,47.37,429.78
1754,62332278,2023-01-31,,970.66
6042,62332278,2023-02-01,119.74,1090.3999999999999
2873,62332278,2023-02-07,-32.06,1058.34
4691,62332278,2023-02-07,-83.68,974.66
1030,62332278,2023-02-10,-145.13,829.53
6577,62332278,2023-02-12,166.15,995.68
5032,62332278,2023-02-12,58.63,1054.31
3399,62332278,2023-02-13,181.54,1235.85
1755,62362650,2023-01-31,,650.79
5010,62362650,2023-02-01,129.83,780.62
1840,62362650,2023-02-01,-466.7,313.91999999999996
7130,62362650,2023-02-05,118.78,432.69999999999993
3336,62362650,2023-02-05,62.8,495.49999999999994
2087,62362650,2023-02-06,-133.3,362.19999999999993
5798,62362650,2023-02-08,191.5,553.6999999999999
2898,62362650,2023-02-08,162.63,716.3299999999999
5147,62362650,2023-02-08,138.18,854.51
651,62362650,2023-02-08,-85.01,769.4999999999999
6503,62362650,2023-02-11,67.06,836.56
4595,62362650,2023-02-11,-114.77,721.79
4459,62362650,2023-02-13,80.64,802.43
1756,62412215,2023-01-31,,766.15
488,62412215,2023-02-02,-89.46,676.6899999999999
1150,62412215,2023-02-03,-89.33,587.36
2609,62412215,2023-02-06,1011.5,1598.8600000000001
4720,62412215,2023-02-06,96.82,1695.68
971,62412215,2023-02-07,-97.95,1597.73
3030,62412215,2023-02-12,1278.9,2876.63
1757,62414886,2023-01-31,,489.04
4998,62414886,2023-02-02,-107.51,381.53000000000003
7342,62414886,2023-02-06,-63.36,318.17
8120,62414886,2023-02-06,-72.35,245.82000000000002
5598,62414886,2023-02-09,-50.28,195.54000000000002
3513,62414886,2023-02-09,-89.43,106.11000000000001
6779,62414886,2023-02-11,-74.36,31.750000000000014
5539,62414886,2023-02-11,-159.77,-128.01999999999998
918,62414886,2023-02-12,-126.93,-254.95000000000002
55,62414886,2023-02-13,-132.93,-387.88
2092,62414886,2023-02-13,-789.4,-1177.28
1758,62470872,2023-01-31,,436.81
1363,62470872,2023-02-03,-81.28,355.53
1724,62470872,2023-02-06,78.94,434.47
7296,62470872,2023-02-11,60.09,494.56
2922,62470872,2023-02-13,101.09,595.65
6531,62470872,2023-02-14,-140.8,454.85
1759,62477219,2023-01-31,,715.67
5199,62477219,2023-02-08,-99.5,616.17
1760,62511159,2023-01-31,,347.79
1548,62511159,2023-02-08,-123.12,224.67000000000002
3520,62511159,2023-02-09,33.68,258.35
3185,62511159,2023-02-10,5.2,263.55
1761,62567104,2023-01-31,,53.95
7456,62567104,2023-02-01,-124.73,-70.78
1706,62567104,2023-02-04,-152.48,-223.26
7302,62567104,2023-02-08,-190.37,-413.63
5439,62567104,2023-02-14,113.47,-300.15999999999997
1762,62580854,2023-01-31,,421.59
1093,62580854,2023-02-05,114.23,535.8199999999999
808,62580854,2023-02-07,-199.97,335.84999999999997
1763,62584374,2023-01-31,,334.08
8593,62584374,2023-02-01,130.11,464.19
7718,62584374,2023-02-05,-101.23,362.96
6259,62584374,2023-02-06,30.38,393.34
4383,62584374,2023-02-12,-518.5,-125.16000000000003
7582,62584374,2023-02-14,-126.17,-251.33000000000004
1764,62671957,2023-01-31,,168.03
5024,62671957,2023-02-01,96.51,264.54
294,62671957,2023-02-07,101.36,365.9
840,62671957,2023-02-07,-126.74,239.16000000000003
3046,62671957,2023-02-08,119.16,358.32
1836,62671957,2023-02-09,58.59,416.91
1400,62671957,2023-02-11,1454.9,1871.8100000000002
1232,62671957,2023-02-12,96.6,1968.41
5666,62671957,2023-02-12,-51.66,1916.7500000000002
1765,62716405,2023-01-31,,531.19
6828,62716405,2023-02-02,84.59,615.7800000000001
4751,62716405,2023-02-03,98.24,714.0200000000001
5936,62716405,2023-02-06,15.22,729.24
4646,62716405,2023-02-14,68.51,797.75
1766,62746004,2023-01-31,,638.36
4386,62746004,2023-02-10,97.09,735.45
7075,62746004,2023-02-11,113.8,849.25
1767,62756075,2023-01-31,,896.87
1468,62756075,2023-02-03,436.5,1333.37
3172,62756075,2023-02-03,10.53,1343.9
1549,62756075,2023-02-05,-61.84,1282.06
7794,62756075,2023-02-06,-11.94,1270.12
4917,62756075,2023-02-08,14.84,1284.96
5640,62756075,2023-02-10,-355.2,929.76
1815,62756075,2023-02-12,196.98,1126.74
7236,62756075,2023-02-13,142.99,1269.73
1768,62780588,2023-01-31,,828.86
4600,62780588,2023-02-03,-534.6,294.26
5788,62780588,2023-02-04,72.53,366.78999999999996
7486,62780588,2023-02-06,62.08,428.87
684,62780588,2023-02-08,106.62,535.49
822,62780588,2023-02-08,41.57,577.06
1055,62780588,2023-02-10,109.89,686.95
1661,62780588,2023-02-11,663.1,1350.05
1317,62780588,2023-02-12,-233.91,1116.1399999999999
1769,62862427,2023-01-31,,545.14
8001,62862427,2023-02-01,-176.41,368.73
316,62862427,2023-02-05,19.27,388.0
3988,62862427,2023-02-06,1069.9,1457.9
5143,62862427,2023-02-06,-70.55,1387.3500000000001
3703,62862427,2023-02-10,76.48,1463.8300000000002
5643,62862427,2023-02-11,89.55,1553.38
4704,62862427,2023-02-11,-101.6,1451.7800000000002
3759,62862427,2023-02-13,1756.0,3207.78
3830,62862427,2023-02-14,-76.49,3131.2900000000004
1770,63014981,2023-01-31,,222.98
8668,63014981,2023-02-05,-42.25,180.73
5489,63014981,2023-02-09,-26.32,154.41
6281,63014981,2023-02-09,-132.48,21.930000000000007
1771,63057168,2023-01-31,,159.71
5015,63057168,2023-02-02,104.5,264.21000000000004
1971,63057168,2023-02-09,-16.12,248.09
430,63057168,2023-02-10,142.78,390.87
8573,63057168,2023-02-10,-92.49,298.38
1772,63102647,2023-01-31,,665.14
1808,63102647,2023-02-01,77.81,742.95
1484,63102647,2023-02-04,76.44,819.39
5807,63102647,2023-02-04,-109.76,709.63
5582,63102647,2023-02-07,113.01,822.64
5447,63102647,2023-02-07,79.0,901.64
2873,63102647,2023-02-07,32.06,933.7
4819,63102647,2023-02-07,-20.07,913.63
6817,63102647,2023-02-09,58.71,972.34
4964,63102647,2023-02-09,-124.1,848.24
5761,63102647,2023-02-11,158.35,1006.5899999999999
3383,63102647,2023-02-11,-152.0,854.5899999999999
1773,63232279,2023-01-31,,931.78
3166,63232279,2023-02-01,118.27,1050.05
6807,63232279,2023-02-02,129.83,1179.88
6875,63232279,2023-02-02,-159.22,1020.66
4202,63232279,2023-02-03,640.4,1661.06
4334,63232279,2023-02-03,-2285.6,-624.54
5924,63232279,2023-02-07,-146.5,-771.04
6887,63232279,2023-02-08,56.83,-714.2099999999999
7431,63232279,2023-02-09,-125.05,-839.26
1180,63232279,2023-02-11,125.55,-713.7099999999999
1910,63232279,2023-02-11,-36.36,-750.0699999999999
1774,63265361,2023-01-31,,935.22
5243,63265361,2023-02-02,-884.3,50.92000000000007
6036,63265361,2023-02-03,96.77,147.69000000000005
591,63265361,2023-02-05,949.6,1097.29
4869,63265361,2023-02-07,-135.72,961.57
3163,63265361,2023-02-08,-132.99,828.58
5817,63265361,2023-02-10,29.92,858.5000000000001
8070,63265361,2023-02-12,136.93,995.4300000000001
1775,63280767,2023-01-31,,836.58
1318,63280767,2023-02-02,58.65,895.23
8351,63280767,2023-02-03,43.75,938.98
3616,63280767,2023-02-05,-159.79,779.19
2265,63280767,2023-02-07,-852.6,-73.40999999999997
8157,63280767,2023-02-10,79.87,6.460000000000036
1553,63280767,2023-02-14,66.56,73.02000000000004
1776,63298193,2023-01-31,,259.55
1396,63298193,2023-02-08,1374.1,1633.6499999999999
5384,63298193,2023-02-08,1360.9,2994.55
2065,63298193,2023-02-11,45.02,3039.57
1216,63298193,2023-02-12,1111.4,4150.97
1777,63301094,2023-01-31,,532.03
3717,63301094,2023-02-03,-159.23,372.79999999999995
6980,63301094,2023-02-04,25.82,398.62
4755,63301094,2023-02-06,1204.5,1603.12
2266,63301094,2023-02-07,-93.91,1509.2099999999998
8292,63301094,2023-02-10,116.53,1625.7399999999998
3185,63301094,2023-02-10,-5.2,1620.54
2190,63301094,2023-02-11,-130.33,1490.2099999999998
1778,63381038,2023-01-31,,541.91
2271,63381038,2023-02-08,69.06,610.97
7315,63381038,2023-02-13,151.93,762.9
1779,63405199,2023-01-31,,18.35
7460,63405199,2023-02-07,102.26,120.61000000000001
1601,63405199,2023-02-07,-178.2,-57.589999999999975
8279,63405199,2023-02-07,-229.29,-286.88
5174,63405199,2023-02-09,226.54,-60.339999999999975
5182,63405199,2023-02-11,75.1,14.76000000000002
5136,63405199,2023-02-14,-18.62,-3.8599999999999817
6687,63405199,2023-02-14,-71.12,-74.97999999999999
1780,63412767,2023-01-31,,715.41
1800,63412767,2023-02-03,-18.62,696.79
2113,63412767,2023-02-03,-87.36,609.43
2785,63412767,2023-02-03,-153.0,456.42999999999995
7915,63412767,2023-02-05,62.56,518.99
353,63412767,2023-02-05,-53.81,465.17999999999995
658,63412767,2023-02-05,-146.21,318.9699999999999
5552,63412767,2023-02-09,128.5,447.4699999999999
4683,63412767,2023-02-11,54.29,501.75999999999993
1425,63412767,2023-02-13,-99.37,402.38999999999993
1781,63486424,2023-01-31,,531.83
8570,63486424,2023-02-04,-0.23,531.6
3938,63486424,2023-02-05,167.77,699.3700000000001
1952,63486424,2023-02-07,92.8,792.1700000000001
5641,63486424,2023-02-10,-55.17,737.0
4282,63486424,2023-02-12,-1224.6,-487.5999999999999
1782,63534397,2023-01-31,,451.25
6061,63534397,2023-02-03,-590.1,-138.85000000000002
7530,63534397,2023-02-06,109.59,-29.26000000000002
3396,63534397,2023-02-07,87.03,57.76999999999998
5185,63534397,2023-02-11,-873.9,-816.13
1783,63556863,2023-01-31,,634.4
2743,63556863,2023-02-01,-0.5,633.9
5051,63556863,2023-02-02,-102.25,531.65
1347,63556863,2023-02-03,130.91,662.56
2826,63556863,2023-02-05,-125.17,537.39
3620,63556863,2023-02-06,1124.1,1661.4899999999998
2243,63556863,2023-02-06,-104.85,1556.6399999999999
7593,63556863,2023-02-08,1127.4,2684.04
4001,63556863,2023-02-09,83.38,2767.42
6995,63556863,2023-02-09,60.16,2827.58
1435,63556863,2023-02-11,-213.76,2613.82
1784,63569270,2023-01-31,,949.8
6717,63569270,2023-02-07,-120.5,829.3
1688,63569270,2023-02-10,30.02,859.3199999999999
4726,63569270,2023-02-11,-1231.3,-371.98
1785,63635633,2023-01-31,,202.35
203,63635633,2023-02-07,123.36,325.71
1535,63635633,2023-02-09,109.51,435.22
2379,63635633,2023-02-10,-60.41,374.81
5132,63635633,2023-02-13,-74.51,300.3
1786,63714888,2023-01-31,,632.75
4783,63714888,2023-02-01,77.55,710.3
4790,63714888,2023-02-04,-109.43,600.87
4840,63714888,2023-02-04,-523.6,77.26999999999998
728,63714888,2023-02-11,174.19,251.45999999999998
7916,63714888,2023-02-12,-207.81,43.64999999999998
2298,63714888,2023-02-12,-1143.7,-1100.0500000000002
194,63714888,2023-02-13,44.57,-1055.48
5001,63714888,2023-02-14,-80.39,-1135.87
1787,63746530,2023-01-31,,874.63
7817,63746530,2023-02-05,986.7,1861.33
4396,63746530,2023-02-06,-57.25,1804.08
7309,63746530,2023-02-07,764.7,2568.78
5561,63746530,2023-02-09,1705.6,4274.38
4065,63746530,2023-02-09,-116.81,4157.57
7871,63746530,2023-02-12,94.08,4251.650000000001
7826,63746530,2023-02-12,-151.29,4100.360000000001
4156,63746530,2023-02-14,150.33,4250.6900000000005
1788,63845700,2023-01-31,,856.95
7951,63845700,2023-02-02,-184.44,672.51
4031,63845700,2023-02-04,-168.29,504.22
3201,63845700,2023-02-06,-59.16,445.06000000000006
1351,63845700,2023-02-09,1606.6,2051.66
3506,63845700,2023-02-11,126.05,2177.71
1023,63845700,2023-02-12,75.56,2253.27
1789,63863096,2023-01-31,,819.23
462,63863096,2023-02-05,-148.09,671.14
5078,63863096,2023-02-08,167.77,838.9100000000001
4512,63863096,2023-02-08,-72.17,766.74
1790,63959769,2023-01-31,,938.58
5,63959769,2023-02-03,112.46,1051.04
5596,63959769,2023-02-08,-147.81,903.23
3511,63959769,2023-02-09,48.6,951.83
4500,63959769,2023-02-10,54.78,1006.61
8280,63959769,2023-02-12,-541.9,464.71000000000004
1791,63977699,2023-01-31,,140.44
1424,63977699,2023-02-08,-156.53,-16.090000000000003
6092,63977699,2023-02-10,-60.14,-76.23
7768,63977699,2023-02-11,207.88,131.64999999999998
6314,63977699,2023-02-11,90.03,221.67999999999998
1792,64034275,2023-01-31,,609.61
5626,64034275,2023-02-01,42.27,651.88
4784,64034275,2023-02-01,-55.09,596.79
7471,64034275,2023-02-01,-71.89,524.9
432,64034275,2023-02-10,-84.47,440.43
263,64034275,2023-02-11,135.48,575.91
3877,64034275,2023-02-11,99.93,675.84
4570,64034275,2023-02-12,69.44,745.28
6901,64034275,2023-02-12,66.35,811.63
1793,64065043,2023-01-31,,245.44
2433,64065043,2023-02-06,78.47,323.90999999999997
3160,64065043,2023-02-06,67.45,391.36
4594,64065043,2023-02-10,95.62,486.98
170,64065043,2023-02-13,1619.8,2106.7799999999997
5948,64065043,2023-02-13,47.82,2154.6
1794,64093529,2023-01-31,,748.57
3518,64093529,2023-02-02,131.15,879.72
5493,64093529,2023-02-03,151.73,1031.45
6593,64093529,2023-02-08,155.62,1187.0700000000002
6093,64093529,2023-02-10,93.29,1280.3600000000001
1795,64108699,2023-01-31,,71.97
5511,64108699,2023-02-02,-50.83,21.14
6207,64108699,2023-02-02,-190.87,-169.73000000000002
1734,64108699,2023-02-07,-116.74,-286.47
6216,64108699,2023-02-08,120.11,-166.36
1403,64108699,2023-02-08,-83.5,-249.86
447,64108699,2023-02-09,-34.17,-284.03000000000003
3558,64108699,2023-02-10,111.68,-172.35000000000002
4896,64108699,2023-02-10,-202.69,-375.04
487,64108699,2023-02-14,241.71,-133.33
1796,64123632,2023-01-31,,358.39
936,64123632,2023-02-03,131.87,490.26
7019,64123632,2023-02-06,54.05,544.31
3122,64123632,2023-02-07,993.9,1538.21
4636,64123632,2023-02-07,24.34,1562.55
6604,64123632,2023-02-10,-193.16,1369.3899999999999
1361,64123632,2023-02-12,85.39,1454.78
1797,64160490,2023-01-31,,222.89
7925,64160490,2023-02-02,115.12,338.01
5088,64160490,2023-02-03,146.33,484.34000000000003
1343,64160490,2023-02-03,-228.59,255.75
6850,64160490,2023-02-05,-62.88,192.87
7337,64160490,2023-02-09,-74.87,118.0
7259,64160490,2023-02-10,11.9,129.9
2073,64160490,2023-02-12,18.96,148.86
7017,64160490,2023-02-13,-133.53,15.329999999999984
6675,64160490,2023-02-13,-162.92,-147.59
4859,64160490,2023-02-14,173.88,26.289999999999992
5731,64160490,2023-02-14,85.5,111.78999999999999
8294,64160490,2023-02-14,-122.9,-11.110000000000014
1798,64167315,2023-01-31,,145.11
6367,64167315,2023-02-05,69.19,214.3
1212,64167315,2023-02-06,99.27,313.57
1042,64167315,2023-02-13,59.69,373.26
1175,64167315,2023-02-14,-165.55,207.70999999999998
1799,64168292,2023-01-31,,297.09
994,64168292,2023-02-03,111.84,408.92999999999995
6668,64168292,2023-02-03,-129.36,279.56999999999994
4323,64168292,2023-02-04,101.49,381.05999999999995
388,64168292,2023-02-06,-59.58,321.47999999999996
6350,64168292,2023-02-08,132.61,454.09
6019,64168292,2023-02-08,-164.35,289.74
8254,64168292,2023-02-10,25.17,314.90999999999997
5892,64168292,2023-02-10,-182.87,132.03999999999996
377,64168292,2023-02-13,169.97,302.01
2992,64168292,2023-02-14,1323.7,1625.71
1800,64177019,2023-01-31,,298.31
585,64177019,2023-02-04,-76.94,221.37
2354,64177019,2023-02-05,-17.88,203.49
5574,64177019,2023-02-06,-89.28,114.21000000000001
4604,64177019,2023-02-09,101.53,215.74
6151,64177019,2023-02-10,116.06,331.8
2915,64177019,2023-02-10,-101.58,230.22000000000003
1801,64226824,2023-01-31,,794.79
4623,64226824,2023-02-05,-112.69,682.0999999999999
7028,64226824,2023-02-11,-104.89,577.2099999999999
1802,64228624,2023-01-31,,508.14
1031,64228624,2023-02-02,-150.88,357.26
3791,64228624,2023-02-04,126.18,483.44
5527,64228624,2023-02-05,110.97,594.41
4608,64228624,2023-02-09,-85.88,508.53
4395,64228624,2023-02-10,93.74,602.27
8073,64228624,2023-02-10,-110.41,491.86
3885,64228624,2023-02-12,1153.9,1645.7600000000002
1803,64237458,2023-01-31,,255.48
8451,64237458,2023-02-01,-75.62,179.85999999999999
5721,64237458,2023-02-02,-55.08,124.77999999999999
7638,64237458,2023-02-05,1295.5,1420.28
3068,64237458,2023-02-05,103.17,1523.45
2937,64237458,2023-02-06,55.36,1578.81
63,64237458,2023-02-06,-178.82,1399.99
4503,64237458,2023-02-09,-158.77,1241.22
6588,64237458,2023-02-10,59.81,1301.03
7839,64237458,2023-02-10,-672.0,629.03
2776,64237458,2023-02-11,2.2,631.23
1542,64237458,2023-02-12,133.51,764.74
3197,64237458,2023-02-12,-69.4,695.3399999999999
4719,64237458,2023-02-14,105.98,801.3199999999999
1804,64299012,2023-01-31,,509.56
3333,64299012,2023-02-01,128.83,638.39
4108,64299012,2023-02-05,90.59,728.98
6219,64299012,2023-02-06,-47.53,681.45
6935,64299012,2023-02-08,129.37,810.82
6074,64299012,2023-02-10,-20.93,789.89
7209,64299012,2023-02-12,-114.77,675.12
6655,64299012,2023-02-14,146.71,821.83
2747,64299012,2023-02-14,-2620.1,-1798.27
1805,64300289,2023-01-31,,472.59
6413,64300289,2023-02-02,-118.23,354.35999999999996
5292,64300289,2023-02-05,29.05,383.40999999999997
8356,64300289,2023-02-06,-78.61,304.79999999999995
305,64300289,2023-02-09,168.03,472.83
2163,64300289,2023-02-10,-108.85,363.98
4949,64300289,2023-02-12,-66.55,297.43
4654,64300289,2023-02-12,-73.94,223.49
1806,64303157,2023-01-31,,698.38
8101,64303157,2023-02-01,-9.32,689.06
5876,64303157,2023-02-06,-128.12,560.94
3540,64303157,2023-02-07,96.55,657.49
842,64303157,2023-02-08,1737.4,2394.8900000000003
1807,64305805,2023-01-31,,181.46
6771,64305805,2023-02-01,126.64,308.1
7697,64305805,2023-02-04,-1649.2,-1341.1
1916,64305805,2023-02-05,-100.57,-1441.67
1644,64305805,2023-02-07,-153.3,-1594.9700000000003
7943,64305805,2023-02-11,102.91,-1492.0600000000002
8431,64305805,2023-02-13,-73.97,-1566.0300000000002
1808,64331821,2023-01-31,,519.62
1455,64331821,2023-02-05,-145.08,374.53999999999996
5368,64331821,2023-02-07,16.72,391.26
8247,64331821,2023-02-09,897.0,1288.26
4724,64331821,2023-02-11,-104.39,1183.87
1866,64331821,2023-02-11,-148.32,1035.55
3841,64331821,2023-02-14,479.9,1515.45
1809,64402841,2023-01-31,,751.76
4732,64402841,2023-02-01,-61.08,690.68
5011,64402841,2023-02-05,109.7,800.38
3634,64402841,2023-02-07,-133.09,667.29
1531,64402841,2023-02-11,93.58,760.87
5616,64402841,2023-02-12,-1411.1,-650.2299999999999
4074,64402841,2023-02-13,52.19,-598.04
1810,64411319,2023-01-31,,619.06
5876,64411319,2023-02-06,128.12,747.18
1986,64411319,2023-02-08,-128.28,618.9
7274,64411319,2023-02-10,-58.75,560.15
6700,64411319,2023-02-11,124.56,684.7099999999999
61,64411319,2023-02-11,96.47,781.18
1811,64460080,2023-01-31,,313.37
6770,64460080,2023-02-01,-85.99,227.38
2343,64460080,2023-02-02,-61.09,166.29000000000002
5327,64460080,2023-02-03,-119.02,47.27000000000001
1983,64460080,2023-02-03,-156.41,-109.13999999999999
4125,64460080,2023-02-10,191.56,82.42000000000002
1812,64462046,2023-01-31,,847.04
4007,64462046,2023-02-07,-1392.7,-545.6600000000001
4016,64462046,2023-02-10,83.79,-461.87000000000006
3691,64462046,2023-02-10,-715.5,-1177.3700000000001
1813,64486954,2023-01-31,,378.0
4182,64486954,2023-02-05,57.18,435.18
3567,64486954,2023-02-05,-1685.4,-1250.22
6322,64486954,2023-02-08,-117.41,-1367.63
1400,64486954,2023-02-11,-1454.9,-2822.53
1814,64526097,2023-01-31,,491.42
6566,64526097,2023-02-02,61.97,553.39
6685,64526097,2023-02-03,140.51,693.9
1810,64526097,2023-02-04,46.96,740.86
3137,64526097,2023-02-10,-67.56,673.3
7815,64526097,2023-02-11,138.99,812.29
6418,64526097,2023-02-12,28.57,840.86
6499,64526097,2023-02-13,157.41,998.27
1815,64533535,2023-01-31,,535.88
2437,64533535,2023-02-03,-108.5,427.38
1946,64533535,2023-02-07,-162.23,265.15
5492,64533535,2023-02-09,-26.26,238.89000000000001
709,64533535,2023-02-11,59.16,298.05
5806,64533535,2023-02-13,77.95,376.0
1816,64571970,2023-01-31,,693.34
1237,64571970,2023-02-04,809.4,1502.74
6006,64571970,2023-02-07,-57.59,1445.15
8551,64571970,2023-02-07,-135.14,1310.01
5395,64571970,2023-02-07,-148.81,1161.2
7964,64571970,2023-02-08,-71.81,1089.39
1336,64571970,2023-02-09,-18.36,1071.03
1817,64590882,2023-01-31,,344.01
5964,64590882,2023-02-03,-1505.1,-1161.09
8440,64590882,2023-02-05,71.17,-1089.9199999999998
165,64590882,2023-02-05,-144.77,-1234.69
7081,64590882,2023-02-07,146.17,-1088.52
8086,64590882,2023-02-14,75.01,-1013.51
7082,64590882,2023-02-14,-54.0,-1067.51
1277,64590882,2023-02-14,-140.07,-1207.58
1818,64610632,2023-01-31,,869.95
179,64610632,2023-02-04,-35.39,834.5600000000001
6683,64610632,2023-02-05,858.4,1692.96
8528,64610632,2023-02-07,-147.04,1545.92
2913,64610632,2023-02-09,46.29,1592.21
637,64610632,2023-02-13,-183.43,1408.78
2560,64610632,2023-02-13,-199.57,1209.21
1819,64683004,2023-01-31,,348.86
7705,64683004,2023-02-01,614.1,962.96
5758,64683004,2023-02-04,303.4,1266.3600000000001
6696,64683004,2023-02-04,3.48,1269.84
433,64683004,2023-02-05,-183.09,1086.75
3720,64683004,2023-02-08,2017.7,3104.45
5398,64683004,2023-02-08,-106.98,2997.4700000000003
8178,64683004,2023-02-09,1658.0,4655.47
2317,64683004,2023-02-11,101.75,4757.22
6078,64683004,2023-02-13,-188.62,4568.6
8516,64683004,2023-02-14,147.85,4716.45
7919,64683004,2023-02-14,107.71,4824.16
1772,64683004,2023-02-14,-26.02,4798.14
1820,64716185,2023-01-31,,391.53
7641,64716185,2023-02-02,80.3,471.83
7876,64716185,2023-02-06,-54.21,417.61999999999995
5890,64716185,2023-02-07,1255.9,1673.52
2234,64716185,2023-02-08,-89.88,1583.6399999999999
8427,64716185,2023-02-13,-153.4,1430.24
2590,64716185,2023-02-14,7.26,1437.5
1821,64769583,2023-01-31,,598.67
7286,64769583,2023-02-02,-115.98,482.68999999999994
6175,64769583,2023-02-04,1705.8,2188.49
198,64769583,2023-02-07,115.83,2304.32
6762,64769583,2023-02-12,-129.84,2174.48
1822,64893719,2023-01-31,,689.59
6739,64893719,2023-02-03,64.85,754.44
4091,64893719,2023-02-04,-91.88,662.5600000000001
840,64893719,2023-02-07,126.74,789.3000000000001
6474,64893719,2023-02-08,41.56,830.86
4240,64893719,2023-02-10,-83.89,746.97
2882,64893719,2023-02-10,-119.83,627.14
1823,64901797,2023-01-31,,672.29
7786,64901797,2023-02-06,73.11,745.4
1385,64901797,2023-02-07,-94.93,650.4699999999999
3932,64901797,2023-02-10,-154.39,496.08
785,64901797,2023-02-14,70.4,566.48
1824,64953936,2023-01-31,,311.46
6635,64953936,2023-02-05,226.81,538.27
1659,64953936,2023-02-08,-34.12,504.15
2325,64953936,2023-02-11,148.4,652.55
3500,64953936,2023-02-13,-710.9,-58.35000000000002
1825,64958880,2023-01-31,,840.8
8501,64958880,2023-02-01,64.89,905.6899999999999
4169,64958880,2023-02-04,87.56,993.25
6968,64958880,2023-02-04,-54.34,938.91
3846,64958880,2023-02-07,-156.28,782.6299999999999
6012,64958880,2023-02-09,142.61,925.24
4962,64958880,2023-02-10,50.54,975.78
1826,64979248,2023-01-31,,202.63
5776,64979248,2023-02-02,-168.67,33.96000000000001
7693,64979248,2023-02-05,46.87,80.83000000000001
5791,64979248,2023-02-10,15.31,96.14
3528,64979248,2023-02-12,622.0,718.14
2340,64979248,2023-02-13,136.67,854.81
6645,64979248,2023-02-14,-44.4,810.41
1827,64990799,2023-01-31,,480.33
7749,64990799,2023-02-02,-102.4,377.92999999999995
6669,64990799,2023-02-03,-62.98,314.95
1123,64990799,2023-02-10,-67.2,247.74999999999997
6154,64990799,2023-02-12,272.8,520.55
8263,64990799,2023-02-12,-52.16,468.39
5070,64990799,2023-02-12,-966.7,-498.31000000000006
1828,65009032,2023-01-31,,984.64
1842,65009032,2023-02-03,220.14,1204.78
1397,65009032,2023-02-04,-128.21,1076.57
255,65009032,2023-02-06,-140.67,935.9
8486,65009032,2023-02-09,143.28,1079.18
2278,65009032,2023-02-09,95.74,1174.92
8507,65009032,2023-02-10,99.74,1274.6599999999999
1222,65009032,2023-02-10,93.37,1368.03
4264,65009032,2023-02-14,97.59,1465.62
1829,65033625,2023-01-31,,186.26
8250,65033625,2023-02-01,117.4,303.65999999999997
6713,65033625,2023-02-01,80.88,384.53999999999996
8265,65033625,2023-02-05,104.89,489.43
2503,65033625,2023-02-06,-107.96,381.47
1830,65052411,2023-01-31,,877.5
8021,65052411,2023-02-05,-80.22,797.28
7403,65052411,2023-02-06,177.63,974.91
1392,65052411,2023-02-10,48.54,1023.45
92,65052411,2023-02-11,159.34,1182.79
4847,65052411,2023-02-12,463.1,1645.8899999999999
1831,65052411,2023-02-14,169.73,1815.62
1831,65097827,2023-01-31,,526.75
7335,65097827,2023-02-02,-133.34,393.40999999999997
344,65097827,2023-02-03,-64.91,328.5
3887,65097827,2023-02-04,-27.43,301.07
6526,65097827,2023-02-05,109.24,410.31
4085,65097827,2023-02-06,738.2,1148.51
3342,65097827,2023-02-09,102.14,1250.65
3685,65097827,2023-02-09,93.18,1343.83
1832,65125795,2023-01-31,,632.35
2206,65125795,2023-02-02,15.19,647.5400000000001
3356,65125795,2023-02-08,38.13,685.6700000000001
5267,65125795,2023-02-14,-66.29,619.38
1833,65143384,2023-01-31,,227.08
8002,65143384,2023-02-04,117.79,344.87
5530,65143384,2023-02-04,8.85,353.72
1046,65143384,2023-02-06,-122.9,230.82
88,65143384,2023-02-07,-109.89,120.93
3015,65143384,2023-02-07,-119.45,1.480000000000004
2435,65143384,2023-02-07,-1516.3,-1514.82
2645,65143384,2023-02-09,139.36,-1375.46
5690,65143384,2023-02-11,-67.21,-1442.6699999999998
3349,65143384,2023-02-12,-45.77,-1488.4399999999998
1834,65159654,2023-01-31,,761.19
4734,65159654,2023-02-05,-148.44,612.75
3949,65159654,2023-02-08,-123.43,489.32000000000005
5562,65159654,2023-02-10,113.36,602.6800000000001
5984,65159654,2023-02-12,-221.72,380.96000000000004
592,65159654,2023-02-14,37.21,418.17
6220,65159654,2023-02-14,-665.3,-247.12999999999994
1835,65199307,2023-01-31,,68.09
763,65199307,2023-02-01,161.85,229.94
8092,65199307,2023-02-01,142.91,372.85
1522,65199307,2023-02-02,1097.6,1470.4499999999998
173,65199307,2023-02-06,89.47,1559.9199999999998
5188,65199307,2023-02-10,-58.45,1501.4699999999998
7087,65199307,2023-02-12,96.4,1597.87
408,65199307,2023-02-13,63.47,1661.34
1836,65200379,2023-01-31,,4.27
4194,65200379,2023-02-03,37.15,41.42
7131,65200379,2023-02-04,-68.44,-27.019999999999996
8680,65200379,2023-02-05,66.67,39.650000000000006
3130,65200379,2023-02-06,-101.4,-61.75
2559,65200379,2023-02-08,-116.58,-178.32999999999998
7361,65200379,2023-02-10,193.12,14.79000000000002
2362,65200379,2023-02-10,158.38,173.17000000000002
8275,65200379,2023-02-10,-83.52,89.65000000000002
4633,65200379,2023-02-11,-171.55,-81.89999999999999
6901,65200379,2023-02-12,-66.35,-148.25
568,65200379,2023-02-12,-1682.4,-1830.65
1837,65220738,2023-01-31,,873.56
669,65220738,2023-02-01,-89.8,783.76
6246,65220738,2023-02-03,-1121.6,-337.8399999999999
5261,65220738,2023-02-04,158.98,-178.85999999999993
6506,65220738,2023-02-05,-1533.5,-1712.36
3057,65220738,2023-02-06,633.0,-1079.36
1661,65220738,2023-02-11,-663.1,-1742.46
1838,65225040,2023-01-31,,826.42
6028,65225040,2023-02-05,-102.18,724.24
6349,65225040,2023-02-06,146.22,870.4599999999999
280,65225040,2023-02-06,106.0,976.4599999999999
3632,65225040,2023-02-09,188.3,1164.76
1913,65225040,2023-02-10,-55.08,1109.68
1839,65280102,2023-01-31,,2.17
2768,65280102,2023-02-06,131.6,133.76999999999998
3111,65280102,2023-02-06,-5.35,128.42
1485,65280102,2023-02-11,203.67,332.09
539,65280102,2023-02-11,-134.09,197.99999999999997
5110,65280102,2023-02-14,701.1,899.1
7582,65280102,2023-02-14,126.17,1025.27
1840,65321237,2023-01-31,,425.42
6599,65321237,2023-02-03,616.4,1041.82
7757,65321237,2023-02-04,-35.68,1006.1400000000001
4734,65321237,2023-02-05,148.44,1154.58
744,65321237,2023-02-08,107.42,1262.0
4188,65321237,2023-02-11,1293.9,2555.9
4539,65321237,2023-02-12,100.61,2656.51
1841,65380590,2023-01-31,,683.96
1896,65380590,2023-02-02,-31.96,652.0
148,65380590,2023-02-05,70.44,722.44
224,65380590,2023-02-07,73.26,795.7
8223,65380590,2023-02-12,-123.38,672.32
2179,65380590,2023-02-14,18.54,690.86
1842,65429379,2023-01-31,,232.83
6014,65429379,2023-02-01,78.22,311.05
178,65429379,2023-02-01,54.5,365.55
6508,65429379,2023-02-07,-155.73,209.82000000000002
1399,65429379,2023-02-09,118.21,328.03000000000003
2635,65429379,2023-02-09,24.12,352.15000000000003
521,65429379,2023-02-09,-133.43,218.72
6092,65429379,2023-02-10,60.14,278.86
7017,65429379,2023-02-13,133.53,412.39
1843,65534206,2023-01-31,,274.89
4878,65534206,2023-02-01,62.95,337.84
4127,65534206,2023-02-01,-173.01,164.82999999999998
4994,65534206,2023-02-04,35.8,200.63
3915,65534206,2023-02-09,-124.56,76.06999999999998
3978,65534206,2023-02-13,40.95,117.01999999999998
8259,65534206,2023-02-14,133.43,250.45
1844,65579734,2023-01-31,,928.08
7318,65579734,2023-02-07,97.26,1025.3400000000001
5158,65579734,2023-02-10,163.3,1188.64
5906,65579734,2023-02-10,134.33,1322.97
7921,65579734,2023-02-10,-123.19,1199.78
3821,65579734,2023-02-11,130.27,1330.0500000000002
7349,65579734,2023-02-12,-156.13,1173.92
5556,65579734,2023-02-13,1085.6,2259.52
4349,65579734,2023-02-13,-115.9,2143.62
1845,65583532,2023-01-31,,542.09
3734,65583532,2023-02-03,-80.54,461.55
1166,65583532,2023-02-04,57.41,518.96
6561,65583532,2023-02-05,209.45,728.4100000000001
2007,65583532,2023-02-09,107.84,836.25
2199,65583532,2023-02-09,-196.47,639.78
1846,65589565,2023-01-31,,321.99
4470,65589565,2023-02-07,-84.83,237.16000000000003
3298,65589565,2023-02-07,-93.93,143.23000000000002
33,65589565,2023-02-12,-1761.1,-1617.87
1847,65596186,2023-01-31,,254.28
5473,65596186,2023-02-03,98.67,352.95
1613,65596186,2023-02-04,-111.74,241.21
3259,65596186,2023-02-06,-121.72,119.49000000000001
4307,65596186,2023-02-14,-37.22,82.27000000000001
1848,65603779,2023-01-31,,652.83
7623,65603779,2023-02-01,-121.46,531.37
4352,65603779,2023-02-02,1145.1,1676.4699999999998
2811,65603779,2023-02-02,-108.49,1567.9799999999998
7715,65603779,2023-02-02,-599.3,968.6799999999998
6718,65603779,2023-02-14,201.83,1170.5099999999998
1849,65606472,2023-01-31,,405.1
5862,65606472,2023-02-12,-65.91,339.19000000000005
4447,65606472,2023-02-14,-142.57,196.62000000000003
71,65606472,2023-02-14,-302.9,-106.27999999999994
1850,65721172,2023-01-31,,221.49
896,65721172,2023-02-04,-155.79,65.70000000000002
8680,65721172,2023-02-05,-66.67,-0.9699999999999847
6898,65721172,2023-02-05,-190.77,-191.74
5957,65721172,2023-02-07,-57.31,-249.04999999999998
6678,65721172,2023-02-09,-154.04,-403.09
647,65721172,2023-02-13,-39.15,-442.23999999999995
1851,65724980,2023-01-31,,307.93
3722,65724980,2023-02-01,66.43,374.36
2591,65724980,2023-02-06,1138.4,1512.7600000000002
3087,65724980,2023-02-06,-133.2,1379.5600000000002
1298,65724980,2023-02-06,-155.01,1224.5500000000002
3697,65724980,2023-02-07,-134.59,1089.9600000000003
5975,65724980,2023-02-08,-157.28,932.6800000000003
6234,65724980,2023-02-12,-1.29,931.3900000000002
1852,65754176,2023-01-31,,716.55
4615,65754176,2023-02-01,174.19,890.74
4054,65754176,2023-02-03,-218.15,672.5899999999999
7411,65754176,2023-02-09,-1045.1,-372.51
4834,65754176,2023-02-10,-106.77,-479.28
7853,65754176,2023-02-12,180.46,-298.82
7368,65754176,2023-02-13,-105.95,-404.77
1853,65782923,2023-01-31,,193.43
7035,65782923,2023-02-05,118.02,311.45
3902,65782923,2023-02-06,-38.61,272.84000000000003
8199,65782923,2023-02-10,-148.09,124.75
5096,65782923,2023-02-11,70.39,195.14
3448,65782923,2023-02-14,-87.88,107.26
1854,65804470,2023-01-31,,454.38
1935,65804470,2023-02-02,-129.45,324.93
7736,65804470,2023-02-03,220.83,545.76
4922,65804470,2023-02-08,117.35,663.11
7027,65804470,2023-02-11,167.02,830.13
5356,65804470,2023-02-11,-90.36,739.77
4268,65804470,2023-02-13,62.13,801.9
2496,65804470,2023-02-14,61.34,863.24
1855,65815967,2023-01-31,,0.43
7496,65815967,2023-02-03,84.7,85.13000000000001
4488,65815967,2023-02-07,43.28,128.41000000000003
4507,65815967,2023-02-07,-149.99,-21.579999999999984
6138,65815967,2023-02-09,110.14,88.56000000000002
6519,65815967,2023-02-09,63.99,152.55
1856,65926576,2023-01-31,,73.48
3441,65926576,2023-02-02,97.47,170.95
248,65926576,2023-02-10,82.23,253.18
747,65926576,2023-02-12,158.57,411.75
657,65926576,2023-02-13,110.4,522.15
4042,65926576,2023-02-14,-143.6,378.55
1857,65988118,2023-01-31,,647.81
2355,65988118,2023-02-02,56.84,704.65
2532,65988118,2023-02-08,-14.01,690.64
1285,65988118,2023-02-10,55.13,745.77
705,65988118,2023-02-10,-117.56,628.2099999999999
3543,65988118,2023-02-11,108.59,736.8
6799,65988118,2023-02-12,157.46,894.26
1858,66008535,2023-01-31,,398.99
8184,66008535,2023-02-01,63.11,462.1
4651,66008535,2023-02-08,105.76,567.86
1859,66022888,2023-01-31,,757.14
2659,66022888,2023-02-01,57.37,814.51
4348,66022888,2023-02-02,-24.05,790.46
1197,66022888,2023-02-03,98.38,888.8399999999999
7846,66022888,2023-02-03,-50.38,838.4599999999999
6484,66022888,2023-02-03,-91.37,747.0899999999999
7870,66022888,2023-02-07,126.32,873.41
4112,66022888,2023-02-08,-159.05,714.3599999999999
8094,66022888,2023-02-09,63.95,778.31
652,66022888,2023-02-14,81.21,859.52
1860,66044567,2023-01-31,,596.13
3731,66044567,2023-02-02,183.83,779.96
5576,66044567,2023-02-03,11.36,791.32
8681,66044567,2023-02-05,159.59,950.9100000000001
760,66044567,2023-02-12,95.14,1046.05
1861,66152145,2023-01-31,,83.45
1031,66152145,2023-02-02,150.88,234.32999999999998
4927,66152145,2023-02-03,55.63,289.96
6599,66152145,2023-02-03,-616.4,-326.44
5969,66152145,2023-02-05,-83.4,-409.84000000000003
1417,66152145,2023-02-07,-1760.8,-2170.64
3422,66152145,2023-02-08,59.97,-2110.67
8622,66152145,2023-02-09,-73.42,-2184.09
7926,66152145,2023-02-14,685.5,-1498.5900000000001
7414,66152145,2023-02-14,107.51,-1391.0800000000002
1862,66168472,2023-01-31,,29.89
7954,66168472,2023-02-03,221.11,251.0
6166,66168472,2023-02-03,-79.25,171.75
3215,66168472,2023-02-03,-196.95,-25.19999999999999
295,66168472,2023-02-05,98.07,72.87
8636,66168472,2023-02-09,96.2,169.07
6436,66168472,2023-02-09,20.18,189.25
5145,66168472,2023-02-12,-88.2,101.05000000000001
1863,66175264,2023-01-31,,765.91
6147,66175264,2023-02-06,123.31,889.22
7337,66175264,2023-02-09,74.87,964.0899999999999
5333,66175264,2023-02-10,1134.6,2098.6899999999996
3842,66175264,2023-02-12,67.31,2166.0
7405,66175264,2023-02-13,-161.21,2004.7899999999997
2972,66175264,2023-02-14,117.68,2122.47
1864,66187843,2023-01-31,,535.34
1217,66187843,2023-02-01,-112.17,423.17
4480,66187843,2023-02-03,163.12,586.29
1865,66239954,2023-01-31,,181.14
4062,66239954,2023-02-02,93.88,275.02
2751,66239954,2023-02-03,267.7,542.72
5969,66239954,2023-02-05,83.4,626.12
3645,66239954,2023-02-07,-140.1,486.02
3150,66239954,2023-02-12,-48.67,437.34999999999997
4678,66239954,2023-02-12,-57.42,379.92999999999995
3149,66239954,2023-02-14,130.84,510.77
5001,66239954,2023-02-14,80.39,591.16
3589,66239954,2023-02-14,-1478.2,-887.0400000000001
1866,66257438,2023-01-31,,818.57
1135,66257438,2023-02-01,78.4,896.97
3621,66257438,2023-02-04,84.59,981.5600000000001
5381,66257438,2023-02-05,-28.46,953.1
4397,66257438,2023-02-07,-6.03,947.07
383,66257438,2023-02-09,71.12,1018.19
6630,66257438,2023-02-12,1799.2,2817.3900000000003
3124,66257438,2023-02-12,-108.0,2709.3900000000003
1867,66283493,2023-01-31,,612.88
6786,66283493,2023-02-06,49.21,662.09
4650,66283493,2023-02-07,1370.6,2032.69
1868,66332583,2023-01-31,,241.29
8661,66332583,2023-02-05,-184.86,56.42999999999998
2836,66332583,2023-02-06,-83.89,-27.460000000000022
5472,66332583,2023-02-07,151.7,124.23999999999997
3387,66332583,2023-02-09,-121.13,3.109999999999971
8604,66332583,2023-02-12,-128.81,-125.70000000000003
775,66332583,2023-02-12,-198.39,-324.09000000000003
1869,66341438,2023-01-31,,685.06
440,66341438,2023-02-05,-1625.6,-940.54
6913,66341438,2023-02-06,113.63,-826.91
2366,66341438,2023-02-13,-81.39,-908.3
1230,66341438,2023-02-13,-1013.4,-1921.6999999999998
1870,66390683,2023-01-31,,52.77
2061,66390683,2023-02-01,-104.47,-51.699999999999996
3709,66390683,2023-02-03,-103.29,-154.99
3233,66390683,2023-02-05,83.99,-71.0
1994,66390683,2023-02-05,-165.42,-236.42
3780,66390683,2023-02-09,90.79,-145.63
3366,66390683,2023-02-11,-77.62,-223.25
8609,66390683,2023-02-13,-157.55,-380.8
7333,66390683,2023-02-14,65.5,-315.3
2208,66390683,2023-02-14,-133.19,-448.49
6655,66390683,2023-02-14,-146.71,-595.2
1871,66416254,2023-01-31,,166.4
3646,66416254,2023-02-03,131.54,297.94
2954,66416254,2023-02-03,-38.14,259.8
6571,66416254,2023-02-03,-63.29,196.51
5839,66416254,2023-02-03,-159.42,37.09
4983,66416254,2023-02-04,-93.96,-56.86999999999999
3038,66416254,2023-02-05,812.6,755.73
5710,66416254,2023-02-05,-159.34,596.39
2745,66416254,2023-02-06,1095.4,1691.79
5898,66416254,2023-02-10,174.77,1866.56
6091,66416254,2023-02-10,-68.78,1797.78
571,66416254,2023-02-11,142.67,1940.45
4297,66416254,2023-02-12,-89.64,1850.81
1182,66416254,2023-02-13,837.4,2688.21
1872,66445304,2023-01-31,,153.78
6451,66445304,2023-02-01,174.0,327.78
1554,66445304,2023-02-05,184.78,512.56
4518,66445304,2023-02-05,-108.92,403.64
4931,66445304,2023-02-08,-94.29,309.35
1873,66449974,2023-01-31,,795.59
554,66449974,2023-02-05,65.31,860.9000000000001
8326,66449974,2023-02-11,102.91,963.8100000000001
7218,66449974,2023-02-12,-80.44,883.37
4347,66449974,2023-02-12,-1265.1,-381.7299999999999
1874,66504443,2023-01-31,,618.97
839,66504443,2023-02-02,-217.51,401.46000000000004
4944,66504443,2023-02-05,-45.47,355.99
861,66504443,2023-02-12,-127.6,228.39000000000004
1875,66521788,2023-01-31,,201.43
869,66521788,2023-02-01,-127.41,74.02000000000001
1564,66521788,2023-02-05,90.66,164.68
661,66521788,2023-02-05,-73.78,90.9
7810,66521788,2023-02-13,-67.31,23.590000000000003
1876,66556141,2023-01-31,,688.37
2218,66556141,2023-02-05,-33.96,654.41
654,66556141,2023-02-07,45.83,700.24
2175,66556141,2023-02-10,206.97,907.21
125,66556141,2023-02-13,-96.51,810.7
1877,66586860,2023-01-31,,938.51
8100,66586860,2023-02-01,1072.7,2011.21
1678,66586860,2023-02-06,-143.42,1867.79
3147,66586860,2023-02-07,-106.1,1761.69
1930,66586860,2023-02-08,-145.66,1616.03
8007,66586860,2023-02-10,116.33,1732.3600000000001
167,66586860,2023-02-11,-86.77,1645.5900000000001
5020,66586860,2023-02-11,-148.74,1496.8500000000001
7963,66586860,2023-02-12,-1764.4,-267.54999999999995
394,66586860,2023-02-13,-56.41,-323.9599999999999
1878,66601462,2023-01-31,,361.46
6464,66601462,2023-02-11,62.18,423.64
1685,66601462,2023-02-13,-115.86,307.78
1879,66624477,2023-01-31,,521.98
5177,66624477,2023-02-10,-1271.5,-749.52
306,66624477,2023-02-13,-70.58,-820.1
1880,66667727,2023-01-31,,431.31
7694,66667727,2023-02-01,145.77,577.08
6671,66667727,2023-02-04,146.82,723.9
6118,66667727,2023-02-04,-201.15,522.75
7132,66667727,2023-02-05,-104.58,418.17
1362,66667727,2023-02-06,-106.31,311.86
1881,66681692,2023-01-31,,712.12
1505,66681692,2023-02-03,644.3,1356.42
4453,66681692,2023-02-03,-102.01,1254.4099999999999
8468,66681692,2023-02-09,1246.4,2500.81
5438,66681692,2023-02-11,99.6,2600.41
3407,66681692,2023-02-14,-150.42,2449.99
1882,66700123,2023-01-31,,175.15
6155,66700123,2023-02-01,-106.46,68.69000000000001
8165,66700123,2023-02-02,-1180.2,-1111.51
2420,66700123,2023-02-08,-39.85,-1151.36
6305,66700123,2023-02-11,125.31,-1026.05
130,66700123,2023-02-12,-62.68,-1088.73
1883,66704269,2023-01-31,,915.51
4134,66704269,2023-02-03,110.38,1025.8899999999999
351,66704269,2023-02-04,124.72,1150.61
1219,66704269,2023-02-04,64.92,1215.53
5710,66704269,2023-02-05,159.34,1374.87
1329,66704269,2023-02-07,-10.31,1364.56
2621,66704269,2023-02-08,-157.04,1207.52
7506,66704269,2023-02-11,94.59,1302.1100000000001
7773,66704269,2023-02-12,-124.55,1177.56
4524,66704269,2023-02-14,658.2,1835.7600000000002
6800,66704269,2023-02-14,87.55,1923.3100000000002
1884,66706067,2023-01-31,,1.98
3918,66706067,2023-02-02,-233.36,-231.38000000000002
628,66706067,2023-02-04,111.13,-120.25000000000003
8095,66706067,2023-02-07,-180.28,-300.53000000000003
7845,66706067,2023-02-08,-12.95,-313.48
6477,66706067,2023-02-08,-1006.9,-1320.38
6021,66706067,2023-02-10,1202.5,-117.88000000000011
8257,66706067,2023-02-10,96.87,-21.010000000000105
8638,66706067,2023-02-10,-140.57,-161.5800000000001
4401,66706067,2023-02-11,-52.74,-214.3200000000001
2246,66706067,2023-02-12,166.9,-47.4200000000001
1885,66729131,2023-01-31,,100.8
4086,66729131,2023-02-04,-24.31,76.49
3447,66729131,2023-02-04,-95.6,-19.11
7106,66729131,2023-02-04,-146.89,-166.0
1886,66729131,2023-02-05,87.07,-78.93
1886,66896515,2023-01-31,,842.82
7244,66896515,2023-02-04,535.8,1378.62
616,66896515,2023-02-05,91.73,1470.35
7728,66896515,2023-02-05,-104.2,1366.15
7254,66896515,2023-02-05,-190.01,1176.14
3753,66896515,2023-02-09,101.53,1277.67
4376,66896515,2023-02-11,222.05,1499.72
5438,66896515,2023-02-11,-99.6,1400.1200000000001
1887,66914990,2023-01-31,,764.75
3192,66914990,2023-02-01,-98.33,666.42
8615,66914990,2023-02-05,137.98,804.4
5008,66914990,2023-02-09,-125.11,679.29
3311,66914990,2023-02-13,-229.21,450.08
2174,66914990,2023-02-14,65.19,515.27
701,66914990,2023-02-14,-133.67,381.6
1888,66930564,2023-01-31,,398.03
7617,66930564,2023-02-02,-83.72,314.30999999999995
2901,66930564,2023-02-05,-174.96,139.34999999999997
3498,66930564,2023-02-06,115.81,255.15999999999997
7633,66930564,2023-02-11,-96.9,158.25999999999996
490,66930564,2023-02-13,114.54,272.79999999999995
1889,66954664,2023-01-31,,620.1
1758,66954664,2023-02-04,49.52,669.62
420,66954664,2023-02-04,-57.49,612.13
7238,66954664,2023-02-05,-202.11,410.02
1686,66954664,2023-02-08,-62.89,347.13
8156,66954664,2023-02-12,-153.75,193.38
6763,66954664,2023-02-13,-48.57,144.81
3809,66954664,2023-02-14,-781.5,-636.69
1890,67029298,2023-01-31,,255.53
740,67029298,2023-02-01,-60.58,194.95
228,67029298,2023-02-02,786.6,981.55
3043,67029298,2023-02-02,68.12,1049.67
6714,67029298,2023-02-02,28.3,1077.97
7298,67029298,2023-02-02,-90.07,987.9000000000001
7135,67029298,2023-02-07,21.61,1009.5100000000001
5209,67029298,2023-02-08,-107.83,901.6800000000001
2477,67029298,2023-02-14,-93.35,808.33
1891,67056187,2023-01-31,,392.51
5289,67056187,2023-02-02,-101.39,291.12
7647,67056187,2023-02-08,-92.86,198.26
2786,67056187,2023-02-09,-163.99,34.26999999999998
7184,67056187,2023-02-11,-1370.2,-1335.93
5730,67056187,2023-02-14,-47.83,-1383.76
7010,67056187,2023-02-14,-106.34,-1490.1000000000001
1892,67090449,2023-01-31,,724.35
8616,67090449,2023-02-04,-31.07,693.28
1625,67090449,2023-02-07,-84.46,608.82
8149,67090449,2023-02-07,-788.3,-179.4799999999999
8486,67090449,2023-02-09,-143.28,-322.7599999999999
7619,67090449,2023-02-10,103.55,-219.20999999999992
7397,67090449,2023-02-10,-59.66,-278.8699999999999
2793,67090449,2023-02-11,62.9,-215.9699999999999
4485,67090449,2023-02-14,72.94,-143.02999999999992
4008,67090449,2023-02-14,-1145.9,-1288.93
1893,67102224,2023-01-31,,852.71
3953,67102224,2023-02-01,103.68,956.3900000000001
4739,67102224,2023-02-03,-107.3,849.09
1894,67104073,2023-01-31,,476.04
410,67104073,2023-02-03,46.54,522.58
5481,67104073,2023-02-07,-184.95,337.63
7031,67104073,2023-02-13,-69.73,267.90000000000003
1895,67147649,2023-01-31,,3.28
475,67147649,2023-02-02,1499.9,1503.18
4450,67147649,2023-02-03,-121.77,1381.41
62,67147649,2023-02-05,106.43,1487.8400000000001
5252,67147649,2023-02-08,27.23,1515.0700000000002
612,67147649,2023-02-10,72.61,1587.68
5176,67147649,2023-02-14,98.34,1686.02
1896,67153119,2023-01-31,,454.81
8268,67153119,2023-02-01,117.6,572.41
3583,67153119,2023-02-01,-99.45,472.96
6207,67153119,2023-02-02,190.87,663.8299999999999
7668,67153119,2023-02-03,8.49,672.3199999999999
3153,67153119,2023-02-08,-53.25,619.0699999999999
6619,67153119,2023-02-12,91.62,710.69
1154,67153119,2023-02-14,-171.69,539.0
1897,67157564,2023-01-31,,562.42
4289,67157564,2023-02-01,1153.0,1715.42
4546,67157564,2023-02-02,74.82,1790.24
271,67157564,2023-02-03,89.03,1879.27
4898,67157564,2023-02-04,-160.12,1719.15
3668,67157564,2023-02-08,-122.19,1596.96
5052,67157564,2023-02-10,-58.74,1538.22
7185,67157564,2023-02-10,-72.18,1466.04
1239,67157564,2023-02-12,71.93,1537.97
1898,67190209,2023-01-31,,567.61
6172,67190209,2023-02-01,74.4,642.01
1899,67270354,2023-01-31,,805.28
4665,67270354,2023-02-04,-130.37,674.91
7833,67270354,2023-02-05,-139.91,535.0
1650,67270354,2023-02-10,1124.9,1659.9
7737,67270354,2023-02-12,-68.07,1591.8300000000002
1900,67283010,2023-01-31,,872.4
5630,67283010,2023-02-02,72.58,944.98
5045,67283010,2023-02-04,126.98,1071.96
1574,67283010,2023-02-05,143.73,1215.69
4380,67283010,2023-02-08,-7.94,1207.75
7007,67283010,2023-02-11,-75.12,1132.6299999999999
1901,67392638,2023-01-31,,519.61
4535,67392638,2023-02-04,905.4,1425.01
3972,67392638,2023-02-05,184.06,1609.07
3836,67392638,2023-02-05,-95.35,1513.72
8429,67392638,2023-02-06,-93.75,1419.97
1902,67400117,2023-01-31,,769.45
1629,67400117,2023-02-02,-114.44,655.01
2016,67400117,2023-02-03,158.72,813.73
4988,67400117,2023-02-10,121.7,935.4300000000001
5499,67400117,2023-02-10,-130.32,805.1100000000001
4524,67400117,2023-02-14,-658.2,146.91000000000008
1903,67434874,2023-01-31,,399.94
2811,67434874,2023-02-02,108.49,508.43
8597,67434874,2023-02-03,94.57,603.0
8667,67434874,2023-02-04,72.83,675.8299999999999
7347,67434874,2023-02-05,80.66,756.49
1744,67434874,2023-02-07,-123.67,632.8199999999999
2231,67434874,2023-02-09,110.11,742.93
610,67434874,2023-02-11,-88.2,654.73
7525,67434874,2023-02-12,-85.9,568.8299999999999
1904,67464890,2023-01-31,,81.27
2331,67464890,2023-02-13,-565.6,-484.33000000000004
5157,67464890,2023-02-14,-114.72,-599.0500000000001
1905,67466632,2023-01-31,,350.06
8546,67466632,2023-02-01,126.75,476.81
7900,67466632,2023-02-05,-1317.7,-840.8900000000001
1471,67466632,2023-02-06,179.1,-661.7900000000001
7547,67466632,2023-02-06,48.43,-613.3600000000001
7071,67466632,2023-02-09,144.14,-469.22000000000014
4599,67466632,2023-02-11,83.01,-386.2100000000001
3675,67466632,2023-02-11,-196.49,-582.7
8574,67466632,2023-02-13,-66.5,-649.2
821,67466632,2023-02-14,-147.38,-796.5800000000002
1906,67489489,2023-01-31,,219.39
5958,67489489,2023-02-01,-118.62,100.76999999999998
1642,67489489,2023-02-04,88.31,189.07999999999998
1878,67489489,2023-02-04,68.1,257.17999999999995
8255,67489489,2023-02-06,112.02,369.2
7553,67489489,2023-02-06,91.86,461.05999999999995
4883,67489489,2023-02-09,-7.44,453.61999999999995
1294,67489489,2023-02-09,-264.6,189.01999999999992
4812,67489489,2023-02-14,85.38,274.3999999999999
1907,67490657,2023-01-31,,588.58
3650,67490657,2023-02-04,-158.56,430.02000000000004
6428,67490657,2023-02-05,-18.89,411.13000000000005
6538,67490657,2023-02-06,-146.96,264.17
7739,67490657,2023-02-08,59.4,323.57
2147,67490657,2023-02-10,123.76,447.33000000000004
3847,67490657,2023-02-11,-954.4,-507.06999999999994
4420,67490657,2023-02-12,-850.1,-1357.17
1201,67490657,2023-02-14,99.88,-1257.29
1908,67502738,2023-01-31,,185.72
7195,67502738,2023-02-08,170.5,356.22
8051,67502738,2023-02-10,-104.93,251.29
3301,67502738,2023-02-12,-84.83,166.45999999999998
1909,67532228,2023-01-31,,805.91
6022,67532228,2023-02-03,936.3,1742.21
4672,67532228,2023-02-04,-163.15,1579.06
8502,67532228,2023-02-05,117.8,1696.86
1458,67532228,2023-02-05,-139.34,1557.52
6970,67532228,2023-02-07,153.27,1710.79
5794,67532228,2023-02-10,-92.13,1618.6599999999999
1910,67541253,2023-01-31,,985.49
8402,67541253,2023-02-02,-555.5,429.99
1670,67541253,2023-02-05,81.2,511.19
6050,67541253,2023-02-09,-38.71,472.48
2594,67541253,2023-02-10,139.35,611.83
1911,67561762,2023-01-31,,469.23
5031,67561762,2023-02-01,170.35,639.58
7689,67561762,2023-02-04,-192.0,447.58000000000004
5803,67561762,2023-02-07,-52.55,395.03000000000003
3205,67561762,2023-02-09,-140.61,254.42000000000002
5664,67561762,2023-02-11,-1136.3,-881.8799999999999
2571,67561762,2023-02-14,114.68,-767.1999999999998
1912,67571676,2023-01-31,,491.88
1379,67571676,2023-02-09,151.22,643.1
6120,67571676,2023-02-09,-7.96,635.14
2760,67571676,2023-02-10,-11.9,623.24
8219,67571676,2023-02-14,-85.15,538.09
1913,67635951,2023-01-31,,692.02
4622,67635951,2023-02-01,167.46,859.48
3904,67635951,2023-02-01,77.61,937.09
3860,67635951,2023-02-04,133.61,1070.7
2038,67635951,2023-02-04,-109.45,961.25
44,67635951,2023-02-04,-174.55,786.7
513,67635951,2023-02-08,174.24,960.94
6389,67635951,2023-02-08,-89.09,871.85
4963,67635951,2023-02-08,-258.6,613.25
1914,67674594,2023-01-31,,126.16
1381,67674594,2023-02-01,61.16,187.32
1500,67674594,2023-02-07,-169.03,18.289999999999992
1740,67674594,2023-02-08,153.92,172.20999999999998
7154,67674594,2023-02-08,-135.45,36.75999999999999
5255,67674594,2023-02-09,-56.53,-19.77000000000001
7083,67674594,2023-02-11,151.65,131.88
8102,67674594,2023-02-12,-76.15,55.72999999999999
1915,67679622,2023-01-31,,631.03
2248,67679622,2023-02-01,142.37,773.4
7076,67679622,2023-02-08,-54.11,719.29
186,67679622,2023-02-08,-93.74,625.55
7413,67679622,2023-02-09,813.0,1438.55
3558,67679622,2023-02-10,-111.68,1326.87
6253,67679622,2023-02-10,-190.89,1135.98
4653,67679622,2023-02-12,-163.83,972.15
1916,67716893,2023-01-31,,250.99
7838,67716893,2023-02-02,93.16,344.15
7727,67716893,2023-02-05,69.16,413.31
1955,67716893,2023-02-07,-126.45,286.86
6812,67716893,2023-02-07,-1500.0,-1213.1399999999999
3656,67716893,2023-02-08,-10.18,-1223.32
4659,67716893,2023-02-08,-73.68,-1297.0
3378,67716893,2023-02-09,166.7,-1130.3
1917,67805276,2023-01-31,,431.12
4686,67805276,2023-02-08,88.85,519.97
1333,67805276,2023-02-09,79.05,599.02
1907,67805276,2023-02-09,-182.8,416.21999999999997
3889,67805276,2023-02-10,103.06,519.28
8214,67805276,2023-02-11,104.82,624.0999999999999
2095,67805276,2023-02-14,-10.57,613.53
1918,67837998,2023-01-31,,246.4
1885,67837998,2023-02-02,154.06,400.46000000000004
4169,67837998,2023-02-04,-87.56,312.9
2563,67837998,2023-02-05,63.7,376.6
1091,67837998,2023-02-10,682.2,1058.8000000000002
1919,67862200,2023-01-31,,944.49
7751,67862200,2023-02-04,-121.95,822.54
3056,67862200,2023-02-06,-7.07,815.47
4124,67862200,2023-02-09,1131.6,1947.07
879,67862200,2023-02-11,1655.3,3602.37
3740,67862200,2023-02-12,-860.8,2741.5699999999997
1920,67902154,2023-01-31,,669.79
8127,67902154,2023-02-01,65.61,735.4
1383,67902154,2023-02-01,-86.21,649.1899999999999
5743,67902154,2023-02-01,-546.3,102.88999999999999
6330,67902154,2023-02-03,-3.24,99.64999999999999
2804,67902154,2023-02-03,-58.81,40.83999999999998
5495,67902154,2023-02-04,126.83,167.67
5186,67902154,2023-02-06,188.27,355.93999999999994
5317,67902154,2023-02-06,-85.9,270.03999999999996
1612,67902154,2023-02-08,118.58,388.61999999999995
4021,67902154,2023-02-12,158.11,546.73
7226,67902154,2023-02-14,-91.53,455.19999999999993
2244,67902154,2023-02-14,-1100.7,-645.5000000000001
1921,67909830,2023-01-31,,589.68
2185,67909830,2023-02-03,168.82,758.5
8626,67909830,2023-02-03,-118.95,639.55
8466,67909830,2023-02-06,-157.94,481.60999999999996
2051,67909830,2023-02-07,86.52,568.13
7878,67909830,2023-02-11,170.72,738.8499999999999
1922,67911201,2023-01-31,,762.17
4218,67911201,2023-02-01,65.26,827.43
5476,67911201,2023-02-04,-120.19,707.24
6241,67911201,2023-02-09,-1558.7,-851.46
5545,67911201,2023-02-10,170.08,-681.38
4558,67911201,2023-02-11,-52.48,-733.86
7013,67911201,2023-02-11,-107.06,-840.9200000000001
1923,67911677,2023-01-31,,725.9
2872,67911677,2023-02-04,149.2,875.0999999999999
4589,67911677,2023-02-09,-73.05,802.05
1924,67938929,2023-01-31,,868.04
5181,67938929,2023-02-01,-125.38,742.66
1293,67938929,2023-02-03,110.43,853.0899999999999
4439,67938929,2023-02-03,-61.92,791.17
1046,67938929,2023-02-06,122.9,914.0699999999999
6291,67938929,2023-02-09,158.5,1072.57
6247,67938929,2023-02-09,-135.47,937.1
4249,67938929,2023-02-10,90.78,1027.88
5052,67938929,2023-02-10,58.74,1086.62
218,67938929,2023-02-10,-20.05,1066.57
6063,67938929,2023-02-11,-73.62,992.95
823,67938929,2023-02-13,121.3,1114.25
1925,67961706,2023-01-31,,569.5
2409,67961706,2023-02-05,95.84,665.34
1907,67961706,2023-02-09,182.8,848.14
5336,67961706,2023-02-11,832.5,1680.6399999999999
2708,67961706,2023-02-12,-98.2,1582.44
3023,67961706,2023-02-14,104.45,1686.8899999999999
1926,67987326,2023-01-31,,161.67
3170,67987326,2023-02-01,-151.18,10.48999999999998
8335,67987326,2023-02-06,175.36,185.85
3274,67987326,2023-02-07,-138.63,47.22
5695,67987326,2023-02-10,83.95,131.17000000000002
1584,67987326,2023-02-12,224.14,355.31
1927,68051701,2023-01-31,,911.6
2633,68051701,2023-02-03,-197.64,713.96
7455,68051701,2023-02-03,-774.8,-60.83999999999992
1250,68051701,2023-02-04,-34.22,-95.05999999999992
8270,68051701,2023-02-11,89.5,-5.559999999999917
5316,68051701,2023-02-12,128.28,122.72000000000008
2511,68051701,2023-02-13,-184.92,-62.1999999999999
1928,68104946,2023-01-31,,925.71
4204,68104946,2023-02-08,109.29,1035.0
1929,68153614,2023-01-31,,927.95
112,68153614,2023-02-02,118.22,1046.17
5545,68153614,2023-02-10,-170.08,876.09
1066,68153614,2023-02-11,-659.5,216.59000000000003
4801,68153614,2023-02-13,-99.78,116.81000000000003
1930,68189902,2023-01-31,,448.56
7936,68189902,2023-02-02,-61.7,386.86
7816,68189902,2023-02-05,125.05,511.90999999999997
7239,68189902,2023-02-05,-153.59,358.32
7006,68189902,2023-02-06,145.42,503.74
2497,68189902,2023-02-07,101.79,605.53
1931,68198696,2023-01-31,,979.46
3937,68198696,2023-02-05,27.36,1006.82
8558,68198696,2023-02-07,159.97,1166.79
6257,68198696,2023-02-08,-96.45,1070.34
3485,68198696,2023-02-09,56.02,1126.3600000000001
5265,68198696,2023-02-09,-37.14,1089.22
6995,68198696,2023-02-09,-60.16,1029.06
2166,68198696,2023-02-11,-16.59,1012.47
5927,68198696,2023-02-12,1149.0,2161.4700000000003
1932,68239576,2023-01-31,,64.42
7203,68239576,2023-02-01,121.83,186.25
8201,68239576,2023-02-01,94.97,281.22
3126,68239576,2023-02-01,21.82,303.04
584,68239576,2023-02-05,100.33,403.37
7858,68239576,2023-02-09,85.04,488.41
2328,68239576,2023-02-09,-129.19,359.22
1933,68262083,2023-01-31,,899.79
4299,68262083,2023-02-04,-141.71,758.0799999999999
7290,68262083,2023-02-11,-57.11,700.9699999999999
4013,68262083,2023-02-14,120.31,821.28
1934,68275028,2023-01-31,,918.44
5956,68275028,2023-02-01,-120.92,797.5200000000001
1491,68275028,2023-02-03,106.67,904.19
7730,68275028,2023-02-04,-35.52,868.6700000000001
7149,68275028,2023-02-07,1002.5,1871.17
6356,68275028,2023-02-07,192.3,2063.4700000000003
3519,68275028,2023-02-09,-107.22,1956.25
1935,68294036,2023-01-31,,184.64
4612,68294036,2023-02-02,119.55,304.19
5947,68294036,2023-02-06,67.41,371.59999999999997
2468,68294036,2023-02-06,-50.84,320.76
2920,68294036,2023-02-08,-157.52,163.23999999999995
8084,68294036,2023-02-08,-162.49,0.7499999999999432
3696,68294036,2023-02-09,411.3,412.04999999999995
3078,68294036,2023-02-10,165.63,577.68
1936,68294645,2023-01-31,,306.18
3291,68294645,2023-02-01,33.51,339.69
7617,68294645,2023-02-02,83.72,423.40999999999997
5938,68294645,2023-02-06,126.54,549.95
4899,68294645,2023-02-12,-72.46,477.49
1937,68311266,2023-01-31,,87.08
5679,68311266,2023-02-01,-239.72,-152.64
243,68311266,2023-02-03,130.74,-21.900000000000006
7833,68311266,2023-02-05,139.91,118.00999999999999
5799,68311266,2023-02-06,1253.1,1371.11
558,68311266,2023-02-10,114.74,1485.85
838,68311266,2023-02-12,-96.87,1388.9799999999998
4565,68311266,2023-02-14,108.48,1497.4599999999998
2134,68311266,2023-02-14,27.68,1525.1399999999999
1938,68315462,2023-01-31,,769.16
6132,68315462,2023-02-01,152.29,921.4499999999999
6761,68315462,2023-02-02,118.55,1040.0
8683,68315462,2023-02-03,198.29,1238.29
7264,68315462,2023-02-05,-10.32,1227.97
316,68315462,2023-02-05,-19.27,1208.7
3644,68315462,2023-02-09,1410.1,2618.8
6248,68315462,2023-02-10,104.86,2723.66
6108,68315462,2023-02-10,63.58,2787.24
68,68315462,2023-02-10,-74.29,2712.95
4253,68315462,2023-02-13,-40.65,2672.2999999999997
1939,68346907,2023-01-31,,752.88
1260,68346907,2023-02-01,-844.6,-91.72000000000003
8166,68346907,2023-02-05,74.21,-17.510000000000034
1099,68346907,2023-02-06,-100.09,-117.60000000000004
5785,68346907,2023-02-07,-129.86,-247.46000000000004
3351,68346907,2023-02-08,43.89,-203.57000000000005
3089,68346907,2023-02-09,-78.9,-282.47
3707,68346907,2023-02-12,-841.7,-1124.17
5018,68346907,2023-02-13,92.64,-1031.53
1940,68393439,2023-01-31,,783.05
1767,68393439,2023-02-01,137.75,920.8
5094,68393439,2023-02-02,-174.74,746.06
1960,68393439,2023-02-05,104.42,850.4799999999999
4373,68393439,2023-02-09,115.06,965.54
4486,68393439,2023-02-10,-130.57,834.97
8441,68393439,2023-02-12,40.07,875.04
3293,68393439,2023-02-12,-67.66,807.38
2516,68393439,2023-02-13,-72.65,734.73
7805,68393439,2023-02-13,-125.61,609.12
7559,68393439,2023-02-13,-152.83,456.28999999999996
1941,68423238,2023-01-31,,972.94
8021,68423238,2023-02-05,80.22,1053.16
2015,68423238,2023-02-11,-107.4,945.76
707,68423238,2023-02-12,128.4,1074.16
1280,68423238,2023-02-12,84.4,1158.56
3138,68423238,2023-02-13,175.32,1333.88
1942,68483071,2023-01-31,,25.88
8299,68483071,2023-02-04,-2122.7,-2096.8199999999997
6310,68483071,2023-02-05,-1580.8,-3677.62
4492,68483071,2023-02-07,166.87,-3510.7499999999995
1943,68484031,2023-01-31,,853.99
3440,68484031,2023-02-02,52.86,906.85
6428,68484031,2023-02-05,18.89,925.74
5588,68484031,2023-02-05,-1463.6,-537.8599999999999
3401,68484031,2023-02-11,1672.7,1134.8400000000001
8027,68484031,2023-02-11,-26.87,1107.9700000000003
1944,68552857,2023-01-31,,309.92
6495,68552857,2023-02-02,156.04,465.96000000000004
6289,68552857,2023-02-02,-106.6,359.36
2632,68552857,2023-02-08,-68.6,290.76
1945,68552994,2023-01-31,,516.25
4878,68552994,2023-02-01,-62.95,453.3
2905,68552994,2023-02-08,-1608.4,-1155.1000000000001
1512,68552994,2023-02-09,-88.81,-1243.91
3809,68552994,2023-02-14,781.5,-462.4100000000001
1946,68558850,2023-01-31,,281.5
7169,68558850,2023-02-01,80.81,362.31
7944,68558850,2023-02-04,1395.3,1757.61
934,68558850,2023-02-06,-182.96,1574.6499999999999
6719,68558850,2023-02-07,-111.95,1462.6999999999998
1754,68558850,2023-02-10,-70.74,1391.9599999999998
4809,68558850,2023-02-12,-69.85,1322.11
1947,68579203,2023-01-31,,149.39
1948,68680764,2023-01-31,,200.27
5063,68680764,2023-02-03,886.6,1086.8700000000001
1325,68680764,2023-02-09,-81.22,1005.65
1949,68683403,2023-01-31,,674.5
74,68683403,2023-02-05,63.32,737.82
59,68683403,2023-02-13,535.9,1273.72
1950,68689742,2023-01-31,,45.41
6996,68689742,2023-02-07,121.67,167.07999999999998
2879,68689742,2023-02-07,56.42,223.5
5126,68689742,2023-02-14,-123.36,100.14
1951,68708795,2023-01-31,,399.11
1439,68708795,2023-02-03,-102.85,296.26
7370,68708795,2023-02-04,-140.43,155.83
2689,68708795,2023-02-04,-255.0,-99.16999999999999
3619,68708795,2023-02-05,-109.76,-208.93
4730,68708795,2023-02-07,-115.4,-324.33
5454,68708795,2023-02-08,-134.23,-458.56
2651,68708795,2023-02-09,-49.06,-507.62
5083,68708795,2023-02-10,-138.8,-646.4200000000001
2604,68708795,2023-02-14,-1297.2,-1943.6200000000001
1952,68721707,2023-01-31,,900.45
4829,68721707,2023-02-03,113.78,1014.23
4666,68721707,2023-02-09,69.99,1084.22
3207,68721707,2023-02-10,-113.56,970.6600000000001
1953,68775529,2023-01-31,,531.87
3393,68775529,2023-02-03,1266.7,1798.5700000000002
1492,68775529,2023-02-07,-113.79,1684.78
4643,68775529,2023-02-08,-48.01,1636.77
1272,68775529,2023-02-09,512.3,2149.0699999999997
4964,68775529,2023-02-09,124.1,2273.17
212,68775529,2023-02-10,129.33,2402.5
6972,68775529,2023-02-11,60.41,2462.91
208,68775529,2023-02-12,178.37,2641.2799999999997
1954,68786878,2023-01-31,,512.06
7879,68786878,2023-02-03,44.25,556.31
8469,68786878,2023-02-12,79.12,635.43
3204,68786878,2023-02-12,66.27,701.6999999999999
849,68786878,2023-02-14,-58.68,643.02
1955,68793483,2023-01-31,,581.36
1980,68793483,2023-02-02,-983.3,-401.93999999999994
5867,68793483,2023-02-03,185.02,-216.91999999999993
4351,68793483,2023-02-03,119.95,-96.96999999999993
1116,68793483,2023-02-08,68.31,-28.659999999999926
3456,68793483,2023-02-08,-110.48,-139.13999999999993
4835,68793483,2023-02-09,140.49,1.3500000000000796
2043,68793483,2023-02-09,-123.28,-121.92999999999992
1390,68793483,2023-02-10,116.54,-5.389999999999915
2368,68793483,2023-02-11,-626.6,-631.9899999999999
2407,68793483,2023-02-13,99.13,-532.8599999999999
6115,68793483,2023-02-14,130.44,-402.4199999999999
7396,68793483,2023-02-14,-59.81,-462.2299999999999
2622,68793483,2023-02-14,-131.83,-594.06
1956,68798691,2023-01-31,,819.33
7927,68798691,2023-02-01,-112.52,706.8100000000001
4468,68798691,2023-02-04,-7.74,699.07
454,68798691,2023-02-05,-124.83,574.24
3085,68798691,2023-02-07,123.45,697.69
533,68798691,2023-02-07,53.14,750.83
6293,68798691,2023-02-11,-33.64,717.19
3760,68798691,2023-02-11,-36.07,681.12
4852,68798691,2023-02-12,-147.45,533.6700000000001
6522,68798691,2023-02-14,71.41,605.08
3109,68798691,2023-02-14,47.84,652.9200000000001
5996,68798691,2023-02-14,-56.66,596.2600000000001
1957,68800062,2023-01-31,,749.65
6674,68800062,2023-02-04,165.76,915.41
5698,68800062,2023-02-04,-668.8,246.61
3007,68800062,2023-02-05,149.41,396.02
2330,68800062,2023-02-05,-276.4,119.62
7786,68800062,2023-02-06,-73.11,46.510000000000005
6019,68800062,2023-02-08,164.35,210.86
1905,68800062,2023-02-08,-116.37,94.48999999999998
7557,68800062,2023-02-09,109.08,203.57
3392,68800062,2023-02-09,100.36,303.92999999999995
890,68800062,2023-02-13,123.49,427.41999999999996
1958,68836810,2023-01-31,,171.96
2067,68836810,2023-02-02,-128.3,43.66
5577,68836810,2023-02-04,89.11,132.76999999999998
1959,68891568,2023-01-31,,844.06
520,68891568,2023-02-02,-58.4,785.66
3738,68891568,2023-02-03,121.82,907.4799999999999
6754,68891568,2023-02-09,-12.23,895.2499999999999
3164,68891568,2023-02-13,38.13,933.3799999999999
6225,68891568,2023-02-13,-30.41,902.9699999999999
3322,68891568,2023-02-13,-77.23,825.7399999999999
1960,68928221,2023-01-31,,502.06
931,68928221,2023-02-02,236.79,738.85
3719,68928221,2023-02-02,-82.11,656.74
1924,68928221,2023-02-04,-104.53,552.21
5841,68928221,2023-02-06,171.3,723.51
5398,68928221,2023-02-08,106.98,830.49
6777,68928221,2023-02-09,46.08,876.5699999999999
5096,68928221,2023-02-11,-70.39,806.18
8109,68928221,2023-02-12,99.99,906.17
2562,68928221,2023-02-14,150.77,1056.94
4493,68928221,2023-02-14,63.0,1119.94
1961,68962066,2023-01-31,,304.46
5404,68962066,2023-02-02,699.5,1003.96
6069,68962066,2023-02-03,-61.91,942.0500000000001
8664,68962066,2023-02-06,197.61,1139.66
2580,68962066,2023-02-06,-441.4,698.2600000000001
5526,68962066,2023-02-07,141.05,839.3100000000002
4057,68962066,2023-02-08,220.34,1059.65
4036,68962066,2023-02-09,-103.84,955.8100000000002
4950,68962066,2023-02-09,-125.24,830.5700000000002
7304,68962066,2023-02-12,-36.02,794.5500000000001
5250,68962066,2023-02-12,-45.23,749.3200000000002
3782,68962066,2023-02-14,-75.98,673.3400000000001
1962,68973836,2023-01-31,,634.67
7538,68973836,2023-02-01,116.57,751.24
8549,68973836,2023-02-03,955.4,1706.6399999999999
7339,68973836,2023-02-04,-157.26,1549.3799999999999
711,68973836,2023-02-05,115.12,1664.5
3273,68973836,2023-02-05,82.33,1746.83
4559,68973836,2023-02-10,-62.01,1684.82
5727,68973836,2023-02-11,1273.1,2957.92
3560,68973836,2023-02-13,-72.81,2885.1099999999997
1963,69008969,2023-01-31,,716.37
5202,69008969,2023-02-02,-128.03,588.34
6279,69008969,2023-02-03,-157.15,431.19
7922,69008969,2023-02-07,-88.5,342.69
875,69008969,2023-02-09,58.69,401.38
7869,69008969,2023-02-10,-143.62,257.76
6972,69008969,2023-02-11,-60.41,197.35
4629,69008969,2023-02-14,67.7,265.05
1964,69090518,2023-01-31,,473.87
1185,69090518,2023-02-04,-124.74,349.13
397,69090518,2023-02-05,-59.47,289.66
2115,69090518,2023-02-07,127.45,417.11
6909,69090518,2023-02-09,99.11,516.22
218,69090518,2023-02-10,20.05,536.27
3870,69090518,2023-02-13,-157.27,379.0
1965,69118170,2023-01-31,,109.35
5050,69118170,2023-02-01,151.41,260.76
3677,69118170,2023-02-02,-56.3,204.45999999999998
6496,69118170,2023-02-06,-1161.4,-956.94
3398,69118170,2023-02-07,86.51,-870.4300000000001
724,69118170,2023-02-08,110.44,-759.99
2843,69118170,2023-02-10,-180.0,-939.99
3821,69118170,2023-02-11,-130.27,-1070.26
1478,69118170,2023-02-14,439.8,-630.46
1966,69153577,2023-01-31,,402.52
6475,69153577,2023-02-05,-112.45,290.07
2849,69153577,2023-02-07,136.09,426.15999999999997
1967,69302678,2023-01-31,,568.08
4472,69302678,2023-02-05,62.49,630.57
4166,69302678,2023-02-10,86.78,717.35
1435,69302678,2023-02-11,213.76,931.11
5382,69302678,2023-02-12,132.03,1063.14
7991,69302678,2023-02-13,62.72,1125.8600000000001
1968,69306093,2023-01-31,,189.46
2274,69306093,2023-02-05,161.46,350.92
6342,69306093,2023-02-12,-20.96,329.96000000000004
1969,69307050,2023-01-31,,623.84
357,69307050,2023-02-02,-62.13,561.71
552,69307050,2023-02-02,-86.31,475.40000000000003
1445,69307050,2023-02-09,60.37,535.77
2647,69307050,2023-02-09,49.28,585.0500000000001
3660,69307050,2023-02-11,73.66,658.71
5091,69307050,2023-02-12,103.74,762.45
1860,69307050,2023-02-14,122.88,885.33
1970,69315008,2023-01-31,,923.08
7280,69315008,2023-02-01,1052.6,1975.6799999999998
6932,69315008,2023-02-01,-72.79,1902.8899999999999
7088,69315008,2023-02-02,180.4,2083.29
7863,69315008,2023-02-05,101.45,2184.74
3,69315008,2023-02-07,-85.76,2098.98
5946,69315008,2023-02-09,-190.82,1908.1599999999999
7412,69315008,2023-02-12,139.75,2047.9099999999999
1971,69344396,2023-01-31,,304.19
6240,69344396,2023-02-02,1190.9,1495.0900000000001
1355,69344396,2023-02-03,97.42,1592.5100000000002
6785,69344396,2023-02-05,-138.9,1453.6100000000001
666,69344396,2023-02-06,840.3,2293.91
583,69344396,2023-02-10,87.07,2380.98
3324,69344396,2023-02-11,160.29,2541.27
6447,69344396,2023-02-11,78.29,2619.56
3764,69344396,2023-02-12,210.36,2829.92
3899,69344396,2023-02-12,118.77,2948.69
6198,69344396,2023-02-12,-44.88,2903.81
6378,69344396,2023-02-14,98.11,3001.92
1972,69362270,2023-01-31,,410.6
6862,69362270,2023-02-02,-179.0,231.60000000000002
5144,69362270,2023-02-05,-17.25,214.35000000000002
2155,69362270,2023-02-10,26.55,240.90000000000003
2165,69362270,2023-02-11,133.78,374.68000000000006
4389,69362270,2023-02-14,-126.46,248.22000000000003
1973,69446767,2023-01-31,,672.47
8655,69446767,2023-02-02,83.44,755.9100000000001
1304,69446767,2023-02-06,22.45,778.36
223,69446767,2023-02-07,101.82,880.1800000000001
3776,69446767,2023-02-09,107.86,988.04
1565,69446767,2023-02-10,-137.34,850.7
7075,69446767,2023-02-11,-113.8,736.9
1829,69446767,2023-02-14,-141.48,595.4200000000001
1974,69447534,2023-01-31,,68.02
959,69447534,2023-02-01,-105.36,-37.34
3738,69447534,2023-02-03,-121.82,-159.16
2381,69447534,2023-02-11,-68.33,-227.49
3921,69447534,2023-02-12,101.4,-126.08999999999999
1432,69447534,2023-02-13,-38.04,-164.13
1975,69468071,2023-01-31,,652.9
7542,69468071,2023-02-04,-81.16,571.74
3741,69468071,2023-02-05,111.92,683.66
4923,69468071,2023-02-06,1791.9,2475.56
6797,69468071,2023-02-06,137.34,2612.9
3160,69468071,2023-02-06,-67.45,2545.45
1107,69468071,2023-02-07,69.39,2614.84
6927,69468071,2023-02-08,166.6,2781.44
102,69468071,2023-02-09,-36.71,2744.73
4478,69468071,2023-02-12,-16.68,2728.0499999999997
715,69468071,2023-02-13,98.15,2826.2
1976,69492532,2023-01-31,,581.23
6861,69492532,2023-02-04,-119.25,461.98
4322,69492532,2023-02-11,-84.22,377.76
7862,69492532,2023-02-12,-200.04,177.72000000000003
1977,69533742,2023-01-31,,812.2
5852,69533742,2023-02-01,1397.4,2209.6000000000004
1556,69533742,2023-02-01,-12.21,2197.3900000000003
5024,69533742,2023-02-01,-96.51,2100.88
3608,69533742,2023-02-03,-175.55,1925.3300000000002
6066,69533742,2023-02-04,-82.56,1842.7700000000002
7159,69533742,2023-02-05,112.73,1955.5000000000002
2192,69533742,2023-02-06,129.51,2085.01
4779,69533742,2023-02-07,-98.42,1986.5900000000001
6411,69533742,2023-02-11,-65.15,1921.44
2522,69533742,2023-02-11,-75.14,1846.3000000000002
1978,69540137,2023-01-31,,351.36
1143,69540137,2023-02-02,109.28,460.64
1651,69540137,2023-02-06,473.7,934.34
2601,69540137,2023-02-06,51.71,986.0500000000001
2865,69540137,2023-02-07,173.55,1159.6000000000001
4588,69540137,2023-02-07,141.99,1301.5900000000001
3676,69540137,2023-02-11,32.04,1333.63
8204,69540137,2023-02-14,1314.7,2648.33
1979,69556322,2023-01-31,,785.03
6665,69556322,2023-02-01,102.91,887.9399999999999
6994,69556322,2023-02-02,24.87,912.81
7469,69556322,2023-02-03,112.15,1024.96
7611,69556322,2023-02-03,66.67,1091.6299999999999
8011,69556322,2023-02-06,68.0,1159.6299999999999
1691,69556322,2023-02-12,-125.48,1034.15
7330,69556322,2023-02-13,-62.36,971.79
3589,69556322,2023-02-14,1478.2,2449.99
4008,69556322,2023-02-14,1145.9,3595.8900000000003
1980,69561077,2023-01-31,,318.31
5181,69561077,2023-02-01,125.38,443.69
482,69561077,2023-02-03,23.5,467.19
6161,69561077,2023-02-04,37.8,504.99
4547,69561077,2023-02-05,1917.1,2422.09
5569,69561077,2023-02-08,-167.35,2254.74
3485,69561077,2023-02-09,-56.02,2198.72
3781,69561077,2023-02-10,75.83,2274.5499999999997
5184,69561077,2023-02-11,132.56,2407.11
8214,69561077,2023-02-11,-104.82,2302.29
5433,69561077,2023-02-12,143.91,2446.2
1981,69588947,2023-01-31,,732.72
7245,69588947,2023-02-08,-66.6,666.12
8118,69588947,2023-02-09,-97.55,568.57
3375,69588947,2023-02-09,-114.45,454.12
8125,69588947,2023-02-10,-8.85,445.27000000000004
1982,69617552,2023-01-31,,853.9
4933,69617552,2023-02-03,-89.23,764.67
3529,69617552,2023-02-06,-96.79,667.88
5276,69617552,2023-02-08,-61.4,606.48
1581,69617552,2023-02-09,108.57,715.05
7937,69617552,2023-02-14,-188.3,526.75
1983,69647833,2023-01-31,,765.74
4793,69647833,2023-02-01,84.44,850.1800000000001
950,69647833,2023-02-03,54.41,904.59
1596,69647833,2023-02-06,-160.08,744.51
4270,69647833,2023-02-07,170.65,915.16
7581,69647833,2023-02-07,-136.97,778.19
4193,69647833,2023-02-13,115.44,893.63
4900,69647833,2023-02-13,-107.16,786.47
1984,69648759,2023-01-31,,693.39
4886,69648759,2023-02-01,80.92,774.31
1063,69648759,2023-02-10,-155.67,618.64
7569,69648759,2023-02-13,-1503.2,-884.5600000000001
1984,69648759,2023-02-14,163.34,-721.22
8522,69648759,2023-02-14,-126.03,-847.25
1985,69664627,2023-01-31,,897.76
1543,69664627,2023-02-01,-130.78,766.98
1790,69664627,2023-02-07,218.78,985.76
5699,69664627,2023-02-10,28.25,1014.01
6820,69664627,2023-02-12,1482.9,2496.91
2077,69664627,2023-02-13,-163.99,2332.92
1986,69665438,2023-01-31,,417.78
1208,69665438,2023-02-01,-99.56,318.21999999999997
329,69665438,2023-02-01,-158.57,159.64999999999998
4023,69665438,2023-02-05,-75.94,83.70999999999998
1987,69683385,2023-01-31,,519.63
1637,69683385,2023-02-04,54.37,574.0
1419,69683385,2023-02-07,-102.9,471.1
1988,69730266,2023-01-31,,732.61
6236,69730266,2023-02-04,-95.37,637.24
5866,69730266,2023-02-07,-105.66,531.58
1717,69730266,2023-02-09,102.69,634.27
5726,69730266,2023-02-12,-79.75,554.52
1989,69796371,2023-01-31,,649.23
2851,69796371,2023-02-02,-94.57,554.6600000000001
1982,69796371,2023-02-03,60.17,614.83
8341,69796371,2023-02-04,1412.5,2027.33
3619,69796371,2023-02-05,109.76,2137.09
1476,69796371,2023-02-06,182.28,2319.37
6217,69796371,2023-02-11,166.3,2485.67
2494,69796371,2023-02-14,2002.7,4488.37
1990,69806946,2023-01-31,,971.49
8467,69806946,2023-02-07,87.82,1059.31
7040,69806946,2023-02-08,-183.05,876.26
1991,69939682,2023-01-31,,854.18
3309,69939682,2023-02-01,94.91,949.0899999999999
5974,69939682,2023-02-01,-120.13,828.9599999999999
5868,69939682,2023-02-08,-5.73,823.2299999999999
5203,69939682,2023-02-09,-143.77,679.4599999999999
7029,69939682,2023-02-11,-214.9,464.55999999999995
1992,70010970,2023-01-31,,114.23
1787,70010970,2023-02-06,-128.7,-14.469999999999985
5995,70010970,2023-02-08,-69.02,-83.48999999999998
7520,70010970,2023-02-11,-181.68,-265.16999999999996
1993,70013367,2023-01-31,,38.86
6116,70013367,2023-02-04,-70.76,-31.900000000000006
8171,70013367,2023-02-06,660.3,628.4
892,70013367,2023-02-06,138.83,767.23
5402,70013367,2023-02-09,140.35,907.5799999999999
5162,70013367,2023-02-13,-96.06,811.52
1994,70034563,2023-01-31,,723.18
4725,70034563,2023-02-01,149.8,872.98
4762,70034563,2023-02-02,-122.42,750.56
1606,70034563,2023-02-04,96.09,846.65
8615,70034563,2023-02-05,-137.98,708.67
8145,70034563,2023-02-13,-182.14,526.53
1995,70049609,2023-01-31,,226.63
491,70049609,2023-02-07,89.73,316.36
1021,70049609,2023-02-07,75.13,391.49
4499,70049609,2023-02-10,-84.17,307.32
1055,70049609,2023-02-10,-109.89,197.43
3117,70049609,2023-02-13,101.66,299.09
5885,70049609,2023-02-14,103.89,402.98
1996,70123664,2023-01-31,,483.12
8106,70123664,2023-02-01,-122.51,360.61
2779,70123664,2023-02-02,-127.28,233.32999999999998
3041,70123664,2023-02-03,-114.58,118.75
4086,70123664,2023-02-04,24.31,143.06
5639,70123664,2023-02-08,-209.01,-65.94999999999999
1997,70129567,2023-01-31,,886.92
5118,70129567,2023-02-01,52.32,939.24
5473,70129567,2023-02-03,-98.67,840.5699999999999
7005,70129567,2023-02-04,-133.05,707.52
7252,70129567,2023-02-06,100.59,808.1099999999999
8114,70129567,2023-02-08,-149.26,658.8499999999999
1912,70129567,2023-02-09,175.39,834.24
8019,70129567,2023-02-10,65.29,899.53
7345,70129567,2023-02-10,-47.22,852.31
7029,70129567,2023-02-11,214.9,1067.21
3602,70129567,2023-02-11,-125.65,941.56
810,70129567,2023-02-12,35.17,976.73
1998,70163139,2023-01-31,,674.14
253,70163139,2023-02-01,85.94,760.0799999999999
283,70163139,2023-02-05,116.16,876.24
5237,70163139,2023-02-06,-31.91,844.3299999999999
3598,70163139,2023-02-07,121.65,965.98
1056,70163139,2023-02-11,158.58,1124.56
8389,70163139,2023-02-11,100.86,1225.42
2525,70163139,2023-02-11,55.33,1280.75
346,70163139,2023-02-12,170.4,1451.15
4321,70163139,2023-02-12,64.23,1515.38
3968,70163139,2023-02-14,48.39,1563.77
1999,70185446,2023-01-31,,863.26
855,70185446,2023-02-08,191.64,1054.9
7436,70185446,2023-02-09,97.29,1152.19
3848,70185446,2023-02-11,96.92,1249.11
2000,70214700,2023-01-31,,152.79
580,70214700,2023-02-01,-1255.3,-1102.51
6828,70214700,2023-02-02,-84.59,-1187.1
210,70214700,2023-02-06,-1498.3,-2685.3999999999996
8319,70214700,2023-02-07,-89.15,-2774.5499999999997
5148,70214700,2023-02-12,127.0,-2647.5499999999997
4479,70214700,2023-02-14,33.09,-2614.46
7957,70214700,2023-02-14,-102.53,-2716.99
2001,70217229,2023-01-31,,705.69
3115,70217229,2023-02-02,190.9,896.59
660,70217229,2023-02-02,167.22,1063.81
6796,70217229,2023-02-03,-127.58,936.23
6102,70217229,2023-02-06,59.52,995.7500000000001
137,70217229,2023-02-12,129.61,1125.3600000000001
6144,70217229,2023-02-12,-491.6,633.76
1173,70217229,2023-02-14,-46.61,587.1500000000001
2002,70221848,2023-01-31,,550.83
5757,70221848,2023-02-01,69.91,620.74
3608,70221848,2023-02-03,175.55,796.2900000000001
5468,70221848,2023-02-05,23.13,819.4200000000001
8114,70221848,2023-02-08,149.26,968.6800000000001
2003,70231750,2023-01-31,,749.6
80,70231750,2023-02-02,187.19,936.79
4572,70231750,2023-02-03,-2128.4,-1191.6100000000001
3169,70231750,2023-02-04,-148.06,-1339.67
6401,70231750,2023-02-04,-1618.2,-2957.87
3141,70231750,2023-02-09,112.38,-2845.4900000000002
1608,70231750,2023-02-10,-192.08,-3037.57
1077,70231750,2023-02-11,100.04,-2937.53
2004,70331285,2023-01-31,,537.34
1314,70331285,2023-02-08,-74.39,462.95000000000005
3387,70331285,2023-02-09,121.13,584.08
7711,70331285,2023-02-10,56.59,640.6700000000001
7102,70331285,2023-02-14,-105.11,535.5600000000001
2005,70351135,2023-01-31,,169.6
4214,70351135,2023-02-01,3.89,173.48999999999998
7516,70351135,2023-02-05,128.72,302.21
1718,70351135,2023-02-13,-167.52,134.68999999999997
2006,70375931,2023-01-31,,980.21
1276,70375931,2023-02-05,92.89,1073.1000000000001
3868,70375931,2023-02-07,-152.96,920.1400000000001
8675,70375931,2023-02-11,87.16,1007.3000000000001
507,70375931,2023-02-13,159.46,1166.76
2007,70384410,2023-01-31,,718.99
5418,70384410,2023-02-04,122.2,841.19
4496,70384410,2023-02-04,-129.64,711.55
7920,70384410,2023-02-09,969.7,1681.25
2335,70384410,2023-02-11,-55.38,1625.87
8427,70384410,2023-02-13,153.4,1779.27
2008,70385129,2023-01-31,,252.45
7623,70385129,2023-02-01,121.46,373.90999999999997
5949,70385129,2023-02-08,25.37,399.28
2806,70385129,2023-02-10,134.99,534.27
2009,70409852,2023-01-31,,662.8
5623,70409852,2023-02-04,-81.35,581.4499999999999
1967,70409852,2023-02-06,137.14,718.5899999999999
5098,70409852,2023-02-09,-67.33,651.26
4421,70409852,2023-02-10,25.41,676.67
2182,70409852,2023-02-11,102.16,778.8299999999999
2010,70469258,2023-01-31,,868.53
2772,70469258,2023-02-04,-71.39,797.14
2554,70469258,2023-02-05,2112.8,2909.94
3288,70469258,2023-02-08,80.16,2990.1
5460,70469258,2023-02-09,-171.71,2818.39
6734,70469258,2023-02-10,-1575.6,1242.7900000000002
946,70469258,2023-02-14,-47.11,1195.6800000000003
2011,70505401,2023-01-31,,138.85
321,70505401,2023-02-04,113.98,252.82999999999998
321,70505401,2023-02-04,-113.98,138.85
7034,70505401,2023-02-11,123.81,262.65999999999997
4662,70505401,2023-02-11,-58.36,204.3
6672,70505401,2023-02-14,-884.5,-680.2
2012,70554021,2023-01-31,,44.26
3013,70554021,2023-02-05,129.49,173.75
1256,70554021,2023-02-06,-116.65,57.099999999999994
2079,70554021,2023-02-10,-1188.3,-1131.2
4080,70554021,2023-02-11,126.09,-1005.11
6323,70554021,2023-02-11,78.25,-926.86
941,70554021,2023-02-12,63.69,-863.1700000000001
2013,70567557,2023-01-31,,984.3
4138,70567557,2023-02-07,41.64,1025.94
6624,70567557,2023-02-08,185.22,1211.1599999999999
2845,70567557,2023-02-08,-87.73,1123.43
2074,70567557,2023-02-13,129.32,1252.75
449,70567557,2023-02-14,113.78,1366.53
2014,70571486,2023-01-31,,573.26
8306,70571486,2023-02-01,-52.17,521.09
5504,70571486,2023-02-07,-639.3,-118.20999999999992
8381,70571486,2023-02-10,-39.45,-157.6599999999999
977,70571486,2023-02-11,115.25,-42.409999999999926
4298,70571486,2023-02-12,47.25,4.8400000000000745
2015,70624878,2023-01-31,,328.5
7377,70624878,2023-02-01,-158.51,169.99
3415,70624878,2023-02-03,825.8,995.79
6898,70624878,2023-02-05,190.77,1186.56
7476,70624878,2023-02-08,190.88,1377.44
5647,70624878,2023-02-08,-94.34,1283.1
429,70624878,2023-02-08,-1051.3,231.79999999999995
2016,70643766,2023-01-31,,143.86
5259,70643766,2023-02-03,-192.08,-48.22
5033,70643766,2023-02-07,-140.14,-188.35999999999999
2017,70652524,2023-01-31,,342.86
362,70652524,2023-02-05,81.18,424.04
466,70652524,2023-02-05,76.23,500.27000000000004
2371,70652524,2023-02-07,61.37,561.64
6388,70652524,2023-02-11,89.98,651.62
4038,70652524,2023-02-12,104.46,756.08
2018,70665892,2023-01-31,,856.22
3998,70665892,2023-02-01,-165.66,690.5600000000001
2456,70665892,2023-02-04,45.03,735.59
6977,70665892,2023-02-08,113.92,849.51
3979,70665892,2023-02-09,1365.7,2215.21
5537,70665892,2023-02-11,-43.12,2172.09
5401,70665892,2023-02-12,245.7,2417.79
2019,70719064,2023-01-31,,752.97
4747,70719064,2023-02-02,1805.5,2558.4700000000003
2491,70719064,2023-02-02,-198.45,2360.02
4778,70719064,2023-02-04,-163.96,2196.06
7369,70719064,2023-02-06,965.2,3161.26
8586,70719064,2023-02-08,145.4,3306.6600000000003
1794,70719064,2023-02-11,40.22,3346.88
2020,70749706,2023-01-31,,963.82
8264,70749706,2023-02-01,-119.88,843.94
5884,70749706,2023-02-04,-122.23,721.71
1472,70749706,2023-02-07,-137.51,584.2
2687,70749706,2023-02-09,-150.23,433.97
7274,70749706,2023-02-10,58.75,492.72
2549,70749706,2023-02-12,-91.93,400.7900000000001
2021,70905083,2023-01-31,,623.65
3778,70905083,2023-02-02,131.53,755.18
3400,70905083,2023-02-02,119.89,875.0699999999999
4993,70905083,2023-02-03,133.41,1008.48
405,70905083,2023-02-07,103.35,1111.83
2022,70920653,2023-01-31,,577.7
7958,70920653,2023-02-02,-88.8,488.90000000000003
5349,70920653,2023-02-04,-97.81,391.09000000000003
301,70920653,2023-02-10,123.77,514.86
2023,70925461,2023-01-31,,260.33
7989,70925461,2023-02-01,-66.84,193.48999999999998
6117,70925461,2023-02-03,97.5,290.99
2664,70925461,2023-02-06,134.68,425.66999999999996
7064,70925461,2023-02-06,46.16,471.83
6430,70925461,2023-02-06,-126.83,345.0
7799,70925461,2023-02-07,-154.41,190.58999999999997
3307,70925461,2023-02-08,121.98,312.57
3200,70925461,2023-02-08,-103.89,208.67999999999998
1434,70925461,2023-02-09,201.62,410.29999999999995
2654,70925461,2023-02-09,-287.8,122.5
1401,70925461,2023-02-12,-100.25,22.25
147,70925461,2023-02-12,-907.1,-884.85
2024,70954264,2023-01-31,,331.51
8092,70954264,2023-02-01,-142.91,188.6
3263,70954264,2023-02-02,-81.2,107.39999999999999
1240,70954264,2023-02-08,-35.81,71.58999999999999
4788,70954264,2023-02-10,113.81,185.39999999999998
7781,70954264,2023-02-10,-64.46,120.94
6562,70954264,2023-02-10,-90.32,30.620000000000005
1057,70954264,2023-02-12,-76.6,-45.97999999999999
2800,70954264,2023-02-12,-82.91,-128.89
4043,70954264,2023-02-13,-101.48,-230.37
2025,70989002,2023-01-31,,220.06
8491,70989002,2023-02-03,-134.37,85.69
4573,70989002,2023-02-04,134.48,220.17
716,70989002,2023-02-04,-111.19,108.97999999999999
2876,70989002,2023-02-05,298.3,407.28
6028,70989002,2023-02-05,102.18,509.46000000000004
1256,70989002,2023-02-06,116.65,626.11
5348,70989002,2023-02-12,-87.73,538.38
5195,70989002,2023-02-13,156.04,694.4200000000001
2026,71014167,2023-01-31,,654.16
2774,71014167,2023-02-01,58.05,712.2099999999999
2718,71014167,2023-02-02,72.72,784.93
3432,71014167,2023-02-04,-118.37,666.56
3822,71014167,2023-02-06,-46.33,620.23
733,71014167,2023-02-07,122.53,742.76
644,71014167,2023-02-12,-84.75,658.01
6188,71014167,2023-02-14,80.98,738.99
2027,71045135,2023-01-31,,98.76
3296,71045135,2023-02-11,-43.47,55.290000000000006
8377,71045135,2023-02-11,-989.3,-934.01
5364,71045135,2023-02-12,54.92,-879.09
6173,71045135,2023-02-14,-133.71,-1012.8
2028,71051904,2023-01-31,,48.92
6758,71051904,2023-02-02,-93.84,-44.92
8325,71051904,2023-02-06,102.1,57.17999999999999
2342,71051904,2023-02-08,117.36,174.54
1308,71051904,2023-02-13,-2.26,172.28
2029,71082437,2023-01-31,,717.98
716,71082437,2023-02-04,111.19,829.1700000000001
8328,71082437,2023-02-06,-51.53,777.64
5016,71082437,2023-02-11,111.11,888.75
8454,71082437,2023-02-11,-122.42,766.33
3974,71082437,2023-02-12,96.6,862.9300000000001
7219,71082437,2023-02-13,-76.11,786.82
2030,71135606,2023-01-31,,728.32
2507,71135606,2023-02-02,-99.44,628.8800000000001
5015,71135606,2023-02-02,-104.5,524.3800000000001
8158,71135606,2023-02-04,-47.16,477.22
949,71135606,2023-02-08,-65.06,412.1600000000001
2756,71135606,2023-02-09,159.05,571.21
3495,71135606,2023-02-09,66.83,638.0400000000001
4024,71135606,2023-02-12,-26.59,611.45
4045,71135606,2023-02-12,-116.83,494.62000000000006
6591,71135606,2023-02-13,73.19,567.8100000000001
2031,71137421,2023-01-31,,65.44
4732,71137421,2023-02-01,61.08,126.52
4425,71137421,2023-02-02,109.29,235.81
10,71137421,2023-02-02,-27.44,208.37
8168,71137421,2023-02-07,53.78,262.15
8426,71137421,2023-02-07,-79.99,182.16000000000003
4385,71137421,2023-02-07,-949.2,-767.04
6536,71137421,2023-02-08,190.12,-576.92
8025,71137421,2023-02-14,-123.69,-700.6099999999999
2032,71161073,2023-01-31,,861.98
1254,71161073,2023-02-01,-99.52,762.46
6049,71161073,2023-02-02,-94.2,668.26
5756,71161073,2023-02-09,191.29,859.55
2033,71183710,2023-01-31,,989.68
4411,71183710,2023-02-02,-77.54,912.14
4170,71183710,2023-02-03,5.31,917.4499999999999
7763,71183710,2023-02-03,-65.8,851.65
874,71183710,2023-02-04,-143.95,707.6999999999999
8011,71183710,2023-02-06,-68.0,639.6999999999999
2051,71183710,2023-02-07,-86.52,553.18
6097,71183710,2023-02-08,68.68,621.86
938,71183710,2023-02-13,-77.91,543.9499999999999
2034,71213535,2023-01-31,,686.81
5062,71213535,2023-02-07,83.34,770.15
7262,71213535,2023-02-08,218.9,989.05
1229,71213535,2023-02-08,136.73,1125.78
2035,71247681,2023-01-31,,955.43
4220,71247681,2023-02-03,-114.47,840.9599999999999
8567,71247681,2023-02-11,-130.08,710.8799999999999
5554,71247681,2023-02-14,-93.52,617.3599999999999
2036,71264941,2023-01-31,,195.49
3410,71264941,2023-02-01,170.89,366.38
5786,71264941,2023-02-01,160.38,526.76
7438,71264941,2023-02-01,92.64,619.4
6720,71264941,2023-02-06,-33.32,586.08
525,71264941,2023-02-10,19.72,605.8
3675,71264941,2023-02-11,196.49,802.29
226,71264941,2023-02-11,101.84,904.13
6643,71264941,2023-02-11,-6.42,897.71
4376,71264941,2023-02-11,-222.05,675.66
2037,71266283,2023-01-31,,496.77
4671,71266283,2023-02-04,1218.0,1714.77
6311,71266283,2023-02-05,134.86,1849.63
2473,71266283,2023-02-07,-151.33,1698.3
4476,71266283,2023-02-09,105.21,1803.51
1152,71266283,2023-02-09,-61.15,1742.36
7770,71266283,2023-02-13,138.97,1881.33
4729,71266283,2023-02-13,18.04,1899.37
3463,71266283,2023-02-13,-223.88,1675.49
2038,71280775,2023-01-31,,427.44
7763,71280775,2023-02-03,65.8,493.24
4381,71280775,2023-02-03,-124.88,368.36
3169,71280775,2023-02-04,148.06,516.4200000000001
1093,71280775,2023-02-05,-114.23,402.19
7069,71280775,2023-02-06,127.87,530.0600000000001
5405,71280775,2023-02-06,91.85,621.91
3490,71280775,2023-02-06,-1176.9,-554.9900000000001
2196,71280775,2023-02-09,112.69,-442.3000000000001
2039,71293250,2023-01-31,,686.0
6534,71293250,2023-02-04,-5.86,680.14
1158,71293250,2023-02-06,120.15,800.29
1106,71293250,2023-02-08,90.09,890.38
6146,71293250,2023-02-11,-99.36,791.02
2040,71332337,2023-01-31,,661.23
1513,71332337,2023-02-07,-1434.3,-773.0699999999999
739,71332337,2023-02-08,113.65,-659.42
8515,71332337,2023-02-08,-195.95,-855.3699999999999
7275,71332337,2023-02-10,88.33,-767.04
6437,71332337,2023-02-12,120.12,-646.92
1732,71332337,2023-02-14,-95.87,-742.79
2041,71381278,2023-01-31,,592.79
7611,71381278,2023-02-03,-66.67,526.12
8004,71381278,2023-02-09,82.1,608.2199999999999
3705,71381278,2023-02-11,1243.0,1851.2199999999998
2810,71381278,2023-02-11,-190.18,1661.0399999999997
5401,71381278,2023-02-12,-245.7,1415.3399999999997
4402,71381278,2023-02-14,125.94,1541.2799999999997
2042,71383376,2023-01-31,,448.26
3629,71383376,2023-02-01,-170.96,277.29999999999995
4797,71383376,2023-02-03,1619.6,1896.8999999999999
2967,71383376,2023-02-04,-884.9,1011.9999999999999
5810,71383376,2023-02-07,92.7,1104.6999999999998
7998,71383376,2023-02-09,-105.71,998.9899999999999
7301,71383376,2023-02-10,94.14,1093.1299999999999
4482,71383376,2023-02-11,39.58,1132.7099999999998
2043,71394875,2023-01-31,,778.77
7181,71394875,2023-02-01,-112.34,666.43
7806,71394875,2023-02-03,165.51,831.9399999999999
566,71394875,2023-02-04,40.15,872.0899999999999
8650,71394875,2023-02-05,68.75,940.8399999999999
978,71394875,2023-02-06,-144.68,796.16
8290,71394875,2023-02-13,158.03,954.1899999999999
8167,71394875,2023-02-14,-67.36,886.8299999999999
2044,71444662,2023-01-31,,276.78
7114,71444662,2023-02-01,-101.08,175.7
3867,71444662,2023-02-02,-116.0,59.699999999999974
1786,71444662,2023-02-04,-1131.3,-1071.6
6854,71444662,2023-02-07,87.19,-984.4099999999999
4930,71444662,2023-02-12,-67.65,-1052.06
2596,71444662,2023-02-13,181.51,-870.55
5093,71444662,2023-02-14,-124.76,-995.31
2045,71469803,2023-01-31,,14.79
1832,71469803,2023-02-05,151.15,165.94
7035,71469803,2023-02-05,-118.02,47.92
4055,71469803,2023-02-11,-191.93,-144.01
8308,71469803,2023-02-14,141.49,-2.519999999999982
1342,71469803,2023-02-14,-64.89,-67.40999999999998
2046,71536854,2023-01-31,,42.99
5172,71536854,2023-02-06,-93.96,-50.96999999999999
1762,71536854,2023-02-10,-181.0,-231.97
5397,71536854,2023-02-11,142.47,-89.5
1163,71536854,2023-02-11,-112.1,-201.6
2047,71562080,2023-01-31,,352.05
3761,71562080,2023-02-04,63.81,415.86
6208,71562080,2023-02-09,101.51,517.37
557,71562080,2023-02-14,-135.72,381.65000000000003
2048,71594658,2023-01-31,,392.66
877,71594658,2023-02-07,67.95,460.61
1222,71594658,2023-02-10,-93.37,367.24
1910,71594658,2023-02-11,36.36,403.6
7943,71594658,2023-02-11,-102.91,300.69000000000005
7168,71594658,2023-02-12,108.19,408.88
7539,71594658,2023-02-12,81.87,490.75
2590,71594658,2023-02-14,-7.26,483.49
2049,71643841,2023-01-31,,232.5
5044,71643841,2023-02-03,161.37,393.87
6913,71643841,2023-02-06,-113.63,280.24
5826,71643841,2023-02-12,71.39,351.63
3504,71643841,2023-02-13,125.16,476.79
6728,71643841,2023-02-14,-1308.6,-831.81
2050,71675127,2023-01-31,,353.48
2322,71675127,2023-02-02,143.95,497.43
8066,71675127,2023-02-07,-171.53,325.9
5043,71675127,2023-02-11,82.38,408.28
2051,71718483,2023-01-31,,747.34
714,71718483,2023-02-01,1089.6,1836.94
5524,71718483,2023-02-02,1193.3,3030.24
2851,71718483,2023-02-02,94.57,3124.81
2096,71718483,2023-02-02,-100.61,3024.2
4311,71718483,2023-02-02,-112.35,2911.85
5456,71718483,2023-02-09,42.25,2954.1
8444,71718483,2023-02-12,90.33,3044.43
1718,71718483,2023-02-13,167.52,3211.95
2052,71791483,2023-01-31,,873.44
1119,71791483,2023-02-03,99.93,973.3700000000001
371,71791483,2023-02-04,-34.64,938.73
4063,71791483,2023-02-12,-86.27,852.46
2053,71792376,2023-01-31,,4.39
3337,71792376,2023-02-02,-50.71,-46.32
573,71792376,2023-02-03,-76.87,-123.19
3768,71792376,2023-02-07,74.77,-48.42
5985,71792376,2023-02-09,-68.62,-117.04
1547,71792376,2023-02-09,-160.1,-277.14
4558,71792376,2023-02-11,52.48,-224.66000000000003
8583,71792376,2023-02-11,-84.08,-308.74
4110,71792376,2023-02-14,90.48,-218.26
2054,71825742,2023-01-31,,665.75
1452,71825742,2023-02-02,198.28,864.03
139,71825742,2023-02-08,-968.8,-104.76999999999998
2055,71852263,2023-01-31,,676.77
4243,71852263,2023-02-10,42.14,718.91
1707,71852263,2023-02-14,163.23,882.14
2056,71868471,2023-01-31,,474.32
5523,71868471,2023-02-05,-1315.1,-840.78
7178,71868471,2023-02-07,189.62,-651.16
184,71868471,2023-02-08,196.25,-454.90999999999997
7385,71868471,2023-02-11,-121.25,-576.16
6163,71868471,2023-02-12,7.59,-568.5699999999999
2057,71913103,2023-01-31,,5.42
2299,71913103,2023-02-02,117.49,122.91
4753,71913103,2023-02-06,121.13,244.04
6956,71913103,2023-02-07,127.37,371.40999999999997
4467,71913103,2023-02-08,40.97,412.38
2058,71934515,2023-01-31,,340.99
397,71934515,2023-02-05,59.47,400.46000000000004
2609,71934515,2023-02-06,-1011.5,-611.04
1141,71934515,2023-02-08,150.55,-460.48999999999995
2373,71934515,2023-02-08,-358.9,-819.3899999999999
8004,71934515,2023-02-09,-82.1,-901.4899999999999
2059,71939863,2023-01-31,,116.31
7960,71939863,2023-02-01,136.22,252.53
2765,71939863,2023-02-05,110.09,362.62
7591,71939863,2023-02-06,995.2,1357.8200000000002
2302,71939863,2023-02-11,102.84,1460.66
2060,72008772,2023-01-31,,725.22
1594,72008772,2023-02-01,-110.9,614.32
973,72008772,2023-02-03,1791.6,2405.92
6874,72008772,2023-02-04,-112.22,2293.7000000000003
5432,72008772,2023-02-06,95.71,2389.41
6768,72008772,2023-02-06,60.85,2450.26
5989,72008772,2023-02-09,83.64,2533.9
1912,72008772,2023-02-09,-175.39,2358.51
4928,72008772,2023-02-13,81.86,2440.37
5439,72008772,2023-02-14,-113.47,2326.9
2061,72050477,2023-01-31,,95.87
7265,72050477,2023-02-03,-106.6,-10.72999999999999
7281,72050477,2023-02-08,156.86,146.13000000000002
2062,72055977,2023-01-31,,172.73
1729,72055977,2023-02-09,624.2,796.9300000000001
1064,72055977,2023-02-09,108.23,905.1600000000001
7578,72055977,2023-02-10,-178.01,727.1500000000001
7675,72055977,2023-02-11,78.66,805.8100000000001
2063,72087700,2023-01-31,,359.55
6965,72087700,2023-02-06,160.25,519.8
8279,72087700,2023-02-07,229.29,749.09
8330,72087700,2023-02-09,25.58,774.67
4033,72087700,2023-02-12,-109.9,664.77
6308,72087700,2023-02-13,125.92,790.69
2064,72120467,2023-01-31,,340.15
743,72120467,2023-02-04,-75.25,264.9
1180,72120467,2023-02-11,-125.55,139.34999999999997
2065,72164482,2023-01-31,,535.39
6821,72164482,2023-02-02,-83.79,451.59999999999997
6391,72164482,2023-02-09,-951.0,-499.40000000000003
1844,72164482,2023-02-10,-89.11,-588.51
6930,72164482,2023-02-12,643.6,55.09000000000003
2066,72176895,2023-01-31,,109.78
344,72176895,2023-02-03,64.91,174.69
7367,72176895,2023-02-09,160.54,335.23
4765,72176895,2023-02-09,-38.14,297.09
2162,72176895,2023-02-13,150.38,447.46999999999997
1182,72176895,2023-02-13,-837.4,-389.93
2067,72208029,2023-01-31,,11.37
2743,72208029,2023-02-01,0.5,11.87
8053,72208029,2023-02-02,-181.62,-169.75
3377,72208029,2023-02-05,-139.1,-308.85
1760,72208029,2023-02-06,66.16,-242.69
7363,72208029,2023-02-06,-1024.2,-1266.89
493,72208029,2023-02-09,-140.11,-1407.0
7137,72208029,2023-02-09,-173.88,-1580.88
7277,72208029,2023-02-10,-80.36,-1661.24
8607,72208029,2023-02-13,-102.22,-1763.46
4356,72208029,2023-02-14,-141.62,-1905.0800000000002
2068,72230395,2023-01-31,,773.55
5560,72230395,2023-02-03,155.02,928.5699999999999
243,72230395,2023-02-03,-130.74,797.8299999999999
4771,72230395,2023-02-09,-53.95,743.88
1008,72230395,2023-02-11,-86.69,657.1899999999999
3497,72230395,2023-02-13,-518.3,138.89
1489,72230395,2023-02-14,-597.7,-458.81000000000006
2069,72268811,2023-01-31,,694.68
7109,72268811,2023-02-02,-62.04,632.64
2796,72268811,2023-02-02,-151.37,481.27
1211,72268811,2023-02-03,133.85,615.1199999999999
2153,72268811,2023-02-08,70.08,685.1999999999999
2716,72268811,2023-02-09,-134.21,550.99
3237,72268811,2023-02-11,132.94,683.93
6658,72268811,2023-02-12,84.13,768.06
2070,72289791,2023-01-31,,502.96
455,72289791,2023-02-02,130.94,633.9
3824,72289791,2023-02-07,185.39,819.29
8248,72289791,2023-02-07,11.99,831.28
5068,72289791,2023-02-10,-1046.8,-215.51999999999998
3927,72289791,2023-02-11,-63.8,-279.32
2071,72292735,2023-01-31,,723.43
2706,72292735,2023-02-01,-50.95,672.4799999999999
5409,72292735,2023-02-01,-153.65,518.8299999999999
5418,72292735,2023-02-04,-122.2,396.62999999999994
4046,72292735,2023-02-09,128.31,524.9399999999999
1128,72292735,2023-02-09,-54.57,470.36999999999995
5426,72292735,2023-02-10,-88.62,381.74999999999994
5608,72292735,2023-02-12,19.98,401.72999999999996
7082,72292735,2023-02-14,54.0,455.72999999999996
2072,72309641,2023-01-31,,386.61
7291,72309641,2023-02-05,179.34,565.95
1770,72309641,2023-02-06,-96.4,469.55
1725,72309641,2023-02-07,-0.83,468.72
2776,72309641,2023-02-11,-2.2,466.52000000000004
7432,72309641,2023-02-13,-138.24,328.28
2992,72309641,2023-02-14,-1323.7,-995.4200000000001
2073,72323206,2023-01-31,,372.97
1803,72323206,2023-02-06,71.4,444.37
7985,72323206,2023-02-09,-135.68,308.69000000000005
4080,72323206,2023-02-11,-126.09,182.60000000000002
55,72323206,2023-02-13,132.93,315.53000000000003
2074,72354216,2023-01-31,,852.23
6413,72354216,2023-02-02,118.23,970.46
1970,72354216,2023-02-05,-81.6,888.86
7272,72354216,2023-02-07,-145.86,743.0
8014,72354216,2023-02-10,-62.94,680.06
7048,72354216,2023-02-11,-165.48,514.58
3179,72354216,2023-02-12,742.0,1256.58
8362,72354216,2023-02-13,1127.3,2383.88
3429,72354216,2023-02-13,-147.05,2236.83
4006,72354216,2023-02-14,-2010.0,226.83000000000015
2075,72446758,2023-01-31,,893.64
2369,72446758,2023-02-08,67.6,961.24
1740,72446758,2023-02-08,-153.92,807.3199999999999
184,72446758,2023-02-08,-196.25,611.0699999999999
2367,72446758,2023-02-12,-58.82,552.25
8308,72446758,2023-02-14,-141.49,410.76
2076,72450129,2023-01-31,,905.61
1339,72450129,2023-02-01,-208.23,697.38
4083,72450129,2023-02-02,90.38,787.76
4341,72450129,2023-02-03,130.7,918.46
7665,72450129,2023-02-03,98.53,1016.99
5014,72450129,2023-02-10,156.28,1173.27
4846,72450129,2023-02-14,112.23,1285.5
2077,72466733,2023-01-31,,580.24
8378,72466733,2023-02-03,474.7,1054.94
4966,72466733,2023-02-08,-61.29,993.65
7603,72466733,2023-02-09,138.48,1132.13
8403,72466733,2023-02-10,-78.83,1053.3
2078,72526383,2023-01-31,,885.37
3585,72526383,2023-02-07,853.6,1738.97
186,72526383,2023-02-08,93.74,1832.71
273,72526383,2023-02-08,-13.55,1819.16
6927,72526383,2023-02-08,-166.6,1652.56
3317,72526383,2023-02-12,895.2,2547.76
6690,72526383,2023-02-13,-93.82,2453.94
2079,72558185,2023-01-31,,793.9
957,72558185,2023-02-08,77.8,871.6999999999999
2080,72600465,2023-01-31,,595.44
5968,72600465,2023-02-03,108.6,704.0400000000001
2869,72600465,2023-02-09,-197.63,506.4100000000001
2081,72623919,2023-01-31,,610.63
6386,72623919,2023-02-03,119.56,730.19
4816,72623919,2023-02-07,644.8,1374.99
8418,72623919,2023-02-07,-65.6,1309.39
4798,72623919,2023-02-08,-72.15,1237.24
712,72623919,2023-02-12,-803.9,433.34000000000003
1367,72623919,2023-02-13,98.45,531.7900000000001
2082,72627756,2023-01-31,,473.02
5613,72627756,2023-02-02,63.42,536.4399999999999
3173,72627756,2023-02-04,44.62,581.06
8179,72627756,2023-02-05,94.48,675.54
295,72627756,2023-02-05,-98.07,577.47
5326,72627756,2023-02-12,49.53,627.0
5364,72627756,2023-02-12,-54.92,572.08
2083,72716288,2023-01-31,,167.69
3245,72716288,2023-02-05,-118.55,49.14
1640,72716288,2023-02-07,1282.4,1331.5400000000002
3027,72716288,2023-02-09,-36.48,1295.0600000000002
2084,72771982,2023-01-31,,501.76
3305,72771982,2023-02-02,-95.09,406.66999999999996
2364,72771982,2023-02-05,-74.98,331.69
246,72771982,2023-02-06,-94.32,237.37
7175,72771982,2023-02-12,81.63,319.0
2186,72771982,2023-02-13,-86.2,232.79999999999998
2085,72784766,2023-01-31,,181.69
3735,72784766,2023-02-01,161.31,343.0
8489,72784766,2023-02-01,-142.14,200.86
3469,72784766,2023-02-09,1288.6,1489.46
6656,72784766,2023-02-11,482.1,1971.56
6688,72784766,2023-02-11,131.61,2103.17
8260,72784766,2023-02-14,170.29,2273.46
2086,72799297,2023-01-31,,614.69
6329,72799297,2023-02-04,-45.45,569.24
2087,72809561,2023-01-31,,270.68
1673,72809561,2023-02-02,156.52,427.20000000000005
2539,72809561,2023-02-02,-62.51,364.69
2974,72809561,2023-02-03,111.35,476.04
653,72809561,2023-02-09,-69.0,407.04
5400,72809561,2023-02-10,-151.75,255.29000000000002
2088,72809943,2023-01-31,,870.72
4990,72809943,2023-02-02,71.36,942.08
7672,72809943,2023-02-02,-91.97,850.11
882,72809943,2023-02-03,-111.24,738.87
2847,72809943,2023-02-06,-57.47,681.4000000000001
2136,72809943,2023-02-06,-96.19,585.21
5582,72809943,2023-02-07,-113.01,472.20000000000005
8354,72809943,2023-02-07,-125.73,346.47
6067,72809943,2023-02-08,-93.19,253.28000000000003
4857,72809943,2023-02-09,-118.62,134.66000000000003
1698,72809943,2023-02-12,99.3,233.96000000000004
2604,72809943,2023-02-14,1297.2,1531.16
691,72809943,2023-02-14,116.09,1647.25
2089,72812647,2023-01-31,,351.84
4487,72812647,2023-02-01,-134.43,217.40999999999997
8314,72812647,2023-02-02,-73.15,144.25999999999996
3198,72812647,2023-02-06,20.39,164.64999999999998
7563,72812647,2023-02-07,74.77,239.41999999999996
7222,72812647,2023-02-08,209.9,449.31999999999994
3453,72812647,2023-02-11,-159.08,290.23999999999995
2090,72856610,2023-01-31,,576.08
7883,72856610,2023-02-01,103.99,680.07
6270,72856610,2023-02-02,107.47,787.5400000000001
3698,72856610,2023-02-05,8.72,796.26
2914,72856610,2023-02-05,-76.11,720.1500000000001
8,72856610,2023-02-06,140.03,860.1800000000001
6502,72856610,2023-02-08,114.69,974.87
6296,72856610,2023-02-13,-74.01,900.86
2091,72894034,2023-01-31,,74.8
4056,72894034,2023-02-01,164.31,239.11
6431,72894034,2023-02-04,79.24,318.35
6338,72894034,2023-02-12,-57.16,261.19
2092,72925782,2023-01-31,,351.64
1928,72925782,2023-02-02,121.58,473.21999999999997
6554,72925782,2023-02-04,761.9,1235.12
881,72925782,2023-02-05,-12.23,1222.89
6909,72925782,2023-02-09,-99.11,1123.78
6316,72925782,2023-02-11,-149.84,973.94
2093,72934756,2023-01-31,,829.55
2700,72934756,2023-02-01,856.5,1686.05
7418,72934756,2023-02-01,12.83,1698.8799999999999
7928,72934756,2023-02-01,-127.57,1571.31
5179,72934756,2023-02-02,-94.69,1476.62
6622,72934756,2023-02-03,28.47,1505.09
1677,72934756,2023-02-04,-1080.2,424.8899999999999
412,72934756,2023-02-07,66.78,491.66999999999985
391,72934756,2023-02-14,-63.85,427.8199999999999
2094,72971287,2023-01-31,,890.23
2344,72971287,2023-02-01,67.52,957.75
4218,72971287,2023-02-01,-65.26,892.49
4358,72971287,2023-02-02,122.23,1014.72
6088,72971287,2023-02-10,-1038.8,-24.079999999999927
2004,72971287,2023-02-11,-87.08,-111.15999999999993
2250,72971287,2023-02-13,109.33,-1.8299999999999272
2095,72986897,2023-01-31,,603.23
6831,72986897,2023-02-04,-42.74,560.49
8142,72986897,2023-02-07,-182.69,377.8
8656,72986897,2023-02-08,72.05,449.85
8331,72986897,2023-02-09,69.41,519.26
568,72986897,2023-02-12,1682.4,2201.66
7196,72986897,2023-02-14,86.1,2287.76
2096,72995062,2023-01-31,,506.73
3582,72995062,2023-02-01,321.2,827.9300000000001
4450,72995062,2023-02-03,121.77,949.7
8121,72995062,2023-02-03,-105.23,844.47
7498,72995062,2023-02-05,-175.88,668.59
8031,72995062,2023-02-08,173.81,842.4
963,72995062,2023-02-09,-73.82,768.58
6193,72995062,2023-02-14,321.9,1090.48
2097,72996601,2023-01-31,,730.27
594,72996601,2023-02-03,-50.42,679.85
5221,72996601,2023-02-03,-201.14,478.71
7824,72996601,2023-02-04,-84.53,394.17999999999995
3416,72996601,2023-02-07,78.2,472.38
2920,72996601,2023-02-08,157.52,629.9
2256,72996601,2023-02-10,93.87,723.77
216,72996601,2023-02-10,-989.8,-266.03
90,72996601,2023-02-11,-113.52,-379.54999999999995
5559,72996601,2023-02-13,-106.08,-485.63
2098,73009461,2023-01-31,,938.52
4910,73009461,2023-02-04,-89.19,849.3299999999999
4872,73009461,2023-02-09,125.67,975.0
4892,73009461,2023-02-10,97.88,1072.8799999999999
7930,73009461,2023-02-13,-26.0,1046.8799999999999
1213,73009461,2023-02-14,88.67,1135.55
2099,73015538,2023-01-31,,634.94
143,73015538,2023-02-01,249.75,884.69
4405,73015538,2023-02-02,-526.8,357.8900000000001
4194,73015538,2023-02-03,-37.15,320.7400000000001
2168,73015538,2023-02-07,-1190.8,-870.0599999999998
3363,73015538,2023-02-08,903.3,33.24000000000012
5376,73015538,2023-02-09,107.47,140.71000000000012
7329,73015538,2023-02-10,85.7,226.41000000000014
562,73015538,2023-02-11,557.0,783.4100000000001
2100,73039019,2023-01-31,,360.0
7498,73039019,2023-02-05,175.88,535.88
939,73039019,2023-02-09,-176.56,359.32
2837,73039019,2023-02-11,-35.07,324.25
2101,73059951,2023-01-31,,955.01
7552,73059951,2023-02-02,128.13,1083.1399999999999
7189,73059951,2023-02-03,53.78,1136.92
1623,73059951,2023-02-04,198.37,1335.29
4582,73059951,2023-02-07,65.96,1401.25
3683,73059951,2023-02-12,206.28,1607.53
2102,73080553,2023-01-31,,880.06
6431,73080553,2023-02-04,-79.24,800.8199999999999
3250,73080553,2023-02-10,59.44,860.26
2667,73080553,2023-02-11,79.43,939.6899999999999
6142,73080553,2023-02-11,-120.19,819.5
2103,73124762,2023-01-31,,110.47
4326,73124762,2023-02-01,-49.48,60.99
4362,73124762,2023-02-01,-50.33,10.660000000000004
5733,73124762,2023-02-06,-24.38,-13.719999999999995
6211,73124762,2023-02-07,87.94,74.22
4940,73124762,2023-02-09,196.64,270.86
6254,73124762,2023-02-09,177.2,448.05999999999995
5916,73124762,2023-02-11,-51.94,396.12
7696,73124762,2023-02-12,78.65,474.77
2104,73208971,2023-01-31,,107.97
6043,73208971,2023-02-02,-185.26,-77.28999999999999
159,73208971,2023-02-07,484.1,406.81000000000006
8252,73208971,2023-02-12,95.07,501.88000000000005
2105,73234341,2023-01-31,,811.71
313,73234341,2023-02-04,101.3,913.01
6264,73234341,2023-02-11,107.95,1020.96
8192,73234341,2023-02-11,-2044.6,-1023.6399999999999
2106,73269307,2023-01-31,,485.86
2434,73269307,2023-02-04,98.27,584.13
2018,73269307,2023-02-04,42.73,626.86
2107,73275714,2023-01-31,,924.88
3434,73275714,2023-02-04,-173.75,751.13
2444,73275714,2023-02-06,-123.09,628.04
8081,73275714,2023-02-11,135.38,763.42
2108,73282074,2023-01-31,,220.48
6375,73282074,2023-02-01,-61.23,159.25
1702,73282074,2023-02-04,-97.9,61.349999999999994
4978,73282074,2023-02-07,-105.38,-44.03
3058,73282074,2023-02-07,-147.36,-191.39000000000001
6803,73282074,2023-02-09,-239.1,-430.49
4683,73282074,2023-02-11,-54.29,-484.78000000000003
4897,73282074,2023-02-13,-71.18,-555.96
2109,73321391,2023-01-31,,100.12
5112,73321391,2023-02-03,-174.25,-74.13
2421,73321391,2023-02-04,-18.25,-92.38
2936,73321391,2023-02-11,-80.85,-173.23
8010,73321391,2023-02-12,-61.95,-235.18
3813,73321391,2023-02-13,-80.74,-315.91999999999996
4201,73321391,2023-02-14,78.83,-237.08999999999997
2110,73328955,2023-01-31,,404.7
2160,73328955,2023-02-06,-30.45,374.25
688,73328955,2023-02-07,-1819.0,-1444.75
1225,73328955,2023-02-09,149.44,-1295.31
8012,73328955,2023-02-10,-50.5,-1345.81
7902,73328955,2023-02-13,77.1,-1268.71
2111,73410227,2023-01-31,,820.36
3939,73410227,2023-02-01,-219.71,600.65
1380,73410227,2023-02-06,52.84,653.49
4765,73410227,2023-02-09,38.14,691.63
5549,73410227,2023-02-12,-107.09,584.54
2112,73439131,2023-01-31,,863.01
5919,73439131,2023-02-02,-54.93,808.08
4990,73439131,2023-02-02,-71.36,736.72
3803,73439131,2023-02-02,-88.1,648.62
3737,73439131,2023-02-03,-149.58,499.03999999999996
7808,73439131,2023-02-04,107.38,606.42
5716,73439131,2023-02-04,-123.49,482.93
8200,73439131,2023-02-06,-1069.0,-586.0699999999999
7313,73439131,2023-02-07,69.6,-516.4699999999999
104,73439131,2023-02-09,-98.98,-615.4499999999999
1418,73439131,2023-02-14,105.25,-510.19999999999993
6721,73439131,2023-02-14,-53.79,-563.9899999999999
2113,73510067,2023-01-31,,895.82
3525,73510067,2023-02-04,135.72,1031.54
6309,73510067,2023-02-07,-135.77,895.77
5367,73510067,2023-02-14,22.59,918.36
2114,73512834,2023-01-31,,424.59
5897,73512834,2023-02-01,103.58,528.17
4855,73512834,2023-02-02,110.43,638.6
2459,73512834,2023-02-04,-578.7,59.89999999999998
3403,73512834,2023-02-05,-6.73,53.16999999999997
3426,73512834,2023-02-06,113.54,166.70999999999998
6009,73512834,2023-02-09,54.35,221.05999999999997
5565,73512834,2023-02-09,-176.84,44.21999999999997
3184,73512834,2023-02-10,123.35,167.56999999999996
8565,73512834,2023-02-11,-31.41,136.15999999999997
5877,73512834,2023-02-11,-110.11,26.04999999999997
5709,73512834,2023-02-12,121.0,147.04999999999995
4521,73512834,2023-02-14,163.28,310.33
2115,73534143,2023-01-31,,804.34
5942,73534143,2023-02-12,-85.27,719.07
2116,73538236,2023-01-31,,231.93
740,73538236,2023-02-01,60.58,292.51
4211,73538236,2023-02-13,-99.01,193.5
2117,73604500,2023-01-31,,689.4
1586,73604500,2023-02-02,-186.07,503.33
8036,73604500,2023-02-06,193.27,696.6
8442,73604500,2023-02-12,140.65,837.25
2118,73642628,2023-01-31,,300.06
6853,73642628,2023-02-06,1042.0,1342.06
1001,73642628,2023-02-06,-128.02,1214.04
3604,73642628,2023-02-07,109.32,1323.36
7788,73642628,2023-02-08,128.53,1451.8899999999999
7388,73642628,2023-02-09,105.05,1556.9399999999998
3817,73642628,2023-02-14,109.13,1666.07
2119,73652359,2023-01-31,,80.58
7408,73652359,2023-02-08,68.73,149.31
7827,73652359,2023-02-12,135.05,284.36
7180,73652359,2023-02-14,12.8,297.16
2120,73668192,2023-01-31,,371.47
8511,73668192,2023-02-02,1495.8,1867.27
3474,73668192,2023-02-04,-153.96,1713.31
1014,73668192,2023-02-05,149.4,1862.71
6741,73668192,2023-02-05,37.76,1900.47
1288,73668192,2023-02-07,-93.03,1807.44
1218,73668192,2023-02-10,111.12,1918.56
7259,73668192,2023-02-10,-11.9,1906.66
1035,73668192,2023-02-13,-62.93,1843.73
2121,73700087,2023-01-31,,274.17
6060,73700087,2023-02-04,116.66,390.83000000000004
7228,73700087,2023-02-04,-44.37,346.46000000000004
1453,73700087,2023-02-06,-106.53,239.93
31,73700087,2023-02-08,70.5,310.43
3438,73700087,2023-02-10,70.11,380.54
4259,73700087,2023-02-12,-84.72,295.82
2122,73744504,2023-01-31,,270.6
2777,73744504,2023-02-05,-54.49,216.11
7118,73744504,2023-02-07,-52.52,163.59000000000003
6617,73744504,2023-02-08,51.75,215.34000000000003
4004,73744504,2023-02-09,-70.71,144.63000000000002
1444,73744504,2023-02-10,-69.64,74.99000000000002
3757,73744504,2023-02-10,-127.34,-52.34999999999998
7802,73744504,2023-02-11,89.18,36.83000000000003
1275,73744504,2023-02-11,-69.64,-32.809999999999974
8510,73744504,2023-02-12,-128.61,-161.42
3514,73744504,2023-02-13,165.67,4.25
6906,73744504,2023-02-13,-137.58,-133.33
2123,73762750,2023-01-31,,221.12
3409,73762750,2023-02-01,-66.19,154.93
5964,73762750,2023-02-03,1505.1,1660.03
411,73762750,2023-02-05,-129.71,1530.32
781,73762750,2023-02-06,106.97,1637.29
1424,73762750,2023-02-08,156.53,1793.82
2124,73782061,2023-01-31,,891.9
1210,73782061,2023-02-02,-58.23,833.67
2394,73782061,2023-02-13,-69.25,764.42
3248,73782061,2023-02-13,-164.0,600.42
2125,73878828,2023-01-31,,845.19
659,73878828,2023-02-01,-58.02,787.1700000000001
983,73878828,2023-02-04,-973.3,-186.12999999999988
4206,73878828,2023-02-06,42.82,-143.3099999999999
599,73878828,2023-02-09,117.9,-25.409999999999883
7179,73878828,2023-02-10,74.6,49.19000000000011
7416,73878828,2023-02-10,-7.29,41.90000000000011
2728,73878828,2023-02-13,86.65,128.55000000000013
2624,73878828,2023-02-13,-62.41,66.14000000000013
2126,73983591,2023-01-31,,292.39
72,73983591,2023-02-01,117.31,409.7
5689,73983591,2023-02-05,72.56,482.26
468,73983591,2023-02-06,-124.22,358.03999999999996
4338,73983591,2023-02-07,7.57,365.61
5663,73983591,2023-02-08,-1668.5,-1302.8899999999999
5046,73983591,2023-02-10,-83.3,-1386.1899999999998
5299,73983591,2023-02-11,-152.46,-1538.6499999999999
7364,73983591,2023-02-13,-83.87,-1622.52
2127,73983601,2023-01-31,,617.23
7151,73983601,2023-02-04,-186.59,430.64
1132,73983601,2023-02-06,-111.97,318.67
5913,73983601,2023-02-08,62.88,381.55
5988,73983601,2023-02-10,-136.73,244.82000000000002
2081,73983601,2023-02-11,81.42,326.24
5581,73983601,2023-02-12,-37.22,289.02000000000004
1719,73983601,2023-02-13,-140.52,148.5
1632,73983601,2023-02-14,82.4,230.9
2128,74012560,2023-01-31,,414.56
1012,74012560,2023-02-08,-51.04,363.52
2396,74012560,2023-02-10,2476.1,2839.62
5278,74012560,2023-02-10,75.51,2915.13
8665,74012560,2023-02-10,-70.94,2844.19
722,74012560,2023-02-10,-71.14,2773.0499999999997
4457,74012560,2023-02-10,-150.3,2622.75
7716,74012560,2023-02-14,-96.98,2525.77
2129,74154906,2023-01-31,,743.84
1406,74154906,2023-02-09,32.68,776.52
2130,74163559,2023-01-31,,45.76
2111,74163559,2023-02-02,100.89,146.65
7546,74163559,2023-02-02,-105.59,41.05999999999999
3330,74163559,2023-02-07,84.66,125.71999999999998
4776,74163559,2023-02-09,-91.85,33.86999999999999
355,74163559,2023-02-10,-108.57,-74.7
2921,74163559,2023-02-11,-80.75,-155.45
2131,74218001,2023-01-31,,133.02
4340,74218001,2023-02-05,68.53,201.55
960,74218001,2023-02-09,898.2,1099.75
3587,74218001,2023-02-09,-7.4,1092.35
2132,74252410,2023-01-31,,278.47
7160,74252410,2023-02-01,37.94,316.41
5534,74252410,2023-02-01,-105.25,211.16000000000003
72,74252410,2023-02-01,-117.31,93.85000000000002
6250,74252410,2023-02-03,126.21,220.06
1850,74252410,2023-02-03,-145.42,74.64000000000004
6744,74252410,2023-02-08,-32.44,42.200000000000045
7950,74252410,2023-02-10,1531.0,1573.2
250,74252410,2023-02-11,-1207.7,365.5
4211,74252410,2023-02-13,99.01,464.51
2323,74252410,2023-02-14,625.3,1089.81
2133,74255305,2023-01-31,,3.7
8576,74255305,2023-02-02,162.41,166.10999999999999
4437,74255305,2023-02-03,106.51,272.62
5172,74255305,2023-02-06,93.96,366.58
6527,74255305,2023-02-07,85.44,452.02
7027,74255305,2023-02-11,-167.02,285.0
3401,74255305,2023-02-11,-1672.7,-1387.7
2134,74281404,2023-01-31,,678.89
3181,74281404,2023-02-01,-456.2,222.69
8524,74281404,2023-02-04,139.28,361.97
2234,74281404,2023-02-08,89.88,451.85
7424,74281404,2023-02-11,-145.81,306.03999999999996
2135,74304084,2023-01-31,,883.35
4545,74304084,2023-02-01,131.58,1014.9300000000001
5318,74304084,2023-02-08,570.9,1585.83
8344,74304084,2023-02-10,89.61,1675.44
332,74304084,2023-02-14,-122.61,1552.83
2136,74365725,2023-01-31,,518.04
1355,74365725,2023-02-03,-97.42,420.61999999999995
2978,74365725,2023-02-06,24.84,445.46
4484,74365725,2023-02-10,81.71,527.17
1709,74365725,2023-02-13,163.71,690.88
2137,74367877,2023-01-31,,818.92
5123,74367877,2023-02-01,45.64,864.56
1714,74367877,2023-02-02,-104.03,760.53
7221,74367877,2023-02-03,472.5,1233.03
2153,74367877,2023-02-08,-70.08,1162.95
3743,74367877,2023-02-10,-118.64,1044.31
6450,74367877,2023-02-13,48.97,1093.28
2138,74387481,2023-01-31,,883.93
7823,74387481,2023-02-02,-117.73,766.1999999999999
4370,74387481,2023-02-04,106.46,872.66
7922,74387481,2023-02-07,88.5,961.16
6211,74387481,2023-02-07,-87.94,873.2199999999999
4816,74387481,2023-02-07,-644.8,228.41999999999996
8084,74387481,2023-02-08,162.49,390.90999999999997
3793,74387481,2023-02-09,-163.2,227.70999999999998
5994,74387481,2023-02-10,-91.88,135.82999999999998
7045,74387481,2023-02-13,-61.95,73.87999999999998
2139,74441123,2023-01-31,,833.24
382,74441123,2023-02-01,-143.97,689.27
494,74441123,2023-02-02,61.45,750.72
1369,74441123,2023-02-08,-124.5,626.22
5552,74441123,2023-02-09,-128.5,497.72
2594,74441123,2023-02-10,-139.35,358.37
6774,74441123,2023-02-13,-1154.7,-796.33
2140,74539170,2023-01-31,,417.58
4232,74539170,2023-02-04,143.01,560.5899999999999
3042,74539170,2023-02-04,-74.02,486.57
3922,74539170,2023-02-07,-142.95,343.62
7365,74539170,2023-02-10,-126.49,217.13
4322,74539170,2023-02-11,84.22,301.35
3090,74539170,2023-02-11,-1.71,299.64
2581,74539170,2023-02-12,-20.81,278.83
2141,74544582,2023-01-31,,407.96
3128,74544582,2023-02-01,-58.96,349.0
5857,74544582,2023-02-06,107.8,456.79999999999995
7822,74544582,2023-02-07,89.17,545.97
5465,74544582,2023-02-08,-1010.6,-464.63
5681,74544582,2023-02-10,-122.82,-587.45
1993,74544582,2023-02-11,-16.09,-603.54
1072,74544582,2023-02-11,-28.8,-632.34
5929,74544582,2023-02-13,-46.08,-678.42
2356,74544582,2023-02-13,-196.46,-874.88
2142,74604471,2023-01-31,,661.57
2151,74604471,2023-02-03,-21.47,640.1
3009,74604471,2023-02-11,1199.0,1839.1
6908,74604471,2023-02-11,1096.1,2935.2
2143,74662976,2023-01-31,,782.3
7760,74662976,2023-02-01,1634.7,2417.0
3442,74662976,2023-02-06,213.44,2630.44
7388,74662976,2023-02-09,-105.05,2525.39
5487,74662976,2023-02-11,-111.96,2413.43
2223,74662976,2023-02-14,-69.61,2343.82
2144,74703933,2023-01-31,,321.42
5679,74703933,2023-02-01,239.72,561.14
3043,74703933,2023-02-02,-68.12,493.02
8345,74703933,2023-02-04,58.74,551.76
5464,74703933,2023-02-04,-157.05,394.71000000000004
4385,74703933,2023-02-07,949.2,1343.91
588,74703933,2023-02-11,-152.17,1191.74
3059,74703933,2023-02-13,81.27,1273.01
2145,74709026,2023-01-31,,465.39
50,74709026,2023-02-04,-119.96,345.43
6425,74709026,2023-02-05,-53.54,291.89
4344,74709026,2023-02-09,58.09,349.98
4853,74709026,2023-02-11,-152.47,197.51
3481,74709026,2023-02-14,162.35,359.86
2146,74768567,2023-01-31,,557.15
6952,74768567,2023-02-04,39.82,596.97
387,74768567,2023-02-08,-58.95,538.02
3889,74768567,2023-02-10,-103.06,434.96
1932,74768567,2023-02-11,-119.83,315.13
2147,74770758,2023-01-31,,643.52
3659,74770758,2023-02-01,143.86,787.38
5900,74770758,2023-02-02,645.8,1433.1799999999998
7212,74770758,2023-02-02,-507.1,926.0799999999999
4904,74770758,2023-02-05,-23.74,902.3399999999999
6508,74770758,2023-02-07,155.73,1058.07
299,74770758,2023-02-07,27.88,1085.9499999999998
198,74770758,2023-02-07,-115.83,970.1199999999999
2882,74770758,2023-02-10,119.83,1089.9499999999998
7165,74770758,2023-02-11,-62.47,1027.48
2358,74770758,2023-02-13,180.81,1208.29
2069,74770758,2023-02-13,39.74,1248.03
6205,74770758,2023-02-14,90.79,1338.82
2233,74770758,2023-02-14,-97.35,1241.4699999999998
4153,74770758,2023-02-14,-541.0,700.4699999999999
2148,74822001,2023-01-31,,673.61
1880,74822001,2023-02-03,113.25,786.86
8241,74822001,2023-02-04,84.91,871.77
6027,74822001,2023-02-06,157.11,1028.88
291,74822001,2023-02-08,-42.88,986.0
2149,75000628,2023-01-31,,117.33
2176,75000628,2023-02-03,-102.49,14.840000000000003
1884,75000628,2023-02-06,-967.8,-952.9599999999999
6719,75000628,2023-02-07,111.95,-841.0099999999999
2001,75000628,2023-02-07,23.9,-817.1099999999999
8305,75000628,2023-02-09,119.86,-697.2499999999999
3242,75000628,2023-02-11,160.56,-536.6899999999999
3577,75000628,2023-02-11,-102.03,-638.7199999999999
1654,75000628,2023-02-12,24.74,-613.9799999999999
1860,75000628,2023-02-14,-122.88,-736.8599999999999
2150,75004471,2023-01-31,,435.54
5208,75004471,2023-02-06,-90.19,345.35
889,75004471,2023-02-07,-71.12,274.23
1268,75004471,2023-02-09,161.19,435.42
319,75004471,2023-02-10,-54.73,380.69
2151,75027308,2023-01-31,,307.44
1165,75027308,2023-02-05,70.81,378.25
2285,75027308,2023-02-13,-21.73,356.52
3690,75027308,2023-02-14,-42.03,314.49
2152,75068844,2023-01-31,,852.47
2404,75068844,2023-02-07,32.26,884.73
5310,75068844,2023-02-09,-174.92,709.8100000000001
8327,75068844,2023-02-10,-205.21,504.6
8414,75068844,2023-02-13,56.42,561.02
2153,75094093,2023-01-31,,478.09
6290,75094093,2023-02-08,-66.58,411.51
3069,75094093,2023-02-10,-86.39,325.12
2812,75094093,2023-02-14,-120.62,204.49999999999997
2154,75134291,2023-01-31,,903.25
1405,75134291,2023-02-07,905.3,1808.55
5801,75134291,2023-02-08,-137.66,1670.8899999999999
1030,75134291,2023-02-10,145.13,1816.02
6183,75134291,2023-02-11,1677.5,3493.52
4286,75134291,2023-02-11,63.08,3556.6
1626,75134291,2023-02-12,-1261.6,2295.0
5959,75134291,2023-02-13,138.85,2433.85
2155,75164598,2023-01-31,,569.4
176,75164598,2023-02-01,84.96,654.36
4089,75164598,2023-02-03,1529.4,2183.76
7364,75164598,2023-02-13,83.87,2267.63
6115,75164598,2023-02-14,-130.44,2137.19
2156,75172199,2023-01-31,,955.0
7759,75172199,2023-02-01,800.0,1755.0
2765,75172199,2023-02-05,-110.09,1644.91
6897,75172199,2023-02-10,-108.6,1536.31
172,75172199,2023-02-14,-41.12,1495.19
2157,75205767,2023-01-31,,113.75
3825,75205767,2023-02-01,12.5,126.25
8037,75205767,2023-02-03,-59.01,67.24000000000001
2677,75205767,2023-02-08,-26.82,40.42
7113,75205767,2023-02-09,117.38,157.8
2787,75205767,2023-02-10,964.8,1122.6
4401,75205767,2023-02-11,52.74,1175.34
2013,75205767,2023-02-12,-195.95,979.3899999999999
2158,75216128,2023-01-31,,671.26
2411,75216128,2023-02-05,848.7,1519.96
6493,75216128,2023-02-05,-51.76,1468.2
787,75216128,2023-02-06,-50.86,1417.3400000000001
4788,75216128,2023-02-10,-113.81,1303.53
4718,75216128,2023-02-11,136.0,1439.53
6007,75216128,2023-02-13,145.9,1585.43
314,75216128,2023-02-13,37.31,1622.74
7797,75216128,2023-02-14,-110.13,1512.6100000000001
2159,75223089,2023-01-31,,557.48
5352,75223089,2023-02-02,-97.37,460.11
1115,75223089,2023-02-06,140.76,600.87
4442,75223089,2023-02-08,0.47,601.34
5206,75223089,2023-02-10,71.41,672.75
2160,75258542,2023-01-31,,772.67
3201,75258542,2023-02-06,59.16,831.8299999999999
2161,75331062,2023-01-31,,117.81
7456,75331062,2023-02-01,124.73,242.54000000000002
1873,75331062,2023-02-02,192.68,435.22
2750,75331062,2023-02-02,153.2,588.4200000000001
7119,75331062,2023-02-09,-103.8,484.62
1110,75331062,2023-02-10,76.32,560.94
8494,75331062,2023-02-12,182.63,743.5699999999999
7753,75331062,2023-02-12,168.57,912.14
2162,75355842,2023-01-31,,621.95
3910,75355842,2023-02-02,-107.62,514.33
6558,75355842,2023-02-08,-167.23,347.1
3247,75355842,2023-02-13,36.43,383.53000000000003
5672,75355842,2023-02-13,-65.62,317.9100000000001
2163,75394177,2023-01-31,,191.04
6841,75394177,2023-02-01,212.26,403.29999999999995
870,75394177,2023-02-01,-189.07,214.23
2281,75394177,2023-02-05,84.35,298.58
618,75394177,2023-02-07,-96.08,202.5
6954,75394177,2023-02-09,-67.76,134.73999999999998
3954,75394177,2023-02-13,-12.26,122.47999999999998
2164,75428657,2023-01-31,,455.8
8293,75428657,2023-02-01,96.14,551.94
910,75428657,2023-02-04,72.24,624.1800000000001
173,75428657,2023-02-06,-89.47,534.71
3730,75428657,2023-02-06,-107.32,427.39
2237,75428657,2023-02-07,-166.06,261.33000000000004
2686,75428657,2023-02-12,-133.04,128.29000000000002
2165,75468090,2023-01-31,,984.92
5954,75468090,2023-02-02,-94.47,890.4499999999999
3071,75468090,2023-02-03,-110.96,779.49
1560,75468090,2023-02-05,143.3,922.79
851,75468090,2023-02-06,-28.36,894.43
4435,75468090,2023-02-09,82.14,976.5699999999999
5230,75468090,2023-02-13,2264.3,3240.87
7183,75468090,2023-02-14,86.73,3327.6
5153,75468090,2023-02-14,-156.02,3171.58
2166,75551521,2023-01-31,,538.64
3410,75551521,2023-02-01,-170.89,367.75
3152,75551521,2023-02-10,-175.95,191.8
8365,75551521,2023-02-11,-40.81,150.99
2167,75553043,2023-01-31,,669.59
4030,75553043,2023-02-01,-124.86,544.73
1084,75553043,2023-02-02,-66.42,478.31000000000006
7662,75553043,2023-02-07,-46.14,432.17
4644,75553043,2023-02-08,45.54,477.71000000000004
2752,75553043,2023-02-12,150.22,627.9300000000001
2698,75553043,2023-02-12,87.33,715.26
944,75553043,2023-02-13,172.54,887.8
3834,75553043,2023-02-13,-126.86,760.94
5195,75553043,2023-02-13,-156.04,604.9000000000001
2168,75569387,2023-01-31,,249.27
3596,75569387,2023-02-01,1775.6,2024.87
7774,75569387,2023-02-03,-177.23,1847.6399999999999
8315,75569387,2023-02-05,76.31,1923.9499999999998
866,75569387,2023-02-08,-137.97,1785.98
5661,75569387,2023-02-08,-155.15,1630.83
8495,75569387,2023-02-09,173.2,1804.03
5557,75569387,2023-02-10,-177.19,1626.84
1026,75569387,2023-02-12,95.61,1722.4499999999998
2169,75573750,2023-01-31,,159.92
2659,75573750,2023-02-01,-57.37,102.54999999999998
7705,75573750,2023-02-01,-614.1,-511.55000000000007
1313,75573750,2023-02-11,95.68,-415.87000000000006
2170,75687743,2023-01-31,,668.39
1544,75687743,2023-02-02,-77.04,591.35
7246,75687743,2023-02-02,-121.53,469.82
964,75687743,2023-02-06,68.98,538.8
149,75687743,2023-02-08,710.3,1249.1
6126,75687743,2023-02-13,-101.21,1147.8899999999999
5004,75687743,2023-02-13,-124.44,1023.4499999999999
2171,75692380,2023-01-31,,477.28
6326,75692380,2023-02-07,13.71,490.98999999999995
73,75692380,2023-02-12,76.48,567.47
2172,75696521,2023-01-31,,660.34
2796,75696521,2023-02-02,151.37,811.71
8113,75696521,2023-02-04,-113.97,697.74
7714,75696521,2023-02-09,124.33,822.07
8141,75696521,2023-02-12,-443.1,378.97
3942,75696521,2023-02-13,105.96,484.93
2173,75747094,2023-01-31,,289.48
3315,75747094,2023-02-01,-108.17,181.31
1404,75747094,2023-02-02,-111.34,69.97000000000001
7043,75747094,2023-02-03,-88.14,-18.169999999999987
7225,75747094,2023-02-03,-170.7,-188.86999999999998
834,75747094,2023-02-06,-179.08,-367.95
7831,75747094,2023-02-07,-69.34,-437.28999999999996
3052,75747094,2023-02-09,125.74,-311.55
3935,75747094,2023-02-09,-24.49,-336.04
775,75747094,2023-02-12,198.39,-137.65
4295,75747094,2023-02-12,119.08,-18.570000000000007
5934,75747094,2023-02-12,-1314.3,-1332.87
8363,75747094,2023-02-14,51.36,-1281.51
2174,75762044,2023-01-31,,980.08
2210,75762044,2023-02-03,-117.47,862.61
6412,75762044,2023-02-05,617.7,1480.31
2704,75762044,2023-02-05,80.83,1561.14
7074,75762044,2023-02-07,-79.53,1481.6100000000001
544,75762044,2023-02-07,-1107.6,374.0100000000002
2129,75762044,2023-02-08,-238.9,135.1100000000002
4516,75762044,2023-02-09,84.51,219.62000000000023
4321,75762044,2023-02-12,-64.23,155.3900000000002
5354,75762044,2023-02-12,-94.0,61.390000000000214
3406,75762044,2023-02-14,-87.33,-25.939999999999785
2175,75782714,2023-01-31,,105.34
3663,75782714,2023-02-02,182.71,288.05
4983,75782714,2023-02-04,93.96,382.01
3812,75782714,2023-02-07,97.29,479.3
4064,75782714,2023-02-08,-58.82,420.48
2232,75782714,2023-02-11,53.59,474.07
2176,75839704,2023-01-31,,202.34
6890,75839704,2023-02-06,59.6,261.94
7146,75839704,2023-02-11,-157.05,104.88999999999999
3724,75839704,2023-02-12,44.96,149.85
2177,75893682,2023-01-31,,573.74
77,75893682,2023-02-03,104.78,678.52
5502,75893682,2023-02-04,102.31,780.83
3295,75893682,2023-02-08,-105.88,674.95
7887,75893682,2023-02-09,148.56,823.51
2178,75925793,2023-01-31,,425.69
5976,75925793,2023-02-01,107.97,533.66
4860,75925793,2023-02-03,-50.4,483.26
6344,75925793,2023-02-04,-87.65,395.61
3366,75925793,2023-02-11,77.62,473.23
1130,75925793,2023-02-11,-143.15,330.08
2179,75946768,2023-01-31,,103.05
303,75946768,2023-02-02,158.32,261.37
4316,75946768,2023-02-03,-121.58,139.79000000000002
7764,75946768,2023-02-04,-85.27,54.52000000000001
8246,75946768,2023-02-11,157.4,211.92000000000002
2180,75954317,2023-01-31,,583.28
6385,75954317,2023-02-02,92.9,676.18
4346,75954317,2023-02-05,41.21,717.39
119,75954317,2023-02-11,129.66,847.05
519,75954317,2023-02-13,760.4,1607.4499999999998
7807,75954317,2023-02-13,122.87,1730.32
683,75954317,2023-02-14,85.66,1815.98
2181,75969874,2023-01-31,,454.25
6661,75969874,2023-02-05,325.0,779.25
1994,75969874,2023-02-05,165.42,944.67
6227,75969874,2023-02-08,-42.92,901.75
2201,75969874,2023-02-09,48.05,949.8
2182,76078639,2023-01-31,,318.17
151,76078639,2023-02-01,9.8,327.97
6732,76078639,2023-02-06,154.69,482.66
2794,76078639,2023-02-08,109.06,591.72
8330,76078639,2023-02-09,-25.58,566.14
2183,76096120,2023-01-31,,996.6
6098,76096120,2023-02-01,-115.85,880.75
1533,76096120,2023-02-02,142.28,1023.03
5515,76096120,2023-02-02,101.22,1124.25
8521,76096120,2023-02-03,85.29,1209.54
6601,76096120,2023-02-05,-142.12,1067.42
5263,76096120,2023-02-06,99.42,1166.84
4697,76096120,2023-02-13,-90.4,1076.44
2184,76099143,2023-01-31,,525.4
1517,76099143,2023-02-02,-118.6,406.79999999999995
6663,76099143,2023-02-05,61.09,467.89
6684,76099143,2023-02-13,-53.33,414.56
2185,76122310,2023-01-31,,985.6
4369,76122310,2023-02-10,-616.1,369.5
1384,76122310,2023-02-11,32.2,401.7
8420,76122310,2023-02-13,148.74,550.44
2186,76146870,2023-01-31,,414.24
1759,76146870,2023-02-03,1278.2,1692.44
94,76146870,2023-02-06,-165.65,1526.79
4759,76146870,2023-02-07,168.17,1694.96
567,76146870,2023-02-07,141.27,1836.23
4974,76146870,2023-02-08,-86.36,1749.8700000000001
4704,76146870,2023-02-11,101.6,1851.47
979,76146870,2023-02-14,88.1,1939.57
2156,76146870,2023-02-14,-104.18,1835.39
8371,76146870,2023-02-14,-1053.5,781.8900000000001
2187,76169332,2023-01-31,,615.46
6821,76169332,2023-02-02,83.79,699.25
3032,76169332,2023-02-02,-1695.5,-996.25
7562,76169332,2023-02-03,-28.0,-1024.25
8153,76169332,2023-02-07,84.19,-940.06
2188,76206810,2023-01-31,,887.63
0,76206810,2023-02-01,-128.78,758.85
1960,76206810,2023-02-05,-104.42,654.43
2044,76206810,2023-02-12,108.81,763.24
274,76206810,2023-02-12,104.78,868.02
3810,76206810,2023-02-14,37.74,905.76
2189,76245103,2023-01-31,,814.75
3622,76245103,2023-02-07,171.4,986.15
7194,76245103,2023-02-08,-72.19,913.96
7851,76245103,2023-02-10,-108.64,805.32
2990,76245103,2023-02-11,-126.42,678.9
1345,76245103,2023-02-11,-194.38,484.52
3186,76245103,2023-02-14,64.58,549.1
2190,76256026,2023-01-31,,36.71
2648,76256026,2023-02-01,114.21,150.92
427,76256026,2023-02-02,-122.54,28.379999999999995
7419,76256026,2023-02-03,-65.14,-36.760000000000005
6324,76256026,2023-02-05,76.57,39.80999999999999
492,76256026,2023-02-06,-91.5,-51.69000000000001
196,76256026,2023-02-06,-583.7,-635.3900000000001
2225,76256026,2023-02-07,-62.85,-698.2400000000001
5723,76256026,2023-02-08,154.47,-543.7700000000001
7431,76256026,2023-02-09,125.05,-418.7200000000001
7312,76256026,2023-02-12,1251.2,832.48
1900,76256026,2023-02-12,1145.7,1978.18
3772,76256026,2023-02-12,-107.03,1871.15
2191,76257915,2023-01-31,,795.66
406,76257915,2023-02-04,87.08,882.74
4825,76257915,2023-02-05,108.03,990.77
4669,76257915,2023-02-07,-1236.7,-245.93000000000006
5660,76257915,2023-02-14,51.78,-194.15000000000006
2192,76273831,2023-01-31,,866.62
6608,76273831,2023-02-02,49.14,915.76
4992,76273831,2023-02-03,-113.59,802.17
4833,76273831,2023-02-07,109.58,911.75
2247,76273831,2023-02-08,99.77,1011.52
8300,76273831,2023-02-12,-110.79,900.73
1112,76273831,2023-02-13,-124.45,776.28
4907,76273831,2023-02-14,129.25,905.53
2193,76318330,2023-01-31,,710.56
5837,76318330,2023-02-01,-960.8,-250.24
6319,76318330,2023-02-03,-1.03,-251.27
1094,76318330,2023-02-04,41.13,-210.14000000000001
1758,76318330,2023-02-04,-49.52,-259.66
3220,76318330,2023-02-04,-165.42,-425.08
2485,76318330,2023-02-06,405.7,-19.379999999999995
1001,76318330,2023-02-06,128.02,108.64000000000001
6583,76318330,2023-02-14,156.27,264.91
2194,76336076,2023-01-31,,288.71
269,76336076,2023-02-07,109.43,398.14
6860,76336076,2023-02-13,-96.98,301.15999999999997
656,76336076,2023-02-14,-1376.0,-1074.8400000000001
2195,76342664,2023-01-31,,371.62
1604,76342664,2023-02-03,42.34,413.96000000000004
1796,76342664,2023-02-04,124.23,538.19
3853,76342664,2023-02-05,-44.51,493.68
8104,76342664,2023-02-12,100.06,593.74
2196,76343783,2023-01-31,,42.36
6959,76343783,2023-02-02,133.38,175.74
2466,76343783,2023-02-08,1253.6,1429.34
3207,76343783,2023-02-10,113.56,1542.8999999999999
7905,76343783,2023-02-13,1505.7,3048.6
2197,76355557,2023-01-31,,285.61
5244,76355557,2023-02-03,110.56,396.17
3758,76355557,2023-02-10,65.54,461.71000000000004
7328,76355557,2023-02-10,-206.97,254.74
5104,76355557,2023-02-11,184.5,439.24
6591,76355557,2023-02-13,-73.19,366.05
2198,76454427,2023-01-31,,267.03
6985,76454427,2023-02-09,32.83,299.85999999999996
7606,76454427,2023-02-10,64.12,363.97999999999996
346,76454427,2023-02-12,-170.4,193.57999999999998
2199,76470405,2023-01-31,,606.3
5974,76470405,2023-02-01,120.13,726.43
4377,76470405,2023-02-02,62.52,788.9499999999999
940,76470405,2023-02-02,-65.2,723.75
5619,76470405,2023-02-05,175.68,899.43
7728,76470405,2023-02-05,104.2,1003.63
4346,76470405,2023-02-05,-41.21,962.42
8660,76470405,2023-02-07,56.28,1018.6999999999999
7719,76470405,2023-02-07,-98.61,920.0899999999999
6151,76470405,2023-02-10,-116.06,804.03
2200,76474111,2023-01-31,,563.43
5201,76474111,2023-02-01,88.99,652.42
6367,76474111,2023-02-05,-69.19,583.2299999999999
8211,76474111,2023-02-07,173.35,756.5799999999999
8180,76474111,2023-02-07,-17.39,739.1899999999999
899,76474111,2023-02-09,-158.25,580.9399999999999
6302,76474111,2023-02-11,-73.94,506.99999999999994
7235,76474111,2023-02-12,109.6,616.5999999999999
7525,76474111,2023-02-12,85.9,702.5
1609,76474111,2023-02-14,626.8,1329.3
2201,76482858,2023-01-31,,568.63
2476,76482858,2023-02-04,-1084.8,-516.17
3647,76482858,2023-02-05,124.61,-391.55999999999995
4071,76482858,2023-02-06,202.83,-188.72999999999996
4669,76482858,2023-02-07,1236.7,1047.97
4449,76482858,2023-02-08,-782.7,265.27
2202,76524911,2023-01-31,,190.9
325,76524911,2023-02-01,-41.55,149.35000000000002
5635,76524911,2023-02-05,-65.57,83.78000000000002
8209,76524911,2023-02-07,176.26,260.04
2332,76524911,2023-02-13,69.71,329.75
2203,76537084,2023-01-31,,884.7
8190,76537084,2023-02-03,77.14,961.84
6113,76537084,2023-02-03,-86.49,875.35
8502,76537084,2023-02-05,-117.8,757.5500000000001
4505,76537084,2023-02-06,83.76,841.3100000000001
4342,76537084,2023-02-11,84.29,925.6
4541,76537084,2023-02-12,-76.36,849.24
2347,76537084,2023-02-13,76.58,925.82
2204,76546657,2023-01-31,,434.77
1018,76546657,2023-02-03,-99.85,334.91999999999996
4068,76546657,2023-02-05,-122.25,212.67
623,76546657,2023-02-06,-88.52,124.14999999999999
1032,76546657,2023-02-07,-14.81,109.33999999999999
3568,76546657,2023-02-07,-85.6,23.739999999999995
7967,76546657,2023-02-08,-1123.1,-1099.36
4132,76546657,2023-02-09,1363.6,264.24
1157,76546657,2023-02-10,209.84,474.08000000000004
2205,76629706,2023-01-31,,962.66
4888,76629706,2023-02-04,126.02,1088.68
5226,76629706,2023-02-04,52.76,1141.44
5866,76629706,2023-02-07,105.66,1247.1
7750,76629706,2023-02-09,-158.66,1088.44
5595,76629706,2023-02-10,74.41,1162.85
2206,76662799,2023-01-31,,296.68
4192,76662799,2023-02-01,-84.07,212.61
4474,76662799,2023-02-04,-76.66,135.95000000000002
2792,76662799,2023-02-06,-77.47,58.48000000000002
1846,76662799,2023-02-08,60.7,119.18000000000002
4661,76662799,2023-02-08,-67.17,52.01000000000002
4004,76662799,2023-02-09,70.71,122.72000000000001
4999,76662799,2023-02-10,-1394.1,-1271.3799999999999
4130,76662799,2023-02-14,95.2,-1176.1799999999998
2207,76698056,2023-01-31,,827.36
7320,76698056,2023-02-02,206.91,1034.27
1404,76698056,2023-02-02,111.34,1145.6100000000001
6127,76698056,2023-02-02,98.37,1243.98
4041,76698056,2023-02-03,9.03,1253.01
1262,76698056,2023-02-07,84.97,1337.98
7717,76698056,2023-02-07,-124.31,1213.67
1449,76698056,2023-02-08,221.0,1434.67
2208,76720959,2023-01-31,,436.06
7263,76720959,2023-02-04,100.63,536.69
891,76720959,2023-02-05,93.03,629.72
6750,76720959,2023-02-07,93.88,723.6
437,76720959,2023-02-10,-166.54,557.06
3797,76720959,2023-02-13,133.35,690.41
2209,76787359,2023-01-31,,386.73
4723,76787359,2023-02-03,116.55,503.28000000000003
2712,76787359,2023-02-03,-110.59,392.69
1456,76787359,2023-02-04,1398.7,1791.39
5693,76787359,2023-02-06,-61.92,1729.47
7186,76787359,2023-02-07,-151.4,1578.0700000000002
4350,76787359,2023-02-07,-808.1,769.97
4107,76787359,2023-02-08,154.93,924.9000000000001
2210,76799768,2023-01-31,,981.08
1808,76799768,2023-02-01,-77.81,903.27
4860,76799768,2023-02-03,50.4,953.6700000000001
3385,76799768,2023-02-03,-100.81,852.86
1505,76799768,2023-02-03,-644.3,208.56000000000006
4119,76799768,2023-02-04,73.93,282.49000000000007
6948,76799768,2023-02-04,53.8,336.2900000000001
5500,76799768,2023-02-04,49.53,385.82000000000005
2430,76799768,2023-02-06,-71.52,314.30000000000007
7205,76799768,2023-02-09,81.65,395.95000000000005
3439,76799768,2023-02-14,55.79,451.74000000000007
2211,76847816,2023-01-31,,197.8
8671,76847816,2023-02-01,-16.06,181.74
6263,76847816,2023-02-01,-129.39,52.35000000000002
5404,76847816,2023-02-02,-699.5,-647.15
7537,76847816,2023-02-03,1259.6,612.4499999999999
1640,76847816,2023-02-07,-1282.4,-669.9500000000002
1547,76847816,2023-02-09,160.1,-509.85000000000014
6459,76847816,2023-02-10,115.98,-393.8700000000002
7299,76847816,2023-02-12,1268.1,874.2299999999998
5141,76847816,2023-02-12,-92.93,781.2999999999997
692,76847816,2023-02-13,-67.88,713.4199999999998
2212,76857747,2023-01-31,,952.88
6420,76857747,2023-02-04,-63.46,889.42
8018,76857747,2023-02-04,-122.06,767.36
1165,76857747,2023-02-05,-70.81,696.55
5355,76857747,2023-02-06,112.33,808.88
3818,76857747,2023-02-07,97.82,906.6999999999999
5762,76857747,2023-02-08,117.22,1023.92
3519,76857747,2023-02-09,107.22,1131.1399999999999
8327,76857747,2023-02-10,205.21,1336.35
7639,76857747,2023-02-11,75.48,1411.83
7201,76857747,2023-02-12,122.61,1534.44
2213,76869201,2023-01-31,,515.62
1398,76869201,2023-02-01,-98.26,417.36
7738,76869201,2023-02-04,-149.33,268.03
2281,76869201,2023-02-05,-84.35,183.67999999999998
3343,76869201,2023-02-09,1485.0,1668.68
5316,76869201,2023-02-12,-128.28,1540.4
6186,76869201,2023-02-14,-20.41,1519.99
2214,76869375,2023-01-31,,894.84
746,76869375,2023-02-01,92.35,987.19
6896,76869375,2023-02-01,41.18,1028.3700000000001
5059,76869375,2023-02-02,-103.03,925.34
3451,76869375,2023-02-03,141.16,1066.5
8645,76869375,2023-02-04,96.31,1162.81
2441,76869375,2023-02-05,-54.79,1108.02
4250,76869375,2023-02-06,-82.75,1025.27
6652,76869375,2023-02-13,148.17,1173.44
2215,76953050,2023-01-31,,453.1
3472,76953050,2023-02-04,-89.97,363.13
1736,76953050,2023-02-05,129.47,492.6
2627,76953050,2023-02-09,39.39,531.99
1011,76953050,2023-02-10,102.06,634.0500000000001
3334,76953050,2023-02-14,120.54,754.59
2216,77010964,2023-01-31,,899.11
4462,77010964,2023-02-05,91.81,990.9200000000001
1002,77010964,2023-02-07,57.25,1048.17
3626,77010964,2023-02-10,-116.67,931.5
7458,77010964,2023-02-11,85.0,1016.5
800,77010964,2023-02-11,-70.24,946.26
2217,77017650,2023-01-31,,699.24
595,77017650,2023-02-01,-103.04,596.2
8242,77017650,2023-02-03,121.15,717.35
6984,77017650,2023-02-04,-92.05,625.3
1526,77017650,2023-02-07,121.9,747.2
926,77017650,2023-02-07,38.41,785.61
8340,77017650,2023-02-08,96.4,882.01
1756,77017650,2023-02-08,-104.18,777.83
605,77017650,2023-02-12,-57.5,720.33
8553,77017650,2023-02-12,-95.8,624.53
3177,77017650,2023-02-13,98.44,722.97
8414,77017650,2023-02-13,-56.42,666.55
3816,77017650,2023-02-14,113.46,780.01
8348,77017650,2023-02-14,-49.55,730.46
2318,77017650,2023-02-14,-116.74,613.72
2218,77026279,2023-01-31,,126.05
621,77026279,2023-02-05,-39.2,86.85
3130,77026279,2023-02-06,101.4,188.25
3024,77026279,2023-02-08,36.78,225.03
2573,77026279,2023-02-09,-105.04,119.99
4365,77026279,2023-02-12,1640.8,1760.79
3054,77026279,2023-02-13,101.58,1862.37
6476,77026279,2023-02-13,-136.98,1725.3899999999999
2219,77207452,2023-01-31,,696.83
3755,77207452,2023-02-04,104.45,801.2800000000001
463,77207452,2023-02-04,65.13,866.4100000000001
7757,77207452,2023-02-04,35.68,902.09
1243,77207452,2023-02-09,-77.75,824.34
1378,77207452,2023-02-10,-104.39,719.95
749,77207452,2023-02-10,-1975.6,-1255.6499999999999
3851,77207452,2023-02-11,150.26,-1105.3899999999999
6656,77207452,2023-02-11,-482.1,-1587.4899999999998
769,77207452,2023-02-11,-531.4,-2118.89
2220,77241606,2023-01-31,,761.38
502,77241606,2023-02-02,-106.05,655.33
6759,77241606,2023-02-07,174.77,830.1
7318,77241606,2023-02-07,-97.26,732.84
1433,77241606,2023-02-08,-84.11,648.73
4862,77241606,2023-02-09,-5.59,643.14
5603,77241606,2023-02-12,141.01,784.15
370,77241606,2023-02-12,77.9,862.05
2221,77243259,2023-01-31,,614.86
7679,77243259,2023-02-01,86.97,701.83
1393,77243259,2023-02-01,-106.89,594.94
4970,77243259,2023-02-02,86.62,681.5600000000001
6709,77243259,2023-02-08,97.07,778.63
1297,77243259,2023-02-08,-164.7,613.9300000000001
360,77243259,2023-02-10,90.2,704.13
6044,77243259,2023-02-12,123.95,828.08
2222,77289104,2023-01-31,,737.08
4973,77289104,2023-02-03,145.14,882.22
5061,77289104,2023-02-06,134.08,1016.3000000000001
2512,77289104,2023-02-07,67.04,1083.3400000000001
4081,77289104,2023-02-10,-148.04,935.3000000000001
7626,77289104,2023-02-13,93.21,1028.51
2223,77342574,2023-01-31,,907.34
7769,77342574,2023-02-01,-115.41,791.9300000000001
4348,77342574,2023-02-02,24.05,815.98
4876,77342574,2023-02-02,-132.64,683.34
5843,77342574,2023-02-02,-1666.0,-982.66
3323,77342574,2023-02-02,-1774.7,-2757.36
735,77342574,2023-02-04,-127.8,-2885.16
6242,77342574,2023-02-10,-187.69,-3072.85
5633,77342574,2023-02-13,211.13,-2861.72
5157,77342574,2023-02-14,114.72,-2747.0
7999,77342574,2023-02-14,-40.73,-2787.73
1068,77342574,2023-02-14,-130.66,-2918.39
2224,77377150,2023-01-31,,673.03
5865,77377150,2023-02-01,-8.07,664.9599999999999
6039,77377150,2023-02-06,-144.03,520.93
1922,77377150,2023-02-08,-112.44,408.49
6931,77377150,2023-02-11,-139.56,268.92999999999995
4768,77377150,2023-02-12,-791.8,-522.87
2225,77379844,2023-01-31,,32.65
5721,77379844,2023-02-02,55.08,87.72999999999999
1052,77379844,2023-02-03,-139.16,-51.43000000000001
636,77379844,2023-02-04,-137.7,-189.13
598,77379844,2023-02-06,136.6,-52.53
7324,77379844,2023-02-13,-37.83,-90.36
2226,77387016,2023-01-31,,894.34
671,77387016,2023-02-05,505.0,1399.3400000000001
4445,77387016,2023-02-14,707.3,2106.64
2227,77418940,2023-01-31,,263.71
5839,77418940,2023-02-03,159.42,423.13
4871,77418940,2023-02-04,127.76,550.89
6741,77418940,2023-02-05,-37.76,513.13
6125,77418940,2023-02-05,-83.83,429.29999999999995
24,77418940,2023-02-10,92.09,521.39
8233,77418940,2023-02-11,1012.8,1534.19
6603,77418940,2023-02-11,-80.51,1453.6799999999998
1394,77418940,2023-02-11,-130.61,1323.07
953,77418940,2023-02-11,-187.53,1135.54
2228,77447018,2023-01-31,,754.64
3606,77447018,2023-02-03,-56.34,698.3
5421,77447018,2023-02-08,-59.47,638.8299999999999
6794,77447018,2023-02-08,-163.05,475.78
7350,77447018,2023-02-10,159.2,634.98
2147,77447018,2023-02-10,-123.76,511.21999999999997
2083,77447018,2023-02-11,-50.07,461.15
5706,77447018,2023-02-11,-147.81,313.3399999999999
2229,77504884,2023-01-31,,221.03
7120,77504884,2023-02-01,695.3,916.3299999999999
1438,77504884,2023-02-07,122.99,1039.32
2807,77504884,2023-02-08,108.51,1147.83
4965,77504884,2023-02-08,92.11,1239.9399999999998
3351,77504884,2023-02-08,-43.89,1196.05
6903,77504884,2023-02-12,-51.05,1145.0
5359,77504884,2023-02-12,-118.61,1026.3899999999999
2230,77551209,2023-01-31,,7.33
7980,77551209,2023-02-04,1795.8,1803.1299999999999
7727,77551209,2023-02-05,-69.16,1733.9699999999998
2963,77551209,2023-02-09,666.4,2400.37
8228,77551209,2023-02-09,136.79,2537.16
4237,77551209,2023-02-11,-573.2,1963.9599999999998
58,77551209,2023-02-13,-104.56,1859.3999999999999
2231,77554032,2023-01-31,,646.5
3241,77554032,2023-02-02,45.75,692.25
8443,77554032,2023-02-02,-124.34,567.91
1713,77554032,2023-02-04,58.86,626.77
8455,77554032,2023-02-07,-198.21,428.56
5646,77554032,2023-02-07,-1029.9,-601.3400000000001
1323,77554032,2023-02-10,-23.96,-625.3000000000002
4506,77554032,2023-02-10,-101.72,-727.0200000000002
2232,77587664,2023-01-31,,769.43
1122,77587664,2023-02-04,-72.49,696.9399999999999
1564,77587664,2023-02-05,-90.66,606.28
1761,77587664,2023-02-06,154.81,761.0899999999999
5246,77587664,2023-02-06,51.05,812.14
1322,77587664,2023-02-07,-33.35,778.79
1721,77587664,2023-02-09,-89.39,689.4
4832,77587664,2023-02-12,72.94,762.3399999999999
2233,77646359,2023-01-31,,434.93
3296,77646359,2023-02-11,43.47,478.4
2234,77668890,2023-01-31,,804.88
3258,77668890,2023-02-02,-103.44,701.44
6061,77668890,2023-02-03,590.1,1291.54
8346,77668890,2023-02-03,-101.3,1190.24
3352,77668890,2023-02-05,-149.93,1040.31
2353,77668890,2023-02-10,-120.91,919.4
5296,77668890,2023-02-11,-174.4,745.0
4404,77668890,2023-02-13,-98.34,646.66
1206,77668890,2023-02-14,132.75,779.41
5380,77668890,2023-02-14,18.83,798.2399999999999
5380,77668890,2023-02-14,-18.83,779.41
4479,77668890,2023-02-14,-33.09,746.3199999999999
2235,77688406,2023-01-31,,224.2
2835,77688406,2023-02-05,49.84,274.03999999999996
7483,77688406,2023-02-06,-16.5,257.53999999999996
2435,77688406,2023-02-07,1516.3,1773.84
2595,77688406,2023-02-08,-140.07,1633.77
8240,77688406,2023-02-10,95.08,1728.85
7494,77688406,2023-02-14,-101.1,1627.75
2236,77717508,2023-01-31,,493.27
2303,77717508,2023-02-01,-173.96,319.30999999999995
3285,77717508,2023-02-03,-73.31,245.99999999999997
2130,77717508,2023-02-04,119.83,365.83
7942,77717508,2023-02-12,125.62,491.45
8624,77717508,2023-02-12,110.26,601.71
4620,77717508,2023-02-12,99.41,701.12
2237,77722115,2023-01-31,,735.94
7101,77722115,2023-02-01,-160.76,575.1800000000001
2515,77722115,2023-02-02,-130.9,444.2800000000001
6668,77722115,2023-02-03,129.36,573.6400000000001
6610,77722115,2023-02-05,92.6,666.24
5818,77722115,2023-02-05,80.56,746.8000000000001
4504,77722115,2023-02-05,-138.32,608.48
6131,77722115,2023-02-06,134.96,743.44
348,77722115,2023-02-07,-204.81,538.6300000000001
6918,77722115,2023-02-09,178.61,717.2400000000001
8218,77722115,2023-02-14,-142.86,574.3800000000001
2238,77737443,2023-01-31,,220.7
2008,77737443,2023-02-03,-115.87,104.82999999999998
5831,77737443,2023-02-04,-187.19,-82.36000000000001
2665,77737443,2023-02-06,103.08,20.719999999999985
6498,77737443,2023-02-07,44.02,64.73999999999998
6302,77737443,2023-02-11,73.94,138.67999999999998
8499,77737443,2023-02-12,93.78,232.45999999999998
5755,77737443,2023-02-12,11.78,244.23999999999998
2239,77792490,2023-01-31,,822.76
6030,77792490,2023-02-01,-150.38,672.38
5047,77792490,2023-02-03,122.22,794.6
3367,77792490,2023-02-04,-123.43,671.17
2895,77792490,2023-02-04,-133.46,537.71
7166,77792490,2023-02-06,124.17,661.88
8270,77792490,2023-02-11,-89.5,572.38
7535,77792490,2023-02-11,-92.62,479.76
1622,77792490,2023-02-12,132.28,612.04
6692,77792490,2023-02-13,111.75,723.79
2240,77797288,2023-01-31,,199.97
7287,77797288,2023-02-02,-68.63,131.34
2638,77797288,2023-02-05,1852.7,1984.04
6077,77797288,2023-02-12,1808.9,3792.94
7168,77797288,2023-02-12,-108.19,3684.75
2241,77802960,2023-01-31,,157.47
392,77802960,2023-02-06,-156.97,0.5
1164,77802960,2023-02-07,-106.8,-106.3
5578,77802960,2023-02-14,140.97,34.67
2242,77838890,2023-01-31,,951.16
6313,77838890,2023-02-01,85.61,1036.77
5022,77838890,2023-02-10,812.8,1849.57
5652,77838890,2023-02-11,-11.3,1838.27
1789,77838890,2023-02-13,101.4,1939.6699999999998
6533,77838890,2023-02-14,56.24,1995.9099999999999
2243,77841390,2023-01-31,,673.82
6111,77841390,2023-02-04,-81.91,591.9100000000001
8126,77841390,2023-02-07,-98.66,493.25000000000006
1376,77841390,2023-02-08,1908.7,2401.9500000000003
2418,77841390,2023-02-12,-151.37,2250.58
8575,77841390,2023-02-13,-61.83,2188.75
607,77841390,2023-02-14,-44.44,2144.31
2244,77847751,2023-01-31,,850.14
1241,77847751,2023-02-09,-74.39,775.75
1532,77847751,2023-02-10,-195.79,579.96
7930,77847751,2023-02-13,26.0,605.96
6806,77847751,2023-02-14,-302.7,303.26
2245,77867306,2023-01-31,,907.96
1270,77867306,2023-02-06,-168.93,739.03
7580,77867306,2023-02-09,-190.68,548.35
4151,77867306,2023-02-09,-787.2,-238.85000000000002
7615,77867306,2023-02-11,-851.2,-1090.0500000000002
8102,77867306,2023-02-12,76.15,-1013.9000000000001
4954,77867306,2023-02-14,-69.99,-1083.89
2246,77880852,2023-01-31,,550.69
2269,77880852,2023-02-02,179.67,730.36
5886,77880852,2023-02-03,-113.03,617.33
7697,77880852,2023-02-04,1649.2,2266.53
5305,77880852,2023-02-04,55.7,2322.23
8,77880852,2023-02-06,-140.03,2182.2
8490,77880852,2023-02-07,81.45,2263.65
7345,77880852,2023-02-10,47.22,2310.87
1839,77880852,2023-02-10,-103.62,2207.25
52,77880852,2023-02-12,68.38,2275.63
2247,77911836,2023-01-31,,87.75
4469,77911836,2023-02-02,-51.61,36.14
267,77911836,2023-02-03,46.29,82.43
3727,77911836,2023-02-03,-622.9,-540.47
928,77911836,2023-02-06,-114.33,-654.8
5199,77911836,2023-02-08,99.5,-555.3
2248,77913078,2023-01-31,,885.96
2656,77913078,2023-02-01,14.22,900.1800000000001
7150,77913078,2023-02-02,93.5,993.6800000000001
8584,77913078,2023-02-03,-193.29,800.3900000000001
7970,77913078,2023-02-10,43.52,843.9100000000001
4443,77913078,2023-02-12,154.82,998.73
2249,77917083,2023-01-31,,929.41
4011,77917083,2023-02-04,135.89,1065.3
4162,77917083,2023-02-05,-78.8,986.5
905,77917083,2023-02-08,1119.6,2106.1
2250,77931114,2023-01-31,,480.52
2055,77931114,2023-02-01,57.95,538.47
708,77931114,2023-02-05,64.41,602.88
3026,77931114,2023-02-06,-67.96,534.92
2249,77931114,2023-02-07,-99.87,435.04999999999995
5453,77931114,2023-02-09,-82.99,352.06
1003,77931114,2023-02-11,-181.51,170.55
7861,77931114,2023-02-12,-1041.9,-871.3500000000001
2251,77966293,2023-01-31,,904.28
3074,77966293,2023-02-03,-77.0,827.28
2788,77966293,2023-02-04,44.5,871.78
3556,77966293,2023-02-05,81.21,952.99
4607,77966293,2023-02-06,22.54,975.53
3163,77966293,2023-02-08,132.99,1108.52
45,77966293,2023-02-08,96.66,1205.18
4529,77966293,2023-02-12,-134.41,1070.77
197,77966293,2023-02-13,-81.41,989.36
146,77966293,2023-02-14,100.41,1089.77
2252,77980498,2023-01-31,,893.87
7544,77980498,2023-02-01,-50.55,843.32
2983,77980498,2023-02-01,-81.36,761.96
337,77980498,2023-02-01,-102.31,659.65
1810,77980498,2023-02-04,-46.96,612.69
3265,77980498,2023-02-10,819.0,1431.69
3760,77980498,2023-02-11,36.07,1467.76
2253,78004131,2023-01-31,,723.24
292,78004131,2023-02-01,-34.17,689.07
4976,78004131,2023-02-04,-37.75,651.32
6816,78004131,2023-02-07,-12.69,638.63
7656,78004131,2023-02-08,-1245.5,-606.87
2569,78004131,2023-02-10,156.94,-449.93
2254,78047487,2023-01-31,,417.33
1593,78047487,2023-02-13,-61.15,356.18
2255,78065026,2023-01-31,,356.26
3264,78065026,2023-02-02,-80.01,276.25
7470,78065026,2023-02-05,-41.55,234.7
1034,78065026,2023-02-07,-75.46,159.24
358,78065026,2023-02-09,38.34,197.57999999999998
2558,78065026,2023-02-13,-194.21,3.3700000000000045
2256,78072161,2023-01-31,,914.19
5054,78072161,2023-02-01,-76.69,837.5
2887,78072161,2023-02-03,70.99,908.49
3783,78072161,2023-02-05,-175.05,733.44
1242,78072161,2023-02-06,-118.48,614.96
6823,78072161,2023-02-07,111.08,726.0400000000001
5769,78072161,2023-02-11,-102.26,623.7800000000001
2257,78076137,2023-01-31,,290.47
2337,78076137,2023-02-01,128.93,419.40000000000003
3241,78076137,2023-02-02,-45.75,373.65000000000003
8110,78076137,2023-02-04,1231.2,1604.8500000000001
5389,78076137,2023-02-04,-130.12,1474.73
6848,78076137,2023-02-05,-357.9,1116.8300000000002
5360,78076137,2023-02-10,-171.22,945.6100000000001
8284,78076137,2023-02-12,78.91,1024.5200000000002
2235,78076137,2023-02-13,115.5,1140.0200000000002
3510,78076137,2023-02-13,-734.3,405.72000000000025
2258,78129803,2023-01-31,,233.76
1421,78129803,2023-02-03,38.61,272.37
8124,78129803,2023-02-03,-168.33,104.03999999999996
1019,78129803,2023-02-05,540.8,644.8399999999999
7978,78129803,2023-02-08,-154.46,490.3799999999999
7939,78129803,2023-02-11,35.03,525.4099999999999
486,78129803,2023-02-12,146.81,672.2199999999999
2637,78129803,2023-02-12,-122.36,549.8599999999999
8643,78129803,2023-02-13,-41.75,508.1099999999999
4673,78129803,2023-02-13,-79.84,428.2699999999999
2259,78133064,2023-01-31,,103.96
3258,78133064,2023-02-02,103.44,207.39999999999998
1673,78133064,2023-02-02,-156.52,50.879999999999995
6943,78133064,2023-02-03,1935.5,1986.38
5809,78133064,2023-02-10,129.69,2116.07
765,78133064,2023-02-12,177.52,2293.59
2462,78133064,2023-02-12,149.27,2442.86
8104,78133064,2023-02-12,-100.06,2342.8
2260,78167719,2023-01-31,,969.06
6589,78167719,2023-02-03,53.43,1022.4899999999999
1347,78167719,2023-02-03,-130.91,891.5799999999999
4863,78167719,2023-02-04,944.5,1836.08
3209,78167719,2023-02-04,71.57,1907.6499999999999
3922,78167719,2023-02-07,142.95,2050.6
6911,78167719,2023-02-07,-84.81,1965.79
8094,78167719,2023-02-09,-63.95,1901.84
5241,78167719,2023-02-14,-97.06,1804.78
885,78167719,2023-02-14,-110.42,1694.36
476,78167719,2023-02-14,-147.72,1546.6399999999999
2261,78175956,2023-01-31,,124.55
1629,78175956,2023-02-02,114.44,238.99
1704,78175956,2023-02-04,-74.84,164.14999999999998
1362,78175956,2023-02-06,106.31,270.46
2154,78175956,2023-02-09,-10.05,260.40999999999997
2496,78175956,2023-02-14,-61.34,199.07
2262,78184766,2023-01-31,,98.1
6016,78184766,2023-02-05,-109.41,-11.310000000000002
1169,78184766,2023-02-08,43.9,32.589999999999996
3925,78184766,2023-02-08,-68.63,-36.04
5278,78184766,2023-02-10,-75.51,-111.55000000000001
4160,78184766,2023-02-12,-76.71,-188.26
2263,78234498,2023-01-31,,697.88
4670,78234498,2023-02-01,69.18,767.06
7859,78234498,2023-02-04,1369.6,2136.66
6609,78234498,2023-02-13,112.88,2249.54
2264,78257880,2023-01-31,,933.22
4764,78257880,2023-02-03,753.5,1686.72
3353,78257880,2023-02-03,180.52,1867.24
5128,78257880,2023-02-03,97.96,1965.2
393,78257880,2023-02-08,151.47,2116.67
1995,78257880,2023-02-09,548.3,2664.9700000000003
4705,78257880,2023-02-09,-587.9,2077.07
7267,78257880,2023-02-10,-31.28,2045.79
2265,78268704,2023-01-31,,888.99
3524,78268704,2023-02-05,997.4,1886.3899999999999
4339,78268704,2023-02-05,141.36,2027.75
3411,78268704,2023-02-06,431.9,2459.65
15,78268704,2023-02-07,-26.33,2433.32
361,78268704,2023-02-07,-86.16,2347.16
4735,78268704,2023-02-13,-24.32,2322.84
2266,78296743,2023-01-31,,406.97
6086,78296743,2023-02-01,-1888.2,-1481.23
4440,78296743,2023-02-02,-108.67,-1589.9
7116,78296743,2023-02-07,-94.27,-1684.17
3627,78296743,2023-02-08,96.34,-1587.83
6839,78296743,2023-02-08,-36.72,-1624.55
6339,78296743,2023-02-08,-154.6,-1779.15
3319,78296743,2023-02-09,-103.44,-1882.59
1555,78296743,2023-02-10,-66.19,-1948.78
1975,78296743,2023-02-10,-143.84,-2092.62
7330,78296743,2023-02-13,62.36,-2030.26
3437,78296743,2023-02-13,-334.9,-2365.16
2267,78303304,2023-01-31,,921.4
2945,78303304,2023-02-03,-108.32,813.0799999999999
5575,78303304,2023-02-06,-91.58,721.5
4961,78303304,2023-02-08,130.43,851.9300000000001
2268,78343618,2023-01-31,,30.43
2694,78343618,2023-02-01,80.43,110.86000000000001
8101,78343618,2023-02-01,9.32,120.18
8405,78343618,2023-02-02,72.9,193.08
5524,78343618,2023-02-02,-1193.3,-1000.2199999999999
2470,78343618,2023-02-03,-1632.0,-2632.22
8063,78343618,2023-02-08,107.47,-2524.75
1588,78343618,2023-02-13,164.76,-2359.99
2269,78362587,2023-01-31,,390.79
4979,78362587,2023-02-01,-1292.5,-901.71
5417,78362587,2023-02-02,142.45,-759.26
475,78362587,2023-02-02,-1499.9,-2259.16
6368,78362587,2023-02-04,1266.4,-992.76
4254,78362587,2023-02-04,-66.32,-1059.08
795,78362587,2023-02-04,-1510.5,-2569.58
3983,78362587,2023-02-07,-136.3,-2705.88
5680,78362587,2023-02-10,35.64,-2670.24
4421,78362587,2023-02-10,-25.41,-2695.65
3899,78362587,2023-02-12,-118.77,-2814.42
2270,78392456,2023-01-31,,592.04
359,78392456,2023-02-02,123.8,715.8399999999999
1094,78392456,2023-02-04,-41.13,674.7099999999999
2257,78392456,2023-02-05,65.73,740.4399999999999
6712,78392456,2023-02-07,-71.99,668.4499999999999
4503,78392456,2023-02-09,158.77,827.22
7748,78392456,2023-02-10,-222.4,604.8199999999999
1697,78392456,2023-02-11,205.44,810.26
1726,78392456,2023-02-11,94.31,904.5699999999999
5847,78392456,2023-02-12,108.51,1013.0799999999999
2740,78392456,2023-02-13,-42.54,970.54
2271,78395863,2023-01-31,,458.24
5953,78395863,2023-02-01,168.34,626.58
1144,78395863,2023-02-02,379.5,1006.08
1507,78395863,2023-02-02,-101.46,904.62
1812,78395863,2023-02-03,-153.58,751.04
7972,78395863,2023-02-09,-49.68,701.36
8477,78395863,2023-02-10,85.31,786.6700000000001
8387,78395863,2023-02-11,-126.78,659.89
5638,78395863,2023-02-12,-1619.3,-959.41
1205,78395863,2023-02-13,177.52,-781.89
2272,78493642,2023-01-31,,748.98
1234,78493642,2023-02-02,53.59,802.57
8170,78493642,2023-02-02,-54.11,748.46
7435,78493642,2023-02-02,-103.47,644.99
8647,78493642,2023-02-07,185.02,830.01
6830,78493642,2023-02-07,113.23,943.24
8418,78493642,2023-02-07,65.6,1008.84
1502,78493642,2023-02-09,134.78,1143.6200000000001
6530,78493642,2023-02-10,167.69,1311.31
3167,78493642,2023-02-13,161.8,1473.1100000000001
2273,78501355,2023-01-31,,910.42
4094,78501355,2023-02-04,1610.8,2521.22
4477,78501355,2023-02-07,210.28,2731.5
6088,78501355,2023-02-10,1038.8,3770.3
2274,78541427,2023-01-31,,366.51
4412,78541427,2023-02-03,718.2,1084.71
4247,78541427,2023-02-06,-981.9,102.81000000000006
5077,78541427,2023-02-06,-1751.6,-1648.79
7451,78541427,2023-02-07,76.58,-1572.21
6947,78541427,2023-02-09,-32.87,-1605.08
3517,78541427,2023-02-13,116.3,-1488.78
5386,78541427,2023-02-14,-95.3,-1584.08
2275,78580221,2023-01-31,,271.94
518,78580221,2023-02-01,105.16,377.1
4753,78580221,2023-02-06,-121.13,255.97
3974,78580221,2023-02-12,-96.6,159.37
241,78580221,2023-02-12,-197.29,-37.91999999999999
6560,78580221,2023-02-14,119.48,81.56000000000002
2276,78584818,2023-01-31,,723.21
4762,78584818,2023-02-02,122.42,845.63
5327,78584818,2023-02-03,119.02,964.6500000000001
4763,78584818,2023-02-07,124.55,1089.2
7995,78584818,2023-02-09,-56.03,1033.17
2277,78667134,2023-01-31,,672.23
5160,78667134,2023-02-02,-93.09,579.14
937,78667134,2023-02-03,-135.44,443.70000000000005
4327,78667134,2023-02-04,153.31,597.01
418,78667134,2023-02-04,39.71,636.72
6709,78667134,2023-02-08,-97.07,539.6500000000001
7241,78667134,2023-02-13,77.77,617.4200000000001
1382,78667134,2023-02-13,-55.07,562.35
8411,78667134,2023-02-14,-68.56,493.79
2278,78673350,2023-01-31,,307.25
7837,78673350,2023-02-03,74.72,381.97
1922,78673350,2023-02-08,112.44,494.40999999999997
2296,78673350,2023-02-09,-137.17,357.24
5136,78673350,2023-02-14,18.62,375.86
2279,78716149,2023-01-31,,658.83
5125,78716149,2023-02-01,-49.84,608.99
331,78716149,2023-02-02,-184.29,424.70000000000005
2446,78716149,2023-02-06,38.7,463.40000000000003
2729,78716149,2023-02-08,40.13,503.53000000000003
2334,78716149,2023-02-10,-106.03,397.50000000000006
3751,78716149,2023-02-14,85.81,483.31000000000006
2280,78767161,2023-01-31,,248.42
5871,78767161,2023-02-01,-115.41,133.01
5754,78767161,2023-02-02,22.54,155.54999999999998
670,78767161,2023-02-02,-133.59,21.95999999999998
99,78767161,2023-02-05,-185.3,-163.34000000000003
2639,78767161,2023-02-06,8.04,-155.30000000000004
7945,78767161,2023-02-06,-69.84,-225.14000000000004
815,78767161,2023-02-08,110.07,-115.07000000000005
2522,78767161,2023-02-11,75.14,-39.93000000000005
7909,78767161,2023-02-14,-103.18,-143.11000000000007
2281,78773905,2023-01-31,,511.78
6760,78773905,2023-02-10,-189.51,322.27
2255,78773905,2023-02-11,-1104.5,-782.23
4045,78773905,2023-02-12,116.83,-665.4
3588,78773905,2023-02-12,-51.02,-716.4200000000001
3164,78773905,2023-02-13,-38.13,-754.5500000000001
2282,78807944,2023-01-31,,442.48
8208,78807944,2023-02-01,-90.9,351.58000000000004
3286,78807944,2023-02-04,-134.34,217.24
342,78807944,2023-02-06,141.23,358.47
7982,78807944,2023-02-07,226.83,585.3
5105,78807944,2023-02-08,-9.19,576.11
3958,78807944,2023-02-10,152.17,728.28
6470,78807944,2023-02-12,-75.44,652.84
2287,78807944,2023-02-12,-169.34,483.5
4337,78807944,2023-02-13,92.53,576.03
3167,78807944,2023-02-13,-161.8,414.23
2283,78844183,2023-01-31,,194.7
3355,78844183,2023-02-02,-12.35,182.35
6516,78844183,2023-02-05,-181.42,0.9300000000000068
7346,78844183,2023-02-06,-132.29,-131.35999999999999
1074,78844183,2023-02-12,-50.34,-181.7
2922,78844183,2023-02-13,-101.09,-282.78999999999996
2284,78905675,2023-01-31,,11.18
3774,78905675,2023-02-01,-84.08,-72.9
2548,78905675,2023-02-04,-138.04,-210.93999999999997
4355,78905675,2023-02-05,-101.84,-312.78
773,78905675,2023-02-08,129.7,-183.07999999999998
8039,78905675,2023-02-08,100.85,-82.22999999999999
2825,78905675,2023-02-08,53.66,-28.569999999999993
5444,78905675,2023-02-09,35.18,6.6100000000000065
2831,78905675,2023-02-10,11.07,17.680000000000007
124,78905675,2023-02-13,-48.01,-30.32999999999999
19,78905675,2023-02-13,-79.92,-110.25
2285,78913378,2023-01-31,,378.08
4906,78913378,2023-02-01,-84.25,293.83
1203,78913378,2023-02-03,-127.62,166.20999999999998
8077,78913378,2023-02-04,68.87,235.07999999999998
1086,78913378,2023-02-04,-143.88,91.19999999999999
4022,78913378,2023-02-05,-58.45,32.749999999999986
5441,78913378,2023-02-06,-711.2,-678.45
8603,78913378,2023-02-08,146.5,-531.95
6885,78913378,2023-02-12,-72.09,-604.0400000000001
1361,78913378,2023-02-12,-85.39,-689.4300000000001
2286,78927989,2023-01-31,,825.23
7722,78927989,2023-02-02,22.64,847.87
5422,78927989,2023-02-05,-60.35,787.52
4415,78927989,2023-02-05,-1174.8,-387.28
648,78927989,2023-02-07,-105.18,-492.46
5747,78927989,2023-02-09,217.27,-275.18999999999994
1215,78927989,2023-02-09,153.45,-121.73999999999998
3961,78927989,2023-02-11,-148.81,-270.54999999999995
8210,78927989,2023-02-12,66.32,-204.23
5717,78927989,2023-02-13,66.55,-137.68
8061,78927989,2023-02-13,52.26,-85.41999999999999
4309,78927989,2023-02-14,-31.7,-117.11999999999999
8111,78927989,2023-02-14,-34.84,-151.95999999999998
2287,78945298,2023-01-31,,609.68
3385,78945298,2023-02-03,100.81,710.49
5309,78945298,2023-02-04,1320.2,2030.69
7202,78945298,2023-02-05,119.75,2150.44
1183,78945298,2023-02-05,115.53,2265.9700000000003
3154,78945298,2023-02-07,883.6,3149.57
2070,78945298,2023-02-07,-194.01,2955.56
5682,78945298,2023-02-08,58.82,3014.38
4373,78945298,2023-02-09,-115.06,2899.32
2288,78953379,2023-01-31,,45.3
7371,78953379,2023-02-02,-181.56,-136.26
6425,78953379,2023-02-05,53.54,-82.72
6661,78953379,2023-02-05,-325.0,-407.72
7277,78953379,2023-02-10,80.36,-327.36
3798,78953379,2023-02-12,85.93,-241.43
2406,78953379,2023-02-12,53.57,-187.86
7895,78953379,2023-02-14,-63.74,-251.60000000000002
2289,79015773,2023-01-31,,706.11
7837,79015773,2023-02-03,-74.72,631.39
2499,79015773,2023-02-10,111.05,742.44
6779,79015773,2023-02-11,74.36,816.8
6057,79015773,2023-02-12,-91.81,724.99
3888,79015773,2023-02-12,-95.84,629.15
7742,79015773,2023-02-13,39.15,668.3
2100,79015773,2023-02-14,118.75,787.05
2290,79033058,2023-01-31,,97.12
1192,79033058,2023-02-01,-167.53,-70.41
2299,79033058,2023-02-02,-117.49,-187.89999999999998
133,79033058,2023-02-04,1454.9,1267.0
8496,79033058,2023-02-09,-1504.7,-237.70000000000005
8498,79033058,2023-02-12,68.89,-168.81000000000006
5948,79033058,2023-02-13,-47.82,-216.63000000000005
2291,79036903,2023-01-31,,491.23
8671,79036903,2023-02-01,16.06,507.29
1353,79036903,2023-02-03,-45.41,461.88
770,79036903,2023-02-09,181.31,643.19
6659,79036903,2023-02-09,-119.51,523.6800000000001
7164,79036903,2023-02-10,-179.1,344.58000000000004
5294,79036903,2023-02-11,-64.21,280.37000000000006
3050,79036903,2023-02-11,-72.7,207.67000000000004
4987,79036903,2023-02-11,-137.26,70.41000000000005
4104,79036903,2023-02-13,-161.44,-91.02999999999994
3928,79036903,2023-02-14,-141.13,-232.15999999999994
2292,79069274,2023-01-31,,685.1
7614,79069274,2023-02-03,-104.0,581.1
3048,79069274,2023-02-09,-97.15,483.95000000000005
5091,79069274,2023-02-12,-103.74,380.21000000000004
5918,79069274,2023-02-13,-86.79,293.42
2293,79090076,2023-01-31,,119.25
6471,79090076,2023-02-01,130.83,250.08
4744,79090076,2023-02-02,1520.8,1770.8799999999999
2301,79090076,2023-02-02,-551.2,1219.6799999999998
7510,79090076,2023-02-03,187.7,1407.3799999999999
2060,79090076,2023-02-07,-54.35,1353.0299999999997
7870,79090076,2023-02-07,-126.32,1226.7099999999998
3905,79090076,2023-02-09,210.8,1437.5099999999998
2108,79090076,2023-02-09,-101.12,1336.3899999999999
3866,79090076,2023-02-13,-144.82,1191.57
1100,79090076,2023-02-14,174.26,1365.83
2294,79091642,2023-01-31,,961.45
4403,79091642,2023-02-02,663.6,1625.0500000000002
3962,79091642,2023-02-05,110.12,1735.17
5774,79091642,2023-02-07,133.96,1869.13
7781,79091642,2023-02-10,64.46,1933.5900000000001
3045,79091642,2023-02-10,-125.47,1808.1200000000001
2295,79118116,2023-01-31,,463.1
7489,79118116,2023-02-01,55.58,518.6800000000001
4197,79118116,2023-02-01,-105.55,413.13
6212,79118116,2023-02-02,-136.38,276.75
8018,79118116,2023-02-04,122.06,398.81000000000006
7016,79118116,2023-02-06,141.06,539.87
2227,79118116,2023-02-07,-101.44,438.43000000000006
1167,79118116,2023-02-10,97.03,535.46
2296,79147964,2023-01-31,,753.1
2917,79147964,2023-02-01,169.68,922.78
4155,79147964,2023-02-01,102.61,1025.39
5118,79147964,2023-02-01,-52.32,973.07
2515,79147964,2023-02-02,130.9,1103.97
3731,79147964,2023-02-02,-183.83,920.14
3963,79147964,2023-02-04,210.25,1130.39
2563,79147964,2023-02-05,-63.7,1066.69
2297,79163824,2023-01-31,,938.15
1528,79163824,2023-02-01,-899.8,38.35000000000002
3761,79163824,2023-02-04,-63.81,-25.45999999999998
5301,79163824,2023-02-06,125.82,100.36000000000001
4037,79163824,2023-02-06,81.68,182.04000000000002
8108,79163824,2023-02-12,111.68,293.72
5691,79163824,2023-02-14,147.24,440.96000000000004
2298,79169988,2023-01-31,,354.01
6212,79169988,2023-02-02,136.38,490.39
8328,79169988,2023-02-06,51.53,541.92
5427,79169988,2023-02-08,-31.3,510.62
4265,79169988,2023-02-08,-102.11,408.51
4914,79169988,2023-02-09,827.3,1235.81
5992,79169988,2023-02-10,212.1,1447.9099999999999
3374,79169988,2023-02-13,58.3,1506.21
1989,79169988,2023-02-13,-93.56,1412.6499999999999
2299,79181666,2023-01-31,,600.88
6150,79181666,2023-02-04,103.33,704.21
1071,79181666,2023-02-08,-138.31,565.9
7279,79181666,2023-02-09,123.84,689.74
1490,79181666,2023-02-10,66.98,756.72
7380,79181666,2023-02-11,77.77,834.49
287,79181666,2023-02-12,108.96,943.4499999999999
4336,79181666,2023-02-14,129.59,1073.04
1572,79181666,2023-02-14,-129.29,943.75
2300,79213491,2023-01-31,,308.65
264,79213491,2023-02-03,-49.16,259.49
3965,79213491,2023-02-05,-51.72,207.76999999999998
7761,79213491,2023-02-05,-216.4,-8.630000000000024
8248,79213491,2023-02-07,-11.99,-20.620000000000026
7635,79213491,2023-02-09,-37.9,-58.520000000000024
2301,79307217,2023-01-31,,307.87
4587,79307217,2023-02-02,93.31,401.18
2677,79307217,2023-02-08,26.82,428.0
5863,79307217,2023-02-09,101.37,529.37
5490,79307217,2023-02-10,79.08,608.45
1801,79307217,2023-02-13,60.19,668.64
2302,79309039,2023-01-31,,642.08
8293,79309039,2023-02-01,-96.14,545.94
4331,79309039,2023-02-03,164.94,710.8800000000001
1185,79309039,2023-02-04,124.74,835.62
8670,79309039,2023-02-06,78.77,914.3900000000001
4959,79309039,2023-02-06,-977.0,-62.6099999999999
6888,79309039,2023-02-11,-90.71,-153.31999999999988
1726,79309039,2023-02-11,-94.31,-247.62999999999988
2303,79325967,2023-01-31,,647.65
681,79325967,2023-02-04,157.32,804.97
2304,79329254,2023-01-31,,984.43
7172,79329254,2023-02-08,-83.02,901.41
6562,79329254,2023-02-10,90.32,991.7299999999999
2298,79329254,2023-02-12,1143.7,2135.43
2727,79329254,2023-02-12,164.03,2299.46
760,79329254,2023-02-12,-95.14,2204.32
2305,79355498,2023-01-31,,132.74
6826,79355498,2023-02-01,812.6,945.34
6386,79355498,2023-02-03,-119.56,825.78
1849,79355498,2023-02-05,-74.28,751.5
3094,79355498,2023-02-06,162.2,913.7
2306,79380893,2023-01-31,,163.15
8184,79380893,2023-02-01,-63.11,100.04
5094,79380893,2023-02-02,174.74,274.78000000000003
5332,79380893,2023-02-03,119.68,394.46000000000004
4919,79380893,2023-02-03,-146.88,247.58000000000004
2199,79380893,2023-02-09,196.47,444.05000000000007
550,79380893,2023-02-12,28.61,472.66
5235,79380893,2023-02-12,-122.48,350.18000000000006
8317,79380893,2023-02-12,-160.14,190.04000000000005
2307,79415620,2023-01-31,,729.51
3855,79415620,2023-02-07,104.64,834.15
7533,79415620,2023-02-08,-113.38,720.77
5005,79415620,2023-02-10,-117.79,602.98
6643,79415620,2023-02-11,6.42,609.4
5386,79415620,2023-02-14,95.3,704.7
1521,79415620,2023-02-14,-64.1,640.6
2308,79435523,2023-01-31,,920.0
7830,79435523,2023-02-03,-17.57,902.43
1373,79435523,2023-02-04,100.66,1003.09
2217,79435523,2023-02-08,-140.73,862.36
7585,79435523,2023-02-12,91.9,954.26
8324,79435523,2023-02-13,-1397.6,-443.3399999999999
2309,79499412,2023-01-31,,159.51
5837,79499412,2023-02-01,960.8,1120.31
6673,79499412,2023-02-01,527.1,1647.4099999999999
2184,79499412,2023-02-14,43.42,1690.83
2310,79566165,2023-01-31,,64.47
1073,79566165,2023-02-01,-86.03,-21.560000000000002
8566,79566165,2023-02-04,-98.42,-119.98
2329,79566165,2023-02-05,94.95,-25.03
7446,79566165,2023-02-05,94.45,69.42
2159,79566165,2023-02-08,132.45,201.87
1336,79566165,2023-02-09,18.36,220.23000000000002
800,79566165,2023-02-11,70.24,290.47
5437,79566165,2023-02-12,-140.52,149.95
2916,79566165,2023-02-14,-86.86,63.08999999999999
2311,79566627,2023-01-31,,377.62
1665,79566627,2023-02-02,-876.4,-498.78
1874,79566627,2023-02-03,-108.13,-606.91
5884,79566627,2023-02-04,122.23,-484.67999999999995
1966,79566627,2023-02-04,-105.93,-590.61
3694,79566627,2023-02-05,-17.69,-608.3
534,79566627,2023-02-07,167.72,-440.58
7195,79566627,2023-02-08,-170.5,-611.0799999999999
5194,79566627,2023-02-09,-109.28,-720.36
2360,79566627,2023-02-12,-115.11,-835.47
4928,79566627,2023-02-13,-81.86,-917.3299999999999
6633,79566627,2023-02-14,72.35,-844.98
2312,79570236,2023-01-31,,91.66
7093,79570236,2023-02-05,-158.27,-66.61000000000001
294,79570236,2023-02-07,-101.36,-167.97000000000003
6504,79570236,2023-02-08,1168.1,1000.1299999999999
2597,79570236,2023-02-11,-1000.2,-0.07000000000016371
2313,79599747,2023-01-31,,393.28
496,79599747,2023-02-02,-57.66,335.62
7918,79599747,2023-02-03,92.94,428.55999999999995
2038,79599747,2023-02-04,109.45,538.01
2306,79599747,2023-02-06,125.59,663.6
2314,79632523,2023-01-31,,867.95
7738,79632523,2023-02-04,149.33,1017.2800000000001
7270,79632523,2023-02-04,146.68,1163.96
5222,79632523,2023-02-04,95.05,1259.01
7631,79632523,2023-02-05,-129.27,1129.74
6034,79632523,2023-02-08,93.73,1223.47
8569,79632523,2023-02-12,-910.1,313.37
2315,79656112,2023-01-31,,848.18
681,79656112,2023-02-04,-157.32,690.8599999999999
8286,79656112,2023-02-04,-199.41,491.44999999999993
2316,79656355,2023-01-31,,766.41
1291,79656355,2023-02-01,1820.3,2586.71
1586,79656355,2023-02-02,186.07,2772.7799999999997
8376,79656355,2023-02-05,-85.62,2687.16
7147,79656355,2023-02-07,68.86,2756.02
2348,79656355,2023-02-08,-115.99,2640.0299999999997
2647,79656355,2023-02-09,-49.28,2590.75
4014,79656355,2023-02-10,-165.02,2425.7299999999996
8082,79656355,2023-02-11,-57.3,2368.43
5470,79656355,2023-02-13,94.19,2462.62
7288,79656355,2023-02-14,666.1,3128.72
4583,79656355,2023-02-14,-150.19,2978.5299999999997
2317,79757019,2023-01-31,,369.26
7538,79757019,2023-02-01,-116.57,252.69
154,79757019,2023-02-04,-116.65,136.04
6493,79757019,2023-02-05,51.76,187.79999999999998
3526,79757019,2023-02-07,74.11,261.90999999999997
2483,79757019,2023-02-13,-93.14,168.76999999999998
2318,79771974,2023-01-31,,350.67
1004,79771974,2023-02-03,613.0,963.6700000000001
814,79771974,2023-02-04,159.42,1123.0900000000001
3755,79771974,2023-02-04,-104.45,1018.6400000000001
7734,79771974,2023-02-07,-98.57,920.07
6954,79771974,2023-02-09,67.76,987.83
3494,79771974,2023-02-14,-43.95,943.8800000000001
2319,79792810,2023-01-31,,505.57
2021,79792810,2023-02-02,-308.77,196.8
5182,79792810,2023-02-11,-75.1,121.70000000000002
1753,79792810,2023-02-12,98.23,219.93
5168,79792810,2023-02-12,-142.78,77.15000000000003
2320,79933337,2023-01-31,,508.79
4906,79933337,2023-02-01,84.25,593.04
2238,79933337,2023-02-02,-78.21,514.83
1370,79933337,2023-02-03,1253.8,1768.63
3523,79933337,2023-02-04,113.62,1882.25
3653,79933337,2023-02-09,-125.98,1756.27
6044,79933337,2023-02-12,-123.95,1632.32
2321,80001684,2023-01-31,,572.24
221,80001684,2023-02-05,41.33,613.57
163,80001684,2023-02-05,-539.8,73.7700000000001
2322,80005822,2023-01-31,,930.08
7648,80005822,2023-02-05,160.23,1090.31
6631,80005822,2023-02-10,90.04,1180.3500000000001
349,80005822,2023-02-10,-119.92,1060.43
174,80005822,2023-02-12,61.43,1121.8600000000001
7103,80005822,2023-02-14,756.9,1878.76
2323,80015485,2023-01-31,,310.56
4946,80015485,2023-02-05,-56.51,254.05
3099,80015485,2023-02-10,-92.86,161.19
7386,80015485,2023-02-14,153.23,314.41999999999996
2324,80040176,2023-01-31,,533.74
4429,80040176,2023-02-03,137.98,671.72
4306,80040176,2023-02-03,-94.07,577.65
8514,80040176,2023-02-07,-21.02,556.63
5914,80040176,2023-02-07,-156.4,400.23
3456,80040176,2023-02-08,110.48,510.71
4692,80040176,2023-02-11,-245.04,265.67
1801,80040176,2023-02-13,-60.19,205.48000000000002
2325,80046304,2023-01-31,,951.74
1364,80046304,2023-02-03,99.68,1051.42
2887,80046304,2023-02-03,-70.99,980.4300000000001
231,80046304,2023-02-04,53.03,1033.46
258,80046304,2023-02-04,-167.73,865.73
7254,80046304,2023-02-05,190.01,1055.74
2816,80046304,2023-02-06,-109.48,946.26
6075,80046304,2023-02-13,120.16,1066.42
4281,80046304,2023-02-14,36.6,1103.02
2326,80135904,2023-01-31,,120.34
1233,80135904,2023-02-03,993.7,1114.04
4655,80135904,2023-02-05,-92.28,1021.7600000000001
6780,80135904,2023-02-07,-86.83,934.9300000000001
6359,80135904,2023-02-08,119.48,1054.41
4284,80135904,2023-02-13,375.1,1429.5100000000002
2327,80168427,2023-01-31,,19.01
7170,80168427,2023-02-01,-81.22,-62.209999999999994
2674,80168427,2023-02-01,-181.06,-243.26999999999998
4689,80168427,2023-02-03,75.28,-167.98999999999998
2410,80168427,2023-02-04,-138.34,-306.33
6276,80168427,2023-02-06,102.2,-204.13
2328,80184223,2023-01-31,,52.59
5035,80184223,2023-02-07,-153.24,-100.65
1532,80184223,2023-02-10,195.79,95.13999999999999
1992,80184223,2023-02-12,95.71,190.84999999999997
6614,80184223,2023-02-12,-13.57,177.27999999999997
2329,80244844,2023-01-31,,774.54
7187,80244844,2023-02-01,-90.07,684.47
1854,80244844,2023-02-04,128.19,812.66
5170,80244844,2023-02-04,-115.56,697.0999999999999
1187,80244844,2023-02-04,-199.36,497.73999999999995
2595,80244844,2023-02-08,140.07,637.81
2222,80244844,2023-02-08,-149.73,488.0799999999999
3196,80244844,2023-02-09,136.3,624.38
6931,80244844,2023-02-11,139.56,763.9399999999999
8365,80244844,2023-02-11,40.81,804.75
2479,80244844,2023-02-14,51.9,856.65
2330,80283776,2023-01-31,,334.03
8602,80283776,2023-02-02,83.88,417.90999999999997
4050,80283776,2023-02-02,-148.09,269.81999999999994
4548,80283776,2023-02-06,-22.17,247.64999999999998
6996,80283776,2023-02-07,-121.67,125.97999999999996
6512,80283776,2023-02-08,92.84,218.81999999999996
6472,80283776,2023-02-08,-123.29,95.52999999999996
3368,80283776,2023-02-13,-40.02,55.509999999999955
2331,80291188,2023-01-31,,338.65
5187,80291188,2023-02-01,70.27,408.91999999999996
1571,80291188,2023-02-05,-124.52,284.4
5982,80291188,2023-02-07,38.29,322.69
171,80291188,2023-02-08,23.79,346.47999999999996
6073,80291188,2023-02-11,-71.24,275.24
7639,80291188,2023-02-11,-75.48,199.76
1023,80291188,2023-02-12,-75.56,124.19999999999997
1346,80291188,2023-02-13,111.96,236.15999999999997
2332,80304720,2023-01-31,,614.87
6708,80304720,2023-02-01,170.25,785.12
8650,80304720,2023-02-05,-68.75,716.37
2333,80325529,2023-01-31,,996.6
3131,80325529,2023-02-03,44.0,1040.6
5510,80325529,2023-02-03,-125.34,915.26
7143,80325529,2023-02-05,145.13,1060.39
1899,80325529,2023-02-05,-196.0,864.39
6025,80325529,2023-02-11,590.6,1454.99
98,80325529,2023-02-13,71.7,1526.69
2334,80355773,2023-01-31,,906.28
7160,80355773,2023-02-01,-37.94,868.3399999999999
5130,80355773,2023-02-03,122.53,990.87
249,80355773,2023-02-03,-5.38,985.49
5038,80355773,2023-02-05,-122.18,863.31
4435,80355773,2023-02-09,-82.14,781.17
6914,80355773,2023-02-13,56.91,838.0799999999999
1768,80355773,2023-02-14,-553.6,284.4799999999999
2335,80360244,2023-01-31,,658.35
129,80360244,2023-02-03,-134.13,524.22
222,80360244,2023-02-05,-83.59,440.63
4037,80360244,2023-02-06,-81.68,358.95000000000005
135,80360244,2023-02-06,-1947.3,-1588.35
1032,80360244,2023-02-07,14.81,-1573.54
2382,80360244,2023-02-09,76.61,-1496.9299999999998
2671,80360244,2023-02-10,-11.31,-1508.24
2336,80379245,2023-01-31,,793.17
7572,80379245,2023-02-01,-56.06,737.1099999999999
4635,80379245,2023-02-03,146.59,883.6999999999999
5693,80379245,2023-02-06,61.92,945.62
2646,80379245,2023-02-06,-1.58,944.04
6149,80379245,2023-02-07,106.24,1050.28
702,80379245,2023-02-08,-85.29,964.99
2171,80379245,2023-02-09,-40.77,924.2199999999999
8497,80379245,2023-02-13,107.98,1032.2
2337,80391084,2023-01-31,,466.35
8355,80391084,2023-02-03,-584.3,-117.94999999999993
6500,80391084,2023-02-06,28.34,-89.60999999999993
4175,80391084,2023-02-07,-122.13,-211.73999999999992
2504,80391084,2023-02-14,-116.9,-328.63999999999993
2338,80428983,2023-01-31,,323.32
1234,80428983,2023-02-02,-53.59,269.73
8410,80428983,2023-02-04,158.41,428.14
5121,80428983,2023-02-09,87.99,516.13
6501,80428983,2023-02-11,-58.01,458.12
3600,80428983,2023-02-12,-564.4,-106.27999999999997
5076,80428983,2023-02-13,-68.69,-174.96999999999997
1205,80428983,2023-02-13,-177.52,-352.49
6167,80428983,2023-02-14,-60.97,-413.46
2339,80439799,2023-01-31,,968.23
1541,80439799,2023-02-05,49.95,1018.1800000000001
4619,80439799,2023-02-11,62.33,1080.51
4359,80439799,2023-02-11,-156.49,924.02
5688,80439799,2023-02-14,-90.74,833.28
2340,80464084,2023-01-31,,12.73
8206,80464084,2023-02-02,145.27,158.0
1344,80464084,2023-02-03,-32.08,125.92
3909,80464084,2023-02-04,-189.06,-63.14
8595,80464084,2023-02-05,80.67,17.53
1868,80464084,2023-02-06,-70.94,-53.41
3442,80464084,2023-02-06,-213.44,-266.85
2341,80504934,2023-01-31,,759.22
8049,80504934,2023-02-04,-74.95,684.27
94,80504934,2023-02-06,165.65,849.9200000000001
3324,80504934,2023-02-11,-160.29,689.63
8430,80504934,2023-02-14,114.98,804.61
2342,80596699,2023-01-31,,47.06
2093,80596699,2023-02-01,130.93,177.99
6170,80596699,2023-02-01,123.08,301.07
8124,80596699,2023-02-03,168.33,469.40000000000003
6484,80596699,2023-02-03,91.37,560.77
4301,80596699,2023-02-04,58.03,618.8000000000001
5317,80596699,2023-02-06,85.9,704.7
560,80596699,2023-02-06,-35.38,669.32
5254,80596699,2023-02-07,48.65,717.97
6542,80596699,2023-02-13,-26.24,691.73
2343,80610910,2023-01-31,,139.54
2322,80610910,2023-02-02,-143.95,-4.409999999999997
988,80610910,2023-02-05,164.35,159.94
4027,80610910,2023-02-06,-1032.3,-872.3599999999999
4743,80610910,2023-02-07,214.17,-658.1899999999999
2344,80678427,2023-01-31,,97.72
6711,80678427,2023-02-01,102.9,200.62
3716,80678427,2023-02-01,53.43,254.05
3270,80678427,2023-02-04,-87.1,166.95000000000002
4302,80678427,2023-02-05,142.28,309.23
1229,80678427,2023-02-08,-136.73,172.50000000000003
6746,80678427,2023-02-08,-144.26,28.240000000000038
2850,80678427,2023-02-08,-1051.4,-1023.1600000000001
3450,80678427,2023-02-12,106.86,-916.3000000000001
6686,80678427,2023-02-12,-140.79,-1057.0900000000001
2263,80678427,2023-02-13,136.9,-920.19
2345,80678577,2023-01-31,,288.61
2109,80678577,2023-02-04,94.62,383.23
3316,80678577,2023-02-11,163.65,546.88
3863,80678577,2023-02-13,75.02,621.9
2346,80709302,2023-01-31,,280.92
6486,80709302,2023-02-05,144.79,425.71000000000004
8192,80709302,2023-02-11,2044.6,2470.31
2347,80747298,2023-01-31,,768.33
4069,80747298,2023-02-09,119.77,888.1
7432,80747298,2023-02-13,138.24,1026.3400000000001
2348,80758476,2023-01-31,,977.44
2117,80758476,2023-02-06,91.53,1068.97
8407,80758476,2023-02-07,-5.07,1063.9
4633,80758476,2023-02-11,171.55,1235.45
2349,80761210,2023-01-31,,545.59
7938,80761210,2023-02-01,-143.85,401.74
3434,80761210,2023-02-04,173.75,575.49
2405,80761210,2023-02-04,-160.27,415.22
2505,80761210,2023-02-07,-105.09,310.13
4659,80761210,2023-02-08,73.68,383.81000000000006
4713,80761210,2023-02-10,113.99,497.8
2350,80778066,2023-01-31,,217.49
7489,80778066,2023-02-01,-55.58,161.91000000000003
1680,80778066,2023-02-03,149.87,311.78000000000003
1340,80778066,2023-02-03,36.57,348.35
3700,80778066,2023-02-07,56.13,404.48
8564,80778066,2023-02-08,-2.72,401.76000000000005
2351,80787776,2023-01-31,,460.46
547,80787776,2023-02-01,142.26,602.72
2064,80787776,2023-02-03,72.41,675.13
6773,80787776,2023-02-03,-22.26,652.87
4252,80787776,2023-02-05,-102.9,549.9699999999999
7638,80787776,2023-02-05,-1295.5,-745.5300000000001
5571,80787776,2023-02-10,-112.36,-857.8900000000001
3607,80787776,2023-02-11,-172.5,-1030.39
3407,80787776,2023-02-14,150.42,-879.9700000000001
2352,80808205,2023-01-31,,280.92
18,80808205,2023-02-01,-88.1,192.82000000000002
6348,80808205,2023-02-02,-1082.7,-889.88
7127,80808205,2023-02-02,-1698.0,-2587.88
3633,80808205,2023-02-03,133.1,-2454.78
661,80808205,2023-02-05,73.78,-2381.0
6890,80808205,2023-02-06,-59.6,-2440.6
4174,80808205,2023-02-11,-193.89,-2634.4900000000002
6814,80808205,2023-02-13,214.61,-2419.88
3445,80808205,2023-02-13,-1017.6,-3437.48
2353,80811957,2023-01-31,,139.95
3756,80811957,2023-02-05,85.92,225.87
995,80811957,2023-02-07,-112.22,113.64999999999999
4253,80811957,2023-02-13,40.65,154.29999999999998
2354,80812213,2023-01-31,,277.14
2518,80812213,2023-02-07,-81.75,195.39
405,80812213,2023-02-07,-103.35,92.03999999999999
1739,80812213,2023-02-08,-67.93,24.109999999999985
2355,80818151,2023-01-31,,320.64
1876,80818151,2023-02-01,75.36,396.0
4180,80818151,2023-02-02,-10.1,385.9
1058,80818151,2023-02-06,436.1,822.0
2356,80877479,2023-01-31,,210.98
8129,80877479,2023-02-03,101.25,312.23
2126,80877479,2023-02-05,-112.01,200.21999999999997
7477,80877479,2023-02-06,-84.1,116.11999999999999
4096,80877479,2023-02-06,-1457.8,-1341.68
1427,80877479,2023-02-07,66.67,-1275.01
3788,80877479,2023-02-09,203.24,-1071.77
2357,80884901,2023-01-31,,453.71
8050,80884901,2023-02-05,-179.02,274.68999999999994
8107,80884901,2023-02-06,-59.73,214.95999999999998
8483,80884901,2023-02-07,-85.23,129.72999999999996
4046,80884901,2023-02-09,-128.31,1.419999999999959
8582,80884901,2023-02-11,34.89,36.30999999999996
4703,80884901,2023-02-14,61.16,97.46999999999996
2358,80889919,2023-01-31,,298.45
3198,80889919,2023-02-06,-20.39,278.06
1559,80889919,2023-02-08,130.71,408.77
2359,80938878,2023-01-31,,29.73
4668,80938878,2023-02-02,24.23,53.96
31,80938878,2023-02-08,-70.5,-16.54
7826,80938878,2023-02-12,151.29,134.75
2360,80939694,2023-01-31,,923.76
1159,80939694,2023-02-04,861.1,1784.8600000000001
997,80939694,2023-02-05,102.47,1887.33
7864,80939694,2023-02-08,66.57,1953.9
3464,80939694,2023-02-08,-79.57,1874.33
848,80939694,2023-02-13,-64.31,1810.02
2361,80940019,2023-01-31,,957.41
2021,80940019,2023-02-02,308.77,1266.1799999999998
1705,80940019,2023-02-03,-612.6,653.5799999999999
2908,80940019,2023-02-07,-301.0,352.5799999999999
2818,80940019,2023-02-11,152.11,504.68999999999994
2362,81049128,2023-01-31,,694.91
3262,81049128,2023-02-06,113.47,808.38
3289,81049128,2023-02-09,-1727.8,-919.42
4125,81049128,2023-02-10,-191.56,-1110.98
3232,81049128,2023-02-11,74.61,-1036.37
2363,81075588,2023-01-31,,297.73
504,81075588,2023-02-01,99.3,397.03000000000003
1287,81075588,2023-02-01,93.43,490.46000000000004
1099,81075588,2023-02-06,100.09,590.5500000000001
3157,81075588,2023-02-08,143.85,734.4000000000001
3158,81075588,2023-02-08,117.07,851.47
8479,81075588,2023-02-09,128.74,980.21
6224,81075588,2023-02-09,-123.35,856.86
111,81075588,2023-02-10,-167.51,689.35
1817,81075588,2023-02-10,-169.0,520.35
2341,81075588,2023-02-11,-96.34,424.01000000000005
6798,81075588,2023-02-11,-152.76,271.25000000000006
2364,81087182,2023-01-31,,861.31
4508,81087182,2023-02-04,-107.78,753.53
7085,81087182,2023-02-05,-142.19,611.3399999999999
598,81087182,2023-02-06,-136.6,474.73999999999995
5306,81087182,2023-02-09,-165.96,308.78
65,81087182,2023-02-14,153.66,462.43999999999994
2365,81099534,2023-01-31,,216.8
3617,81099534,2023-02-01,-99.68,117.12
2548,81099534,2023-02-04,138.04,255.16
6282,81099534,2023-02-11,68.14,323.3
3502,81099534,2023-02-14,-117.23,206.07
2366,81145048,2023-01-31,,290.02
7990,81145048,2023-02-02,-115.05,174.96999999999997
3646,81145048,2023-02-03,-131.54,43.43000000000001
1039,81145048,2023-02-05,859.9,903.3299999999999
864,81145048,2023-02-06,51.78,955.11
960,81145048,2023-02-09,-898.2,56.90999999999997
4620,81145048,2023-02-12,-99.41,-42.50000000000003
7975,81145048,2023-02-12,-170.71,-213.21000000000004
2367,81159651,2023-01-31,,466.71
5420,81159651,2023-02-02,-44.56,422.15
7791,81159651,2023-02-05,126.51,548.66
41,81159651,2023-02-07,55.28,603.9399999999999
8297,81159651,2023-02-08,-132.1,471.84
5535,81159651,2023-02-09,-67.99,403.84999999999997
7235,81159651,2023-02-12,-109.6,294.25
157,81159651,2023-02-13,437.5,731.75
5084,81159651,2023-02-14,-42.19,689.56
2368,81181209,2023-01-31,,828.91
4149,81181209,2023-02-02,-58.23,770.68
5973,81181209,2023-02-09,181.77,952.45
8669,81181209,2023-02-09,118.7,1071.15
4883,81181209,2023-02-09,7.44,1078.59
3652,81181209,2023-02-10,1210.3,2288.89
3826,81181209,2023-02-11,-104.35,2184.54
2369,81191580,2023-01-31,,584.56
3420,81191580,2023-02-06,-14.55,570.01
5247,81191580,2023-02-10,-145.53,424.4799999999999
788,81191580,2023-02-12,143.1,567.5799999999999
7358,81191580,2023-02-12,76.93,644.51
286,81191580,2023-02-14,-135.36,509.1499999999999
2370,81200849,2023-01-31,,479.29
5825,81200849,2023-02-03,132.53,611.82
3912,81200849,2023-02-06,63.33,675.15
1701,81200849,2023-02-06,-99.31,575.84
6000,81200849,2023-02-07,-76.35,499.49
7467,81200849,2023-02-08,9.98,509.47
7465,81200849,2023-02-11,18.39,527.86
6650,81200849,2023-02-12,-165.42,362.44000000000005
2371,81206535,2023-01-31,,452.69
5075,81206535,2023-02-05,117.78,570.47
2469,81206535,2023-02-05,84.4,654.87
458,81206535,2023-02-05,29.75,684.62
290,81206535,2023-02-08,42.59,727.21
3203,81206535,2023-02-09,-22.93,704.28
6253,81206535,2023-02-10,190.89,895.17
431,81206535,2023-02-13,47.54,942.71
188,81206535,2023-02-14,-836.0,106.71000000000004
2372,81227009,2023-01-31,,475.45
6482,81227009,2023-02-01,95.83,571.28
8580,81227009,2023-02-01,-33.49,537.79
2797,81227009,2023-02-03,90.64,628.43
966,81227009,2023-02-03,-59.28,569.15
7032,81227009,2023-02-07,91.92,661.0699999999999
442,81227009,2023-02-10,144.33,805.4
7007,81227009,2023-02-11,75.12,880.52
2817,81227009,2023-02-11,-39.39,841.13
8280,81227009,2023-02-12,541.9,1383.03
7260,81227009,2023-02-12,144.19,1527.22
6595,81227009,2023-02-13,-136.4,1390.82
8415,81227009,2023-02-14,50.66,1441.48
4142,81227009,2023-02-14,-111.15,1330.33
2373,81245588,2023-01-31,,775.87
3756,81245588,2023-02-05,-85.92,689.95
2006,81245588,2023-02-10,83.51,773.46
8423,81245588,2023-02-10,-120.39,653.07
7031,81245588,2023-02-13,69.73,722.8
7637,81245588,2023-02-14,136.73,859.53
2374,81267006,2023-01-31,,425.16
5776,81267006,2023-02-02,168.67,593.83
7924,81267006,2023-02-03,-69.26,524.57
2346,81267006,2023-02-05,107.8,632.37
6836,81267006,2023-02-10,1430.6,2062.97
4843,81267006,2023-02-10,-135.89,1927.08
2375,81336389,2023-01-31,,210.06
3475,81336389,2023-02-01,119.5,329.56
4303,81336389,2023-02-03,77.36,406.92
1335,81336389,2023-02-03,-188.47,218.45
8239,81336389,2023-02-05,-106.54,111.90999999999998
6201,81336389,2023-02-06,-109.52,2.3899999999999864
2146,81336389,2023-02-09,83.99,86.37999999999998
6328,81336389,2023-02-10,-216.08,-129.70000000000005
6569,81336389,2023-02-13,99.54,-30.16000000000001
8333,81336389,2023-02-13,-149.91,-180.07
2376,81336468,2023-01-31,,935.41
3933,81336468,2023-02-02,807.9,1743.31
1036,81336468,2023-02-02,779.9,2523.21
4403,81336468,2023-02-02,-663.6,1859.61
3732,81336468,2023-02-02,-1327.5,532.1099999999999
2461,81336468,2023-02-05,37.98,570.0899999999999
731,81336468,2023-02-06,75.77,645.8599999999999
5337,81336468,2023-02-07,127.56,773.4199999999998
1693,81336468,2023-02-09,154.98,928.3999999999999
261,81336468,2023-02-09,146.02,1074.4199999999998
2377,81337623,2023-01-31,,815.36
6005,81337623,2023-02-04,-185.63,629.73
6902,81337623,2023-02-07,183.44,813.1700000000001
7630,81337623,2023-02-10,167.13,980.3
4117,81337623,2023-02-10,101.56,1081.8600000000001
6256,81337623,2023-02-12,-26.35,1055.51
5650,81337623,2023-02-14,69.51,1125.02
2378,81340143,2023-01-31,,647.34
310,81340143,2023-02-05,103.36,750.7
6441,81340143,2023-02-09,-682.6,68.10000000000002
7574,81340143,2023-02-11,-47.38,20.72000000000002
2379,81384411,2023-01-31,,175.86
3417,81384411,2023-02-03,174.31,350.17
7401,81384411,2023-02-04,-1361.0,-1010.8299999999999
4257,81384411,2023-02-10,-63.87,-1074.6999999999998
5690,81384411,2023-02-11,67.21,-1007.4899999999999
1697,81384411,2023-02-11,-205.44,-1212.9299999999998
6390,81384411,2023-02-12,-114.27,-1327.1999999999998
2380,81398388,2023-01-31,,979.87
1681,81398388,2023-02-02,120.93,1100.8
1828,81398388,2023-02-02,15.93,1116.73
7174,81398388,2023-02-09,-115.5,1001.23
4892,81398388,2023-02-10,-97.88,903.35
3371,81398388,2023-02-13,-43.87,859.48
2381,81445756,2023-01-31,,267.66
1370,81445756,2023-02-03,-1253.8,-986.1399999999999
969,81445756,2023-02-04,-110.0,-1096.1399999999999
2382,81475774,2023-01-31,,568.11
5139,81475774,2023-02-03,-156.2,411.91
3578,81475774,2023-02-04,1059.1,1471.01
3472,81475774,2023-02-04,89.97,1560.98
4274,81475774,2023-02-07,118.92,1679.9
8563,81475774,2023-02-10,-58.79,1621.11
1815,81475774,2023-02-12,-196.98,1424.13
7249,81475774,2023-02-13,-66.54,1357.59
2383,81527490,2023-01-31,,234.05
4155,81527490,2023-02-01,-102.61,131.44
4440,81527490,2023-02-02,108.67,240.11
7646,81527490,2023-02-05,135.59,375.70000000000005
2114,81527490,2023-02-06,1.14,376.84000000000003
6975,81527490,2023-02-07,69.94,446.78000000000003
6856,81527490,2023-02-07,-17.58,429.20000000000005
5973,81527490,2023-02-09,-181.77,247.43
545,81527490,2023-02-09,-254.92,-7.489999999999981
2123,81527490,2023-02-12,174.92,167.43
5315,81527490,2023-02-13,100.05,267.48
4193,81527490,2023-02-13,-115.44,152.04000000000002
2384,81561788,2023-01-31,,454.89
6362,81561788,2023-02-02,-1106.9,-652.0100000000001
8428,81561788,2023-02-05,821.8,169.78999999999985
7446,81561788,2023-02-05,-94.45,75.33999999999985
3217,81561788,2023-02-06,48.45,123.78999999999985
4658,81561788,2023-02-07,96.93,220.71999999999986
651,81561788,2023-02-08,85.01,305.72999999999985
7953,81561788,2023-02-09,-109.32,196.40999999999985
6452,81561788,2023-02-11,1777.8,1974.2099999999998
4700,81561788,2023-02-11,121.33,2095.54
2385,81590655,2023-01-31,,742.17
6968,81590655,2023-02-04,54.34,796.51
5546,81590655,2023-02-05,103.0,899.51
6009,81590655,2023-02-09,-54.35,845.16
2854,81590655,2023-02-10,712.2,1557.3600000000001
2386,81646873,2023-01-31,,188.36
3820,81646873,2023-02-02,-95.2,93.16000000000001
1669,81646873,2023-02-03,-62.59,30.570000000000007
1350,81646873,2023-02-04,78.93,109.50000000000001
1289,81646873,2023-02-06,89.63,199.13
6228,81646873,2023-02-07,81.96,281.09000000000003
6365,81646873,2023-02-09,10.45,291.54
2943,81646873,2023-02-09,-161.02,130.51999999999998
334,81646873,2023-02-10,679.8,810.3199999999999
1689,81646873,2023-02-13,-100.5,709.8199999999999
2387,81651344,2023-01-31,,219.55
8568,81651344,2023-02-06,155.37,374.92
1675,81651344,2023-02-08,-92.38,282.54
5303,81651344,2023-02-09,-78.16,204.38000000000002
2388,81655495,2023-01-31,,315.33
235,81655495,2023-02-01,-1139.7,-824.3700000000001
8396,81655495,2023-02-02,-1091.2,-1915.5700000000002
5637,81655495,2023-02-03,89.14,-1826.43
4527,81655495,2023-02-06,191.25,-1635.1800000000003
652,81655495,2023-02-14,-81.21,-1716.39
2389,81662619,2023-01-31,,712.33
4017,81662619,2023-02-01,-137.9,574.4300000000001
8370,81662619,2023-02-06,82.51,656.94
3868,81662619,2023-02-07,152.96,809.9000000000001
8147,81662619,2023-02-10,-34.99,774.9100000000001
8040,81662619,2023-02-12,-109.89,665.02
2565,81662619,2023-02-14,141.21,806.23
2390,81727860,2023-01-31,,192.44
1809,81727860,2023-02-05,-99.25,93.19
6121,81727860,2023-02-08,76.65,169.84
5912,81727860,2023-02-09,-193.78,-23.939999999999998
2391,81740267,2023-01-31,,67.86
6596,81740267,2023-02-02,110.38,178.24
6921,81740267,2023-02-06,81.53,259.77
565,81740267,2023-02-06,-110.09,149.68
2392,81823420,2023-01-31,,259.73
2956,81823420,2023-02-01,102.1,361.83000000000004
6118,81823420,2023-02-04,201.15,562.98
2871,81823420,2023-02-06,-49.47,513.51
2577,81823420,2023-02-10,8.29,521.8000000000001
6358,81823420,2023-02-11,38.25,560.0500000000001
2393,81855175,2023-01-31,,907.59
2860,81855175,2023-02-01,-42.34,865.25
4184,81855175,2023-02-01,-49.37,815.88
2966,81855175,2023-02-02,75.11,890.99
2176,81855175,2023-02-03,102.49,993.48
3478,81855175,2023-02-09,-892.4,101.08000000000004
360,81855175,2023-02-10,-90.2,10.880000000000038
8475,81855175,2023-02-12,-1801.4,-1790.52
4777,81855175,2023-02-14,-32.96,-1823.48
2394,81923993,2023-01-31,,686.37
5469,81923993,2023-02-05,-637.3,49.07000000000005
619,81923993,2023-02-10,27.72,76.79000000000005
4394,81923993,2023-02-11,142.72,219.51000000000005
8567,81923993,2023-02-11,130.08,349.59000000000003
3051,81923993,2023-02-12,-181.41,168.18000000000006
4153,81923993,2023-02-14,541.0,709.1800000000001
2395,81932657,2023-01-31,,146.81
7317,81932657,2023-02-01,80.7,227.51
7014,81932657,2023-02-01,58.0,285.51
6515,81932657,2023-02-08,1044.7,1330.21
7671,81932657,2023-02-09,-4.61,1325.6000000000001
8469,81932657,2023-02-12,-79.12,1246.48
2396,81994568,2023-01-31,,578.86
4460,81994568,2023-02-03,47.78,626.64
7911,81994568,2023-02-03,-20.43,606.21
795,81994568,2023-02-04,1510.5,2116.71
7400,81994568,2023-02-06,58.84,2175.55
1587,81994568,2023-02-10,1463.6,3639.1499999999996
3612,81994568,2023-02-10,30.61,3669.7599999999998
474,81994568,2023-02-10,-75.99,3593.77
2397,82002852,2023-01-31,,816.53
6729,82002852,2023-02-04,148.35,964.88
6786,82002852,2023-02-06,-49.21,915.67
5634,82002852,2023-02-09,-61.13,854.54
7514,82002852,2023-02-12,-119.03,735.51
2398,82023979,2023-01-31,,744.37
23,82023979,2023-02-02,-1019.5,-275.13
2277,82023979,2023-02-03,104.62,-170.51
5403,82023979,2023-02-10,-107.4,-277.90999999999997
2399,82027257,2023-01-31,,681.1
5983,82027257,2023-02-02,129.77,810.87
2110,82027257,2023-02-07,-118.19,692.6800000000001
5009,82027257,2023-02-11,147.54,840.22
2495,82027257,2023-02-11,122.19,962.4100000000001
5824,82027257,2023-02-11,-184.66,777.75
4443,82027257,2023-02-12,-154.82,622.9300000000001
6872,82027257,2023-02-13,88.79,711.72
1600,82027257,2023-02-13,-74.3,637.4200000000001
2400,82043720,2023-01-31,,803.68
2076,82043720,2023-02-01,52.9,856.5799999999999
1407,82043720,2023-02-04,-118.34,738.24
912,82043720,2023-02-08,119.51,857.75
8464,82043720,2023-02-10,-62.15,795.5999999999999
1395,82043720,2023-02-12,96.27,891.8699999999999
2401,82101740,2023-01-31,,469.34
6214,82101740,2023-02-01,-72.19,397.15
4079,82101740,2023-02-02,68.21,465.35999999999996
1940,82101740,2023-02-11,30.14,495.5
3064,82101740,2023-02-12,-153.41,342.09
6976,82101740,2023-02-13,-43.53,298.55999999999995
2402,82115900,2023-01-31,,446.89
6728,82115900,2023-02-14,1308.6,1755.4899999999998
2403,82177278,2023-01-31,,236.32
3871,82177278,2023-02-02,924.0,1160.32
7094,82177278,2023-02-02,-123.02,1037.3
6876,82177278,2023-02-08,-105.67,931.6299999999999
5124,82177278,2023-02-09,95.76,1027.3899999999999
6790,82177278,2023-02-10,75.98,1103.37
3082,82177278,2023-02-11,-64.7,1038.6699999999998
3874,82177278,2023-02-12,-130.79,907.8799999999999
5551,82177278,2023-02-13,-123.69,784.1899999999999
6070,82177278,2023-02-14,191.52,975.7099999999999
2404,82188502,2023-01-31,,788.02
3409,82188502,2023-02-01,66.19,854.21
1524,82188502,2023-02-01,-96.2,758.01
8216,82188502,2023-02-02,109.3,867.31
1353,82188502,2023-02-03,45.41,912.72
4772,82188502,2023-02-09,-109.88,802.8399999999999
2275,82188502,2023-02-09,-127.38,675.46
8073,82188502,2023-02-10,110.41,785.87
1292,82188502,2023-02-10,-73.39,712.48
2405,82233451,2023-01-31,,795.71
7375,82233451,2023-02-01,97.37,893.08
270,82233451,2023-02-05,-167.85,725.23
1635,82233451,2023-02-13,155.44,880.6700000000001
2406,82259327,2023-01-31,,982.72
5728,82259327,2023-02-03,-134.35,848.37
4863,82259327,2023-02-04,-944.5,-96.13
5588,82259327,2023-02-05,1463.6,1367.4699999999998
456,82259327,2023-02-07,112.11,1479.5799999999997
2189,82259327,2023-02-07,46.81,1526.3899999999999
6449,82259327,2023-02-09,107.63,1634.0199999999998
4032,82259327,2023-02-10,-94.84,1539.1799999999998
2407,82263080,2023-01-31,,928.54
3353,82263080,2023-02-03,-180.52,748.02
5773,82263080,2023-02-04,98.52,846.54
2112,82263080,2023-02-11,782.2,1628.74
759,82263080,2023-02-12,133.67,1762.41
1042,82263080,2023-02-13,-59.69,1702.72
2408,82283956,2023-01-31,,745.72
1059,82283956,2023-02-01,-158.92,586.8000000000001
1210,82283956,2023-02-02,58.23,645.0300000000001
6541,82283956,2023-02-03,-349.6,295.43
2409,82303710,2023-01-31,,619.98
1439,82303710,2023-02-03,102.85,722.83
5065,82303710,2023-02-10,112.61,835.44
2653,82303710,2023-02-14,208.0,1043.44
1647,82303710,2023-02-14,-91.7,951.74
4226,82303710,2023-02-14,-1674.0,-722.26
2410,82314789,2023-01-31,,735.77
2857,82314789,2023-02-01,53.09,788.86
8433,82314789,2023-02-04,-87.35,701.51
1298,82314789,2023-02-06,155.01,856.52
6783,82314789,2023-02-09,-1340.1,-483.5799999999999
4544,82314789,2023-02-13,-75.81,-559.3899999999999
2411,82424659,2023-01-31,,568.77
8256,82424659,2023-02-02,56.94,625.71
8434,82424659,2023-02-05,-186.17,439.53999999999996
3205,82424659,2023-02-09,140.61,580.15
6766,82424659,2023-02-09,-87.15,493.0
3674,82424659,2023-02-12,151.48,644.48
2285,82424659,2023-02-13,21.73,666.21
2412,82461559,2023-01-31,,652.26
1197,82461559,2023-02-03,-98.38,553.88
1469,82461559,2023-02-07,117.08,670.96
1469,82461559,2023-02-07,-117.08,553.88
4446,82461559,2023-02-08,85.07,638.95
1224,82461559,2023-02-09,-6.95,632.0
6040,82461559,2023-02-12,37.14,669.14
4911,82461559,2023-02-13,-167.76,501.38
2100,82461559,2023-02-14,-118.75,382.63
2413,82543932,2023-01-31,,279.1
77,82543932,2023-02-03,-104.78,174.32000000000002
1847,82543932,2023-02-05,170.9,345.22
1253,82543932,2023-02-05,-167.18,178.04000000000002
5115,82543932,2023-02-10,-98.45,79.59000000000002
5525,82543932,2023-02-12,-187.21,-107.61999999999999
2414,82558079,2023-01-31,,381.22
502,82558079,2023-02-02,106.05,487.27000000000004
69,82558079,2023-02-07,-65.45,421.82000000000005
8618,82558079,2023-02-12,26.9,448.72
6545,82558079,2023-02-13,-54.59,394.13
7902,82558079,2023-02-13,-77.1,317.03000000000003
2415,82568859,2023-01-31,,32.21
7702,82568859,2023-02-03,432.2,464.40999999999997
2891,82568859,2023-02-03,37.0,501.40999999999997
8406,82568859,2023-02-05,87.66,589.0699999999999
8325,82568859,2023-02-06,-102.1,486.96999999999997
5931,82568859,2023-02-10,110.62,597.5899999999999
2416,82589836,2023-01-31,,648.06
1306,82589836,2023-02-02,-39.13,608.93
531,82589836,2023-02-03,207.91,816.8399999999999
3550,82589836,2023-02-08,77.26,894.0999999999999
261,82589836,2023-02-09,-146.02,748.0799999999999
7366,82589836,2023-02-13,-113.04,635.04
7771,82589836,2023-02-13,-137.63,497.4099999999999
2417,82696309,2023-01-31,,352.08
8208,82696309,2023-02-01,90.9,442.98
3114,82696309,2023-02-11,-114.97,328.01
2395,82696309,2023-02-13,-63.14,264.87
2418,82734145,2023-01-31,,278.57
1124,82734145,2023-02-02,185.74,464.31
5057,82734145,2023-02-07,124.86,589.17
8116,82734145,2023-02-09,-94.06,495.11
2383,82734145,2023-02-12,-85.04,410.07
1170,82734145,2023-02-13,650.5,1060.57
7762,82734145,2023-02-13,116.52,1177.09
5151,82734145,2023-02-13,85.84,1262.9299999999998
2419,82764940,2023-01-31,,876.37
2860,82764940,2023-02-01,42.34,918.71
5980,82764940,2023-02-02,1117.0,2035.71
8534,82764940,2023-02-02,-100.46,1935.25
4885,82764940,2023-02-10,-1580.9,354.3499999999999
1891,82764940,2023-02-12,153.05,507.3999999999999
2228,82764940,2023-02-12,127.13,634.53
2725,82764940,2023-02-14,182.1,816.6299999999999
2420,82776251,2023-01-31,,747.11
7778,82776251,2023-02-01,91.77,838.88
782,82776251,2023-02-03,123.38,962.26
847,82776251,2023-02-04,-1315.2,-352.94000000000005
3312,82776251,2023-02-11,202.15,-150.79000000000005
2421,82807528,2023-01-31,,117.15
5202,82807528,2023-02-02,128.03,245.18
7683,82807528,2023-02-02,-109.57,135.61
4854,82807528,2023-02-03,79.68,215.29000000000002
4861,82807528,2023-02-09,-18.91,196.38000000000002
7015,82807528,2023-02-13,-45.1,151.28000000000003
5673,82807528,2023-02-14,-71.88,79.40000000000002
887,82807528,2023-02-14,-113.52,-34.119999999999976
2422,82879607,2023-01-31,,72.18
7404,82879607,2023-02-06,-171.29,-99.10999999999999
4265,82879607,2023-02-08,102.11,3.000000000000014
7914,82879607,2023-02-11,164.37,167.37
2003,82879607,2023-02-12,-109.8,57.57000000000001
4544,82879607,2023-02-13,75.81,133.38
2600,82879607,2023-02-14,-117.24,16.140000000000015
2423,82911152,2023-01-31,,564.11
5713,82911152,2023-02-02,109.06,673.1700000000001
3936,82911152,2023-02-02,-68.58,604.59
3431,82911152,2023-02-11,118.19,722.78
2313,82911152,2023-02-11,42.9,765.6800000000001
5602,82911152,2023-02-11,-1104.0,-338.31999999999994
3886,82911152,2023-02-13,-169.23,-507.54999999999995
2528,82911152,2023-02-14,-156.79,-664.3399999999999
2424,82920281,2023-01-31,,41.13
6049,82920281,2023-02-02,94.2,135.33
973,82920281,2023-02-03,-1791.6,-1656.27
322,82920281,2023-02-06,-543.9,-2200.17
2137,82920281,2023-02-10,114.72,-2085.45
2425,82927034,2023-01-31,,435.71
936,82927034,2023-02-03,-131.87,303.84
5516,82927034,2023-02-04,63.83,367.66999999999996
6755,82927034,2023-02-08,-66.93,300.73999999999995
1720,82927034,2023-02-09,86.0,386.73999999999995
3360,82927034,2023-02-11,-116.46,270.28
7192,82927034,2023-02-14,99.21,369.48999999999995
2426,82930132,2023-01-31,,131.87
5259,82930132,2023-02-03,192.08,323.95000000000005
8221,82930132,2023-02-03,175.68,499.63
3037,82930132,2023-02-04,69.05,568.6800000000001
3359,82930132,2023-02-05,119.88,688.5600000000001
1194,82930132,2023-02-06,-105.81,582.75
1006,82930132,2023-02-11,-137.86,444.89
4830,82930132,2023-02-12,0.94,445.83
2427,83003822,2023-01-31,,286.54
901,83003822,2023-02-03,-143.42,143.12000000000003
6836,83003822,2023-02-10,-1430.6,-1287.4799999999998
3877,83003822,2023-02-11,-99.93,-1387.4099999999999
2428,83056011,2023-01-31,,968.4
83,83056011,2023-02-03,129.38,1097.78
2680,83056011,2023-02-08,168.14,1265.92
3224,83056011,2023-02-11,-66.39,1199.53
2429,83067540,2023-01-31,,258.33
2891,83067540,2023-02-03,-37.0,221.32999999999998
1302,83067540,2023-02-03,-111.0,110.32999999999998
3404,83067540,2023-02-06,944.2,1054.53
2958,83067540,2023-02-11,133.67,1188.2
2430,83081615,2023-01-31,,301.32
2372,83081615,2023-02-02,141.97,443.28999999999996
4053,83081615,2023-02-04,41.77,485.06
5344,83081615,2023-02-05,113.82,598.88
2452,83081615,2023-02-07,139.96,738.84
1611,83081615,2023-02-11,67.03,805.87
2431,83124388,2023-01-31,,504.59
8044,83124388,2023-02-02,101.47,606.06
4306,83124388,2023-02-03,94.07,700.13
5349,83124388,2023-02-04,97.81,797.9399999999999
6777,83124388,2023-02-09,-46.08,751.86
7472,83124388,2023-02-09,-64.47,687.39
6522,83124388,2023-02-14,-71.41,615.98
2432,83128181,2023-01-31,,816.12
1978,83128181,2023-02-01,-97.36,718.76
6715,83128181,2023-02-03,82.71,801.47
1078,83128181,2023-02-07,132.91,934.38
3020,83128181,2023-02-09,-1325.7,-391.32000000000005
5353,83128181,2023-02-12,-1681.9,-2073.2200000000003
2433,83128544,2023-01-31,,25.71
4831,83128544,2023-02-05,21.67,47.38
6363,83128544,2023-02-07,181.11,228.49
5027,83128544,2023-02-07,1.03,229.52
3159,83128544,2023-02-07,-153.16,76.36000000000001
7788,83128544,2023-02-08,-128.53,-52.16999999999999
1921,83128544,2023-02-13,-132.3,-184.47
5925,83128544,2023-02-14,85.67,-98.8
2434,83166098,2023-01-31,,827.81
1118,83166098,2023-02-01,-116.71,711.0999999999999
2293,83166098,2023-02-06,-135.81,575.29
2249,83166098,2023-02-07,99.87,675.16
6177,83166098,2023-02-07,-46.92,628.24
7000,83166098,2023-02-08,-170.98,457.26
216,83166098,2023-02-10,989.8,1447.06
8372,83166098,2023-02-11,-110.56,1336.5
7324,83166098,2023-02-13,37.83,1374.33
4968,83166098,2023-02-13,-165.82,1208.51
2435,83187508,2023-01-31,,714.42
4694,83187508,2023-02-01,130.8,845.22
4178,83187508,2023-02-05,35.44,880.66
627,83187508,2023-02-05,-85.78,794.88
1934,83187508,2023-02-06,106.03,900.91
5377,83187508,2023-02-06,90.78,991.6899999999999
6552,83187508,2023-02-08,-126.03,865.66
96,83187508,2023-02-09,65.38,931.04
2307,83187508,2023-02-09,-122.79,808.25
8048,83187508,2023-02-10,1048.2,1856.45
5761,83187508,2023-02-11,-158.35,1698.1000000000001
2022,83187508,2023-02-13,1207.6,2905.7
5578,83187508,2023-02-14,-140.97,2764.73
2436,83191889,2023-01-31,,344.33
5911,83191889,2023-02-02,-91.54,252.78999999999996
5269,83191889,2023-02-02,-101.15,151.64
7925,83191889,2023-02-02,-115.12,36.51999999999997
791,83191889,2023-02-04,398.1,434.62
3103,83191889,2023-02-10,90.73,525.35
1950,83191889,2023-02-10,-88.72,436.63
3055,83191889,2023-02-12,170.43,607.06
1499,83191889,2023-02-13,128.78,735.84
2437,83202693,2023-01-31,,165.41
6507,83202693,2023-02-02,85.17,250.57999999999998
3394,83202693,2023-02-03,-195.91,54.670000000000016
7453,83202693,2023-02-07,-336.2,-281.53
6745,83202693,2023-02-09,129.57,-151.95999999999998
1477,83202693,2023-02-11,93.53,-58.42999999999998
6052,83202693,2023-02-13,-33.04,-91.46999999999997
2438,83281565,2023-01-31,,968.83
5455,83281565,2023-02-06,68.88,1037.71
171,83281565,2023-02-08,-23.79,1013.9200000000001
8364,83281565,2023-02-08,-126.11,887.8100000000001
8603,83281565,2023-02-08,-146.5,741.3100000000001
2687,83281565,2023-02-09,150.23,891.54
2123,83281565,2023-02-12,-174.92,716.62
5006,83281565,2023-02-13,106.97,823.59
5093,83281565,2023-02-14,124.76,948.35
2439,83302154,2023-01-31,,465.25
7673,83302154,2023-02-02,-110.35,354.9
6022,83302154,2023-02-03,-936.3,-581.4
8175,83302154,2023-02-04,598.4,17.0
2193,83302154,2023-02-04,72.97,89.97
5231,83302154,2023-02-06,-141.54,-51.56999999999999
1295,83302154,2023-02-10,206.87,155.3
7002,83302154,2023-02-13,-166.98,-11.679999999999978
2440,83443439,2023-01-31,,97.61
8470,83443439,2023-02-03,1218.0,1315.61
3655,83443439,2023-02-03,-4.02,1311.59
6689,83443439,2023-02-04,-95.13,1216.4599999999998
5546,83443439,2023-02-05,-103.0,1113.4599999999998
5216,83443439,2023-02-06,-55.3,1058.1599999999999
6328,83443439,2023-02-10,216.08,1274.24
2673,83443439,2023-02-10,117.1,1391.34
5653,83443439,2023-02-13,114.78,1506.12
2441,83475318,2023-01-31,,228.96
6482,83475318,2023-02-01,-95.83,133.13
3320,83475318,2023-02-12,79.07,212.2
7919,83475318,2023-02-14,-107.71,104.49000000000001
2442,83530155,2023-01-31,,638.57
1318,83530155,2023-02-02,-58.65,579.9200000000001
5662,83530155,2023-02-10,-136.31,443.61
5755,83530155,2023-02-12,-11.78,431.83000000000004
202,83530155,2023-02-12,-1006.5,-574.67
4969,83530155,2023-02-13,80.6,-494.06999999999994
2443,83530541,2023-01-31,,630.6
1322,83530541,2023-02-07,33.35,663.95
6399,83530541,2023-02-08,-1316.4,-652.45
3872,83530541,2023-02-13,-97.98,-750.4300000000001
2444,83531401,2023-01-31,,445.24
4242,83531401,2023-02-09,-11.67,433.57
7921,83531401,2023-02-10,123.19,556.76
4930,83531401,2023-02-12,67.65,624.41
2445,83539050,2023-01-31,,172.33
1945,83539050,2023-02-09,64.03,236.36
6076,83539050,2023-02-09,-138.19,98.17000000000002
2907,83539050,2023-02-14,114.54,212.71000000000004
2446,83557419,2023-01-31,,374.69
8144,83557419,2023-02-03,-115.71,258.98
8013,83557419,2023-02-05,-98.9,160.07999999999998
2558,83557419,2023-02-13,194.21,354.29
2447,83565726,2023-01-31,,910.38
4889,83565726,2023-02-02,-90.49,819.89
3148,83565726,2023-02-02,-792.0,27.889999999999986
48,83565726,2023-02-03,-68.43,-40.54000000000002
2449,83565726,2023-02-07,162.23,121.68999999999997
6426,83565726,2023-02-07,-87.52,34.16999999999997
1962,83565726,2023-02-11,954.4,988.5699999999999
8512,83565726,2023-02-12,119.09,1107.6599999999999
2213,83565726,2023-02-12,100.74,1208.3999999999999
339,83565726,2023-02-13,-959.6,248.79999999999995
2448,83573848,2023-01-31,,818.5
1643,83573848,2023-02-01,-94.56,723.94
859,83573848,2023-02-02,133.09,857.03
1278,83573848,2023-02-02,123.95,980.98
1847,83573848,2023-02-05,-170.9,810.0799999999999
5912,83573848,2023-02-09,193.78,1003.86
4872,83573848,2023-02-09,-125.67,878.1899999999999
4240,83573848,2023-02-10,83.89,962.0799999999999
2449,83639740,2023-01-31,,266.62
2067,83639740,2023-02-02,128.3,394.92
2771,83639740,2023-02-02,105.52,500.44
2954,83639740,2023-02-03,38.14,538.58
4705,83639740,2023-02-09,587.9,1126.48
5253,83639740,2023-02-11,200.58,1327.06
2450,83659554,2023-01-31,,548.94
227,83659554,2023-02-08,1537.1,2086.04
5784,83659554,2023-02-12,60.3,2146.34
7260,83659554,2023-02-12,-144.19,2002.15
2451,83668302,2023-01-31,,686.96
267,83668302,2023-02-03,-46.29,640.6700000000001
975,83668302,2023-02-07,-11.37,629.3000000000001
1087,83668302,2023-02-12,36.33,665.63
550,83668302,2023-02-12,-28.61,637.02
6332,83668302,2023-02-12,-209.98,427.0400000000001
2452,83672404,2023-01-31,,269.57
5374,83672404,2023-02-01,164.06,433.63
64,83672404,2023-02-02,-131.02,302.61
6869,83672404,2023-02-04,-150.01,152.6
7003,83672404,2023-02-04,-614.0,-461.4
6823,83672404,2023-02-07,-111.08,-572.48
7305,83672404,2023-02-09,75.46,-497.02
3092,83672404,2023-02-09,55.42,-441.59999999999997
2453,83693383,2023-01-31,,138.05
3213,83693383,2023-02-02,-57.51,80.54000000000002
3894,83693383,2023-02-07,-38.04,42.500000000000014
4492,83693383,2023-02-07,-166.87,-124.36999999999999
1405,83693383,2023-02-07,-905.3,-1029.6699999999998
1902,83693383,2023-02-08,189.71,-839.9599999999999
2264,83693383,2023-02-10,67.01,-772.9499999999999
690,83693383,2023-02-14,136.49,-636.4599999999999
1342,83693383,2023-02-14,64.89,-571.5699999999999
2454,83698413,2023-01-31,,223.67
5685,83698413,2023-02-07,113.6,337.27
3021,83698413,2023-02-09,-44.19,293.08
886,83698413,2023-02-12,-100.01,193.07
6556,83698413,2023-02-13,141.46,334.53
2789,83698413,2023-02-13,-90.0,244.52999999999997
2455,83788130,2023-01-31,,833.68
3144,83788130,2023-02-01,-132.46,701.2199999999999
5480,83788130,2023-02-02,-76.14,625.0799999999999
1628,83788130,2023-02-03,-136.61,488.4699999999999
7327,83788130,2023-02-03,-196.73,291.7399999999999
66,83788130,2023-02-06,-161.03,130.70999999999992
5454,83788130,2023-02-08,134.23,264.93999999999994
7079,83788130,2023-02-11,69.84,334.7799999999999
2456,83796561,2023-01-31,,410.08
2057,83796561,2023-02-01,-2239.3,-1829.2200000000003
6878,83796561,2023-02-03,-115.16,-1944.3800000000003
8367,83796561,2023-02-04,69.83,-1874.5500000000002
8057,83796561,2023-02-13,124.65,-1749.9000000000003
3339,83796561,2023-02-14,187.3,-1562.6000000000004
2457,83828891,2023-01-31,,780.59
2063,83828891,2023-02-05,40.41,821.0
5393,83828891,2023-02-05,-136.6,684.4000000000001
8022,83828891,2023-02-08,120.57,804.97
6171,83828891,2023-02-09,-51.97,753.0
5793,83828891,2023-02-12,84.03,837.03
4374,83828891,2023-02-13,116.37,953.4000000000001
2814,83828891,2023-02-14,68.67,1022.07
2458,83852014,2023-01-31,,830.02
7511,83852014,2023-02-01,103.4,933.42
420,83852014,2023-02-04,57.49,990.91
3994,83852014,2023-02-04,-61.88,929.03
3273,83852014,2023-02-05,-82.33,846.7
1819,83852014,2023-02-06,154.07,1000.77
6658,83852014,2023-02-12,-84.13,916.64
4307,83852014,2023-02-14,37.22,953.86
2459,83854141,2023-01-31,,280.06
7818,83854141,2023-02-02,-126.94,153.12
3209,83854141,2023-02-04,-71.57,81.55000000000001
123,83854141,2023-02-05,26.38,107.93
7608,83854141,2023-02-13,109.04,216.97000000000003
5797,83854141,2023-02-14,59.91,276.88
2460,83891783,2023-01-31,,158.08
1377,83891783,2023-02-01,-144.25,13.830000000000013
6046,83891783,2023-02-02,15.77,29.600000000000012
5517,83891783,2023-02-02,-128.31,-98.71
1755,83891783,2023-02-08,118.11,19.400000000000006
8222,83891783,2023-02-09,-123.62,-104.22
519,83891783,2023-02-13,-760.4,-864.62
2975,83891783,2023-02-14,32.8,-831.82
2461,83975923,2023-01-31,,837.45
2878,83975923,2023-02-01,-156.79,680.6600000000001
5742,83975923,2023-02-06,-68.31,612.35
4877,83975923,2023-02-07,-12.66,599.69
2884,83975923,2023-02-12,-131.34,468.35
2462,83981442,2023-01-31,,89.35
7335,83981442,2023-02-02,133.34,222.69
1780,83981442,2023-02-02,93.56,316.25
2591,83981442,2023-02-06,-1138.4,-822.1500000000001
3568,83981442,2023-02-07,85.6,-736.5500000000001
2463,84070285,2023-01-31,,796.6
5645,84070285,2023-02-02,-936.1,-139.5
7729,84070285,2023-02-04,-32.62,-172.12
1223,84070285,2023-02-06,160.17,-11.950000000000017
4058,84070285,2023-02-08,117.53,105.57999999999998
5593,84070285,2023-02-12,1128.7,1234.28
1746,84070285,2023-02-12,-128.19,1106.09
5668,84070285,2023-02-13,82.37,1188.46
6235,84070285,2023-02-13,75.77,1264.23
2388,84070285,2023-02-13,-69.55,1194.68
2464,84107088,2023-01-31,,2.2
154,84107088,2023-02-04,116.65,118.85000000000001
6490,84107088,2023-02-05,105.33,224.18
919,84107088,2023-02-05,-65.92,158.26
5940,84107088,2023-02-07,-591.2,-432.94000000000005
8621,84107088,2023-02-09,-35.02,-467.96000000000004
8453,84107088,2023-02-09,-78.03,-545.99
2465,84187157,2023-01-31,,252.9
7026,84187157,2023-02-04,-125.07,127.83000000000001
8661,84187157,2023-02-05,184.86,312.69000000000005
1164,84187157,2023-02-07,106.8,419.49
1076,84187157,2023-02-09,-96.36,323.13
3466,84187157,2023-02-14,1485.7,1808.83
5604,84187157,2023-02-14,-178.46,1630.3700000000001
2466,84188877,2023-01-31,,624.29
7311,84188877,2023-02-03,104.82,729.1099999999999
8028,84188877,2023-02-04,-58.55,670.56
4432,84188877,2023-02-05,-183.91,486.65
4611,84188877,2023-02-06,92.7,579.35
7507,84188877,2023-02-06,-110.83,468.52
1178,84188877,2023-02-09,-56.12,412.4
242,84188877,2023-02-09,-67.84,344.55999999999995
7709,84188877,2023-02-10,-1800.7,-1456.14
7829,84188877,2023-02-11,102.13,-1354.0100000000002
5727,84188877,2023-02-11,-1273.1,-2627.11
8164,84188877,2023-02-12,183.73,-2443.38
2467,84275961,2023-01-31,,625.24
2890,84275961,2023-02-01,138.19,763.4300000000001
3071,84275961,2023-02-03,110.96,874.39
1583,84275961,2023-02-03,98.41,972.8
3924,84275961,2023-02-07,-79.84,892.96
6120,84275961,2023-02-09,7.96,900.92
2832,84275961,2023-02-10,-182.75,718.17
2468,84280969,2023-01-31,,161.7
1283,84280969,2023-02-02,92.47,254.17
3319,84280969,2023-02-09,103.44,357.61
3781,84280969,2023-02-10,-75.83,281.78
1964,84280969,2023-02-12,-92.56,189.21999999999997
4295,84280969,2023-02-12,-119.08,70.13999999999999
2469,84290934,2023-01-31,,914.5
720,84290934,2023-02-05,-81.8,832.7
5947,84290934,2023-02-06,-67.41,765.29
5857,84290934,2023-02-06,-107.8,657.49
7126,84290934,2023-02-07,-71.52,585.97
7334,84290934,2023-02-09,185.1,771.0699999999999
2470,84295462,2023-01-31,,154.03
2426,84295462,2023-02-01,913.5,1067.53
5988,84295462,2023-02-10,136.73,1204.26
6886,84295462,2023-02-10,89.47,1293.73
4416,84295462,2023-02-11,128.07,1421.8
1999,84295462,2023-02-12,-49.41,1372.3899999999999
2471,84310867,2023-01-31,,258.66
6438,84310867,2023-02-01,65.12,323.78000000000003
694,84310867,2023-02-10,-144.29,179.49000000000004
3826,84310867,2023-02-11,104.35,283.84000000000003
796,84310867,2023-02-12,893.8,1177.6399999999999
6698,84310867,2023-02-12,70.46,1248.1
2127,84310867,2023-02-14,-1295.6,-47.5
2472,84333228,2023-01-31,,330.99
5475,84333228,2023-02-02,190.92,521.91
8432,84333228,2023-02-02,-75.84,446.07
4745,84333228,2023-02-03,114.6,560.67
6018,84333228,2023-02-05,-96.05,464.62
7130,84333228,2023-02-05,-118.78,345.84
8583,84333228,2023-02-11,84.08,429.91999999999996
2473,84334262,2023-01-31,,525.57
8651,84334262,2023-02-02,93.94,619.51
2623,84334262,2023-02-04,-110.05,509.46000000000004
2087,84334262,2023-02-06,133.3,642.76
5234,84334262,2023-02-11,409.8,1052.56
6784,84334262,2023-02-11,105.66,1158.22
214,84334262,2023-02-12,-207.6,950.6200000000001
5587,84334262,2023-02-13,104.24,1054.8600000000001
6718,84334262,2023-02-14,-201.83,853.03
2474,84366763,2023-01-31,,734.48
4855,84366763,2023-02-02,-110.43,624.05
5067,84366763,2023-02-05,76.24,700.29
2612,84366763,2023-02-06,-470.6,229.69
315,84366763,2023-02-11,107.54,337.23
8527,84366763,2023-02-11,74.51,411.74
8233,84366763,2023-02-11,-1012.8,-601.06
2475,84375036,2023-01-31,,356.1
1538,84375036,2023-02-01,114.22,470.32000000000005
2436,84375036,2023-02-07,115.15,585.47
5450,84375036,2023-02-07,-313.5,271.97
5661,84375036,2023-02-08,155.15,427.12
1275,84375036,2023-02-11,69.64,496.76000000000005
3283,84375036,2023-02-11,-130.89,365.87000000000006
1366,84375036,2023-02-13,510.4,876.27
2476,84396180,2023-01-31,,103.83
7783,84396180,2023-02-04,54.15,157.98
7589,84396180,2023-02-08,-130.54,27.439999999999998
6697,84396180,2023-02-10,100.43,127.87
2787,84396180,2023-02-10,-964.8,-836.93
2027,84396180,2023-02-11,31.4,-805.53
2757,84396180,2023-02-13,156.37,-649.16
2477,84406205,2023-01-31,,818.63
1316,84406205,2023-02-05,46.34,864.97
5647,84406205,2023-02-08,94.34,959.31
680,84406205,2023-02-13,-1827.6,-868.29
4485,84406205,2023-02-14,-72.94,-941.23
2478,84411377,2023-01-31,,870.25
5383,84411377,2023-02-07,112.51,982.76
5189,84411377,2023-02-12,-351.6,631.16
2527,84411377,2023-02-13,139.83,770.99
2479,84411930,2023-01-31,,916.61
4025,84411930,2023-02-04,-58.05,858.5600000000001
8628,84411930,2023-02-05,-36.77,821.79
2409,84411930,2023-02-05,-95.84,725.95
7772,84411930,2023-02-06,-52.31,673.64
3570,84411930,2023-02-07,-56.32,617.32
4653,84411930,2023-02-12,163.83,781.1500000000001
2480,84416510,2023-01-31,,793.45
820,84416510,2023-02-02,-31.64,761.8100000000001
7398,84416510,2023-02-02,-88.86,672.95
6335,84416510,2023-02-09,84.55,757.5
3847,84416510,2023-02-11,954.4,1711.9
8639,84416510,2023-02-12,124.59,1836.49
8435,84416510,2023-02-13,72.94,1909.43
7200,84416510,2023-02-14,-404.9,1504.53
2481,84418749,2023-01-31,,457.27
6805,84418749,2023-02-01,200.4,657.67
727,84418749,2023-02-01,-78.47,579.2
5735,84418749,2023-02-02,46.77,625.97
2794,84418749,2023-02-08,-109.06,516.91
4065,84418749,2023-02-09,116.81,633.72
2068,84418749,2023-02-12,21.61,655.33
6749,84418749,2023-02-13,93.39,748.72
2482,84448752,2023-01-31,,412.15
3253,84448752,2023-02-06,1409.6,1821.75
5295,84448752,2023-02-06,88.91,1910.66
166,84448752,2023-02-08,1368.6,3279.26
2466,84448752,2023-02-08,-1253.6,2025.66
2483,84471701,2023-01-31,,89.27
1209,84471701,2023-02-01,62.0,151.26999999999998
5352,84471701,2023-02-02,97.37,248.64
4568,84471701,2023-02-05,-55.81,192.82999999999998
2145,84471701,2023-02-08,77.23,270.06
2484,84656105,2023-01-31,,547.59
3329,84656105,2023-02-03,-56.77,490.82000000000005
4096,84656105,2023-02-06,1457.8,1948.62
6864,84656105,2023-02-06,109.51,2058.13
7758,84656105,2023-02-07,100.78,2158.9100000000003
369,84656105,2023-02-08,189.28,2348.19
7835,84656105,2023-02-13,-105.18,2243.01
2485,84682032,2023-01-31,,612.1
413,84682032,2023-02-03,-3.5,608.6
1225,84682032,2023-02-09,-149.44,459.16
2931,84682032,2023-02-14,-79.89,379.27000000000004
699,84682032,2023-02-14,-123.85,255.42000000000002
2486,84695068,2023-01-31,,693.94
5164,84695068,2023-02-09,-74.41,619.5300000000001
2180,84695068,2023-02-10,34.71,654.24
7963,84695068,2023-02-12,1764.4,2418.6400000000003
8562,84695068,2023-02-13,-9.8,2408.84
2487,84714323,2023-01-31,,667.61
1728,84714323,2023-02-03,-43.31,624.3
920,84714323,2023-02-04,1268.7,1893.0
2488,84746166,2023-01-31,,806.73
7911,84746166,2023-02-03,20.43,827.16
5944,84746166,2023-02-04,24.15,851.3100000000001
6819,84746166,2023-02-05,-59.8,791.51
8533,84746166,2023-02-08,-157.06,634.45
5704,84746166,2023-02-09,-1202.9,-568.45
853,84746166,2023-02-11,-32.0,-600.45
8057,84746166,2023-02-13,-124.65,-725.1
6586,84746166,2023-02-14,-98.03,-823.1300000000001
2489,84778718,2023-01-31,,521.14
4020,84778718,2023-02-03,37.49,558.63
1465,84778718,2023-02-05,101.46,660.0899999999999
521,84778718,2023-02-09,133.43,793.52
6323,84778718,2023-02-11,-78.25,715.27
8550,84778718,2023-02-12,1183.8,1899.07
306,84778718,2023-02-13,70.58,1969.6499999999999
2490,84822607,2023-01-31,,425.79
7838,84822607,2023-02-02,-93.16,332.63
7220,84822607,2023-02-03,65.15,397.78000000000003
1184,84822607,2023-02-07,77.96,475.74
1040,84822607,2023-02-07,-209.73,266.01000000000005
5026,84822607,2023-02-08,134.18,400.19000000000005
7084,84822607,2023-02-10,90.33,490.52000000000004
2491,84853260,2023-01-31,,925.31
1908,84853260,2023-02-07,-74.75,850.56
215,84853260,2023-02-09,-72.3,778.26
3746,84853260,2023-02-13,128.84,907.0999999999999
4447,84853260,2023-02-14,142.57,1049.67
2492,84928531,2023-01-31,,236.36
6402,84928531,2023-02-01,-75.09,161.27
5683,84928531,2023-02-04,186.01,347.28
2122,84928531,2023-02-06,138.32,485.6
6082,84928531,2023-02-06,-87.2,398.4
8331,84928531,2023-02-09,-69.41,328.99
2493,84951477,2023-01-31,,316.2
2286,84951477,2023-02-02,-68.17,248.02999999999997
3143,84951477,2023-02-03,39.9,287.93
978,84951477,2023-02-06,144.68,432.61
7695,84951477,2023-02-10,174.71,607.3199999999999
5205,84951477,2023-02-10,141.06,748.38
81,84951477,2023-02-10,-551.6,196.77999999999997
7161,84951477,2023-02-13,-61.34,135.43999999999997
2494,84964879,2023-01-31,,629.81
7710,84964879,2023-02-01,106.68,736.49
1648,84964879,2023-02-03,15.12,751.6099999999999
2666,84964879,2023-02-05,45.42,797.03
445,84964879,2023-02-07,1653.3,2450.33
2852,84964879,2023-02-08,-113.98,2336.35
7650,84964879,2023-02-11,-59.1,2277.25
2495,84969883,2023-01-31,,672.74
7552,84969883,2023-02-02,-128.13,544.61
8085,84969883,2023-02-03,-1179.0,-634.39
1458,84969883,2023-02-05,139.34,-495.04999999999995
7426,84969883,2023-02-12,845.0,349.95000000000005
809,84969883,2023-02-13,57.17,407.12000000000006
5007,84969883,2023-02-14,-117.34,289.78000000000003
4445,84969883,2023-02-14,-707.3,-417.5199999999999
2496,84995019,2023-01-31,,731.41
169,84995019,2023-02-01,-89.01,642.4
8379,84995019,2023-02-01,-126.06,516.3399999999999
6949,84995019,2023-02-02,-118.32,398.02
4602,84995019,2023-02-03,195.63,593.65
2085,84995019,2023-02-03,64.43,658.0799999999999
8266,84995019,2023-02-04,482.7,1140.78
2895,84995019,2023-02-04,133.46,1274.24
7657,84995019,2023-02-04,85.5,1359.74
2203,84995019,2023-02-04,-64.93,1294.81
658,84995019,2023-02-05,146.21,1441.02
8199,84995019,2023-02-10,148.09,1589.11
8237,84995019,2023-02-11,-69.11,1520.0
3692,84995019,2023-02-14,58.59,1578.59
2497,85001424,2023-01-31,,653.31
3953,85001424,2023-02-01,-103.68,549.6299999999999
8370,85001424,2023-02-06,-82.51,467.11999999999995
5883,85001424,2023-02-09,-126.2,340.91999999999996
6316,85001424,2023-02-11,149.84,490.75999999999993
6662,85001424,2023-02-11,-107.51,383.24999999999994
4826,85001424,2023-02-14,94.55,477.79999999999995
6645,85001424,2023-02-14,44.4,522.1999999999999
2498,85057916,2023-01-31,,656.89
2696,85057916,2023-02-03,18.28,675.17
450,85057916,2023-02-05,74.52,749.6899999999999
5492,85057916,2023-02-09,26.26,775.9499999999999
6757,85057916,2023-02-10,150.39,926.3399999999999
3112,85057916,2023-02-10,76.06,1002.4
6530,85057916,2023-02-10,-167.69,834.71
2499,85128569,2023-01-31,,340.68
3041,85128569,2023-02-03,114.58,455.26
5445,85128569,2023-02-07,-65.37,389.89
6540,85128569,2023-02-11,-105.27,284.62
5978,85128569,2023-02-14,-122.97,161.65
2500,85140734,2023-01-31,,699.57
438,85140734,2023-02-01,205.89,905.46
4070,85140734,2023-02-01,131.36,1036.8200000000002
7448,85140734,2023-02-02,70.63,1107.45
3276,85140734,2023-02-03,-79.37,1028.08
1358,85140734,2023-02-04,77.13,1105.21
717,85140734,2023-02-08,-2113.3,-1008.0900000000001
2072,85140734,2023-02-12,71.65,-936.4400000000002
136,85140734,2023-02-12,-143.0,-1079.44
2501,85156953,2023-01-31,,900.09
2991,85156953,2023-02-02,-16.74,883.35
2268,85156953,2023-02-03,81.73,965.08
5371,85156953,2023-02-05,103.29,1068.3700000000001
3971,85156953,2023-02-10,168.19,1236.56
6961,85156953,2023-02-12,-93.42,1143.14
4145,85156953,2023-02-13,68.93,1212.0700000000002
3575,85156953,2023-02-14,2134.6,3346.67
2502,85177718,2023-01-31,,478.18
958,85177718,2023-02-03,513.3,991.48
6045,85177718,2023-02-05,-131.36,860.12
6765,85177718,2023-02-14,125.03,985.15
2503,85182642,2023-01-31,,451.38
3765,85182642,2023-02-07,-108.09,343.28999999999996
2780,85182642,2023-02-08,-96.42,246.87
1461,85182642,2023-02-11,99.35,346.21999999999997
2504,85192761,2023-01-31,,982.48
8674,85192761,2023-02-04,95.76,1078.24
542,85192761,2023-02-05,-1922.5,-844.26
514,85192761,2023-02-08,52.45,-791.81
5779,85192761,2023-02-12,151.09,-640.72
2505,85238291,2023-01-31,,665.68
7383,85238291,2023-02-01,-142.98,522.6999999999999
168,85238291,2023-02-02,-28.99,493.71
5900,85238291,2023-02-02,-645.8,-152.08999999999997
7899,85238291,2023-02-05,-94.84,-246.92999999999998
282,85238291,2023-02-07,163.8,-83.12999999999997
4317,85238291,2023-02-08,197.96,114.83000000000004
4349,85238291,2023-02-13,115.9,230.73000000000005
2506,85250129,2023-01-31,,400.91
4924,85250129,2023-02-01,-119.21,281.70000000000005
2150,85250129,2023-02-02,77.14,358.84000000000003
528,85250129,2023-02-06,-87.33,271.51000000000005
7531,85250129,2023-02-08,952.0,1223.51
7664,85250129,2023-02-08,-118.76,1104.75
5119,85250129,2023-02-10,-135.21,969.54
1441,85250129,2023-02-12,-56.37,913.17
2507,85265080,2023-01-31,,992.6
6014,85265080,2023-02-01,-78.22,914.38
6623,85265080,2023-02-01,-126.36,788.02
1216,85265080,2023-02-12,-1111.4,-323.3800000000001
2508,85310930,2023-01-31,,688.91
3765,85310930,2023-02-07,108.09,797.0
753,85310930,2023-02-09,121.5,918.5
2081,85310930,2023-02-11,-81.42,837.0799999999999
2509,85336547,2023-01-31,,785.57
6570,85336547,2023-02-03,120.76,906.33
3711,85336547,2023-02-08,-83.2,823.1300000000001
7748,85336547,2023-02-10,222.4,1045.53
2510,85341369,2023-01-31,,932.11
4047,85341369,2023-02-01,146.39,1078.5
3538,85341369,2023-02-02,-149.36,929.14
4766,85341369,2023-02-02,-187.4,741.74
8601,85341369,2023-02-05,36.56,778.3
1473,85341369,2023-02-06,178.4,956.7
6190,85341369,2023-02-06,-34.38,922.3199999999999
242,85341369,2023-02-09,67.84,990.16
6317,85341369,2023-02-11,28.34,1018.5
7771,85341369,2023-02-13,137.63,1156.13
2511,85344981,2023-01-31,,874.46
6644,85344981,2023-02-05,-85.08,789.38
7363,85344981,2023-02-06,1024.2,1813.58
3503,85344981,2023-02-08,203.1,2016.68
3255,85344981,2023-02-09,121.16,2137.84
3275,85344981,2023-02-11,120.98,2258.82
5593,85344981,2023-02-12,-1128.7,1130.1200000000001
7795,85344981,2023-02-13,105.71,1235.8300000000002
2262,85344981,2023-02-14,64.22,1300.0500000000002
2512,85362253,2023-01-31,,790.41
3097,85362253,2023-02-01,-63.28,727.13
7634,85362253,2023-02-03,-178.54,548.5899999999999
2220,85362253,2023-02-04,-61.06,487.53
7624,85362253,2023-02-07,78.85,566.38
38,85362253,2023-02-08,92.43,658.81
3251,85362253,2023-02-12,-76.86,581.9499999999999
4631,85362253,2023-02-14,544.0,1125.9499999999998
2513,85399459,2023-01-31,,705.94
40,85399459,2023-02-02,-89.7,616.24
7036,85399459,2023-02-07,-169.12,447.12000000000006
1639,85399459,2023-02-10,37.83,484.95000000000005
5056,85399459,2023-02-11,-1037.0,-552.05
5103,85399459,2023-02-13,-89.1,-641.15
2514,85420056,2023-01-31,,107.03
8191,85420056,2023-02-04,26.76,133.79
6216,85420056,2023-02-08,-120.11,13.680000000000007
2894,85420056,2023-02-09,94.81,108.49000000000001
1863,85420056,2023-02-11,177.1,285.59000000000003
4523,85420056,2023-02-13,48.77,334.36
2515,85423742,2023-01-31,,131.14
238,85423742,2023-02-02,84.91,216.04999999999998
1851,85423742,2023-02-09,106.29,322.34
8599,85423742,2023-02-11,858.7,1181.04
5605,85423742,2023-02-11,11.69,1192.73
880,85423742,2023-02-12,122.62,1315.35
3320,85423742,2023-02-12,-79.07,1236.28
6800,85423742,2023-02-14,-87.55,1148.73
2516,85435135,2023-01-31,,106.63
5630,85435135,2023-02-02,-72.58,34.05
1203,85435135,2023-02-03,127.62,161.67000000000002
3329,85435135,2023-02-03,56.77,218.44
7560,85435135,2023-02-03,-90.48,127.96000000000001
4566,85435135,2023-02-07,127.93,255.89000000000001
2593,85435135,2023-02-11,141.75,397.64
3721,85435135,2023-02-11,110.28,507.92
208,85435135,2023-02-12,-178.37,329.55
1429,85435135,2023-02-13,126.46,456.01
2517,85482194,2023-01-31,,997.62
4601,85482194,2023-02-03,160.1,1157.72
1797,85482194,2023-02-05,114.53,1272.25
7272,85482194,2023-02-07,145.86,1418.1100000000001
6458,85482194,2023-02-08,141.86,1559.97
4536,85482194,2023-02-08,45.23,1605.2
897,85482194,2023-02-09,-1216.6,388.60000000000014
6293,85482194,2023-02-11,33.64,422.2400000000001
7124,85482194,2023-02-11,-137.43,284.8100000000001
2518,85490561,2023-01-31,,512.78
6403,85490561,2023-02-03,119.2,631.98
723,85490561,2023-02-03,-140.5,491.47999999999996
6873,85490561,2023-02-07,75.08,566.56
7302,85490561,2023-02-08,190.37,756.93
7740,85490561,2023-02-09,-97.54,659.39
1926,85490561,2023-02-09,-205.74,453.6499999999999
685,85490561,2023-02-13,-86.25,367.3999999999999
2519,85493851,2023-01-31,,796.35
1447,85493851,2023-02-05,-121.03,675.32
6974,85493851,2023-02-06,1.46,676.78
3206,85493851,2023-02-08,96.95,773.73
2733,85493851,2023-02-09,-134.75,638.98
2721,85493851,2023-02-09,-142.59,496.39
2616,85493851,2023-02-14,93.61,590.0
2520,85496714,2023-01-31,,353.13
1676,85496714,2023-02-03,-129.19,223.94
2010,85496714,2023-02-04,-91.41,132.53
8002,85496714,2023-02-04,-117.79,14.739999999999995
4148,85496714,2023-02-06,60.39,75.13
5821,85496714,2023-02-08,-153.79,-78.66
460,85496714,2023-02-09,63.04,-15.619999999999997
1390,85496714,2023-02-10,-116.54,-132.16
8372,85496714,2023-02-11,110.56,-21.60000000000001
5934,85496714,2023-02-12,1314.3,1292.7
4809,85496714,2023-02-12,69.85,1362.55
1425,85496714,2023-02-13,99.37,1461.92
6415,85496714,2023-02-13,32.94,1494.8600000000001
2521,85498335,2023-01-31,,745.08
5719,85498335,2023-02-04,-80.51,664.57
7393,85498335,2023-02-07,84.97,749.5400000000001
6851,85498335,2023-02-09,149.64,899.1800000000001
2307,85498335,2023-02-09,122.79,1021.97
2522,85498936,2023-01-31,,47.77
6943,85498936,2023-02-03,-1935.5,-1887.73
3989,85498936,2023-02-09,158.52,-1729.21
8381,85498936,2023-02-10,39.45,-1689.76
6353,85498936,2023-02-13,0.58,-1689.18
2523,85501046,2023-01-31,,354.76
3943,85501046,2023-02-01,-152.04,202.72
3110,85501046,2023-02-05,158.24,360.96000000000004
7766,85501046,2023-02-08,-57.32,303.64
2524,85503501,2023-01-31,,13.66
4639,85503501,2023-02-01,53.46,67.12
8258,85503501,2023-02-04,-148.08,-80.96000000000001
8434,85503501,2023-02-05,186.17,105.20999999999998
403,85503501,2023-02-05,-55.52,49.689999999999976
1616,85503501,2023-02-06,394.5,444.19
2157,85503501,2023-02-08,178.49,622.6800000000001
7580,85503501,2023-02-09,190.68,813.36
1510,85503501,2023-02-13,59.04,872.4
2525,85551186,2023-01-31,,909.25
3733,85551186,2023-02-07,102.52,1011.77
8401,85551186,2023-02-07,-1198.9,-187.1300000000001
6809,85551186,2023-02-09,99.59,-87.5400000000001
2526,85559926,2023-01-31,,423.28
2827,85559926,2023-02-01,-125.68,297.59999999999997
8316,85559926,2023-02-06,16.67,314.27
3700,85559926,2023-02-07,-56.13,258.14
3289,85559926,2023-02-09,1727.8,1985.94
7586,85559926,2023-02-10,89.09,2075.0299999999997
722,85559926,2023-02-10,71.14,2146.1699999999996
2083,85559926,2023-02-11,50.07,2196.24
6654,85559926,2023-02-12,1071.4,3267.64
765,85559926,2023-02-12,-177.52,3090.12
2527,85562851,2023-01-31,,499.37
5921,85562851,2023-02-02,-144.51,354.86
1015,85562851,2023-02-03,-141.05,213.81
326,85562851,2023-02-07,119.25,333.06
7982,85562851,2023-02-07,-226.83,106.22999999999999
8271,85562851,2023-02-08,-19.11,87.11999999999999
5844,85562851,2023-02-08,-186.34,-99.22000000000001
899,85562851,2023-02-09,158.25,59.02999999999999
5272,85562851,2023-02-12,-66.67,-7.640000000000015
2528,85609963,2023-01-31,,424.83
1656,85609963,2023-02-04,189.72,614.55
8196,85609963,2023-02-05,142.79,757.3399999999999
7877,85609963,2023-02-10,156.22,913.56
2529,85652943,2023-01-31,,424.5
5369,85652943,2023-02-02,-95.52,328.98
2712,85652943,2023-02-03,110.59,439.57
7522,85652943,2023-02-03,-854.4,-414.83
4150,85652943,2023-02-09,121.95,-292.88
2530,85679194,2023-01-31,,891.99
3412,85679194,2023-02-06,104.32,996.31
8647,85679194,2023-02-07,-185.02,811.29
2350,85679194,2023-02-09,79.45,890.74
7267,85679194,2023-02-10,31.28,922.02
6521,85679194,2023-02-13,38.26,960.28
2531,85709972,2023-01-31,,936.57
7310,85709972,2023-02-05,45.1,981.6700000000001
8417,85709972,2023-02-11,173.7,1155.3700000000001
2532,85723355,2023-01-31,,745.34
1174,85723355,2023-02-05,-6.72,738.62
8080,85723355,2023-02-08,-187.24,551.38
459,85723355,2023-02-12,112.23,663.61
3987,85723355,2023-02-13,-30.37,633.24
4475,85723355,2023-02-14,-1773.6,-1140.36
2533,85724829,2023-01-31,,189.94
1792,85724829,2023-02-02,49.63,239.57
1236,85724829,2023-02-02,-2.63,236.94
482,85724829,2023-02-03,-23.5,213.44
5553,85724829,2023-02-08,108.96,322.4
70,85724829,2023-02-08,-122.81,199.58999999999997
2668,85724829,2023-02-10,148.63,348.21999999999997
1723,85724829,2023-02-10,141.46,489.67999999999995
7976,85724829,2023-02-10,-74.15,415.53
1054,85724829,2023-02-11,185.47,601.0
647,85724829,2023-02-13,39.15,640.15
2534,85771346,2023-01-31,,458.88
2803,85771346,2023-02-07,-201.7,257.18
5318,85771346,2023-02-08,-570.9,-313.71999999999997
2535,85826354,2023-01-31,,611.74
7641,85826354,2023-02-02,-80.3,531.44
7077,85826354,2023-02-03,52.49,583.9300000000001
7706,85826354,2023-02-05,100.81,684.74
2509,85826354,2023-02-13,64.85,749.59
5763,85826354,2023-02-13,-44.38,705.21
2536,85839285,2023-01-31,,728.06
1028,85839285,2023-02-01,637.1,1365.1599999999999
232,85839285,2023-02-03,-136.43,1228.73
2480,85839285,2023-02-06,104.85,1333.58
4800,85839285,2023-02-07,124.7,1458.28
811,85839285,2023-02-09,-65.77,1392.51
7361,85839285,2023-02-10,-193.12,1199.3899999999999
97,85839285,2023-02-13,-68.86,1130.53
2537,85841767,2023-01-31,,458.43
6858,85841767,2023-02-01,-111.89,346.54
296,85841767,2023-02-03,90.58,437.12
5412,85841767,2023-02-04,14.63,451.75
7067,85841767,2023-02-04,-90.44,361.31
6483,85841767,2023-02-06,-110.66,250.65
5943,85841767,2023-02-08,-70.92,179.73000000000002
3194,85841767,2023-02-08,-134.88,44.85000000000002
1988,85841767,2023-02-10,-168.64,-123.78999999999996
7463,85841767,2023-02-13,-216.37,-340.15999999999997
3810,85841767,2023-02-14,-37.74,-377.9
2538,85846175,2023-01-31,,22.88
5425,85846175,2023-02-03,56.99,79.87
5901,85846175,2023-02-04,112.13,192.0
6089,85846175,2023-02-04,-117.97,74.03
5424,85846175,2023-02-07,15.66,89.69
739,85846175,2023-02-08,-113.65,-23.960000000000008
7934,85846175,2023-02-09,-101.26,-125.22000000000001
2488,85846175,2023-02-11,197.9,72.67999999999999
6079,85846175,2023-02-11,114.34,187.01999999999998
5396,85846175,2023-02-12,115.87,302.89
1827,85846175,2023-02-14,164.38,467.27
2539,85848442,2023-01-31,,118.46
2372,85848442,2023-02-02,-141.97,-23.510000000000005
2908,85848442,2023-02-07,301.0,277.49
4274,85848442,2023-02-07,-118.92,158.57
7643,85848442,2023-02-08,-103.57,55.000000000000014
227,85848442,2023-02-08,-1537.1,-1482.1
6867,85848442,2023-02-10,87.35,-1394.75
6029,85848442,2023-02-10,74.72,-1320.03
6343,85848442,2023-02-10,-168.35,-1488.3799999999999
1044,85848442,2023-02-11,-45.67,-1534.05
4562,85848442,2023-02-11,-77.54,-1611.59
2540,85874418,2023-01-31,,151.83
5050,85874418,2023-02-01,-151.41,0.4200000000000159
4712,85874418,2023-02-02,110.52,110.94000000000001
1799,85874418,2023-02-02,-33.06,77.88000000000001
7207,85874418,2023-02-03,113.54,191.42000000000002
1711,85874418,2023-02-03,-247.64,-56.21999999999997
1132,85874418,2023-02-06,111.97,55.75000000000003
6387,85874418,2023-02-08,-1805.6,-1749.85
3228,85874418,2023-02-12,-61.36,-1811.2099999999998
2541,85902834,2023-01-31,,357.94
7398,85902834,2023-02-02,88.86,446.8
6199,85902834,2023-02-03,23.24,470.04
1443,85902834,2023-02-06,178.37,648.41
7632,85902834,2023-02-06,-107.61,540.8
4566,85902834,2023-02-07,-127.93,412.87
5614,85902834,2023-02-08,-120.35,292.52
6939,85902834,2023-02-10,-160.72,131.8
8654,85902834,2023-02-11,138.48,270.28
4494,85902834,2023-02-13,731.4,1001.68
3113,85902834,2023-02-13,-83.84,917.8399999999999
2542,85919813,2023-01-31,,647.36
4721,85919813,2023-02-01,106.8,754.16
4090,85919813,2023-02-07,-171.45,582.71
1624,85919813,2023-02-09,-77.66,505.05000000000007
4114,85919813,2023-02-12,-81.83,423.22
2543,85924719,2023-01-31,,472.05
8079,85924719,2023-02-08,1872.8,2344.85
6842,85924719,2023-02-09,-77.33,2267.52
5058,85924719,2023-02-11,1010.6,3278.12
2544,85939269,2023-01-31,,223.1
3428,85939269,2023-02-01,-121.91,101.19
624,85939269,2023-02-02,534.5,635.69
7125,85939269,2023-02-05,-181.23,454.46000000000004
7629,85939269,2023-02-06,-151.33,303.13000000000005
7695,85939269,2023-02-10,-174.71,128.42000000000004
2385,85939269,2023-02-13,154.15,282.57000000000005
823,85939269,2023-02-13,-121.3,161.27000000000004
2545,85940057,2023-01-31,,521.37
6702,85940057,2023-02-01,1069.7,1591.0700000000002
6699,85940057,2023-02-04,-100.53,1490.54
4708,85940057,2023-02-05,49.85,1540.3899999999999
6096,85940057,2023-02-05,-1136.4,403.9899999999998
7484,85940057,2023-02-12,-110.14,293.8499999999998
3388,85940057,2023-02-12,-989.2,-695.3500000000003
2546,85951663,2023-01-31,,385.0
3583,85951663,2023-02-01,99.45,484.45
3918,85951663,2023-02-02,233.36,717.81
331,85951663,2023-02-02,184.29,902.1
4986,85951663,2023-02-02,-133.67,768.4300000000001
5047,85951663,2023-02-03,-122.22,646.21
2689,85951663,2023-02-04,255.0,901.21
1147,85951663,2023-02-08,-105.97,795.24
4239,85951663,2023-02-08,-215.14,580.1
6765,85951663,2023-02-14,-125.03,455.07000000000005
2547,85994636,2023-01-31,,819.24
4375,85994636,2023-02-01,-114.04,705.2
5394,85994636,2023-02-02,-104.79,600.41
7401,85994636,2023-02-04,1361.0,1961.4099999999999
7640,85994636,2023-02-04,-1410.9,550.5099999999998
7780,85994636,2023-02-08,65.85,616.3599999999998
211,85994636,2023-02-09,-96.08,520.2799999999997
6454,85994636,2023-02-12,123.24,643.5199999999998
3414,85994636,2023-02-12,63.33,706.8499999999998
7515,85994636,2023-02-13,104.7,811.5499999999997
2548,86007729,2023-01-31,,320.78
7379,86007729,2023-02-05,97.55,418.33
1479,86007729,2023-02-10,-29.52,388.80999999999995
1020,86007729,2023-02-12,111.6,500.40999999999997
3560,86007729,2023-02-13,72.81,573.22
2549,86020532,2023-01-31,,972.95
1503,86020532,2023-02-05,-95.98,876.97
6142,86020532,2023-02-11,120.19,997.1600000000001
4722,86020532,2023-02-12,44.97,1042.13
6914,86020532,2023-02-13,-56.91,985.22
2550,86031592,2023-01-31,,637.42
122,86031592,2023-02-01,124.24,761.66
8273,86031592,2023-02-01,-135.0,626.66
737,86031592,2023-02-02,180.16,806.8199999999999
3917,86031592,2023-02-02,51.28,858.0999999999999
5910,86031592,2023-02-03,70.8,928.9
5285,86031592,2023-02-03,-56.89,872.01
791,86031592,2023-02-04,-398.1,473.90999999999997
1301,86031592,2023-02-05,78.96,552.87
694,86031592,2023-02-10,144.29,697.16
2749,86031592,2023-02-11,-331.8,365.35999999999996
6999,86031592,2023-02-13,86.51,451.86999999999995
2551,86053438,2023-01-31,,303.06
158,86053438,2023-02-01,1152.9,1455.96
3867,86053438,2023-02-02,116.0,1571.96
8198,86053438,2023-02-04,-150.45,1421.51
4243,86053438,2023-02-10,-42.14,1379.3700000000001
625,86053438,2023-02-13,147.5,1526.8700000000001
7138,86053438,2023-02-13,77.52,1604.39
2552,86068003,2023-01-31,,567.14
6330,86068003,2023-02-03,3.24,570.38
5173,86068003,2023-02-03,-129.77,440.61
4598,86068003,2023-02-06,63.7,504.31
8426,86068003,2023-02-07,79.99,584.3
2471,86068003,2023-02-08,-693.4,-109.10000000000002
1437,86068003,2023-02-11,-42.95,-152.05
4951,86068003,2023-02-11,-56.7,-208.75000000000003
5436,86068003,2023-02-12,84.03,-124.72000000000003
2747,86068003,2023-02-14,2620.1,2495.38
2553,86086812,2023-01-31,,832.82
3327,86086812,2023-02-02,-106.61,726.21
7089,86086812,2023-02-13,-105.74,620.47
2554,86092750,2023-01-31,,261.57
3744,86092750,2023-02-03,952.0,1213.57
2585,86092750,2023-02-08,-91.53,1122.04
2457,86092750,2023-02-09,155.22,1277.26
1464,86092750,2023-02-10,-80.91,1196.35
2555,86106528,2023-01-31,,238.55
8635,86106528,2023-02-02,120.72,359.27
7794,86106528,2023-02-06,11.94,371.21000000000004
2556,86108287,2023-01-31,,523.61
3624,86108287,2023-02-05,61.25,584.86
5569,86108287,2023-02-08,167.35,752.21
6072,86108287,2023-02-10,-86.14,666.07
3652,86108287,2023-02-10,-1210.3,-544.2299999999999
5066,86108287,2023-02-11,40.3,-503.9299999999999
2557,86131065,2023-01-31,,920.08
3489,86131065,2023-02-05,-114.02,806.0600000000001
15,86131065,2023-02-07,26.33,832.3900000000001
5484,86131065,2023-02-08,154.2,986.59
2679,86131065,2023-02-09,-73.98,912.61
2558,86155528,2023-01-31,,772.38
4932,86155528,2023-02-01,81.56,853.94
3010,86155528,2023-02-06,161.12,1015.06
5366,86155528,2023-02-08,-63.8,951.26
6449,86155528,2023-02-09,-107.63,843.63
6052,86155528,2023-02-13,33.04,876.67
2559,86169883,2023-01-31,,452.25
1380,86169883,2023-02-06,-52.84,399.40999999999997
8126,86169883,2023-02-07,98.66,498.07
1682,86169883,2023-02-08,-165.79,332.28
6840,86169883,2023-02-12,-151.06,181.22
2727,86169883,2023-02-12,-164.03,17.189999999999998
5930,86169883,2023-02-12,-191.61,-174.42000000000002
809,86169883,2023-02-13,-57.17,-231.59000000000003
4945,86169883,2023-02-14,69.79,-161.8
7340,86169883,2023-02-14,-143.83,-305.63
2560,86190489,2023-01-31,,237.72
3739,86190489,2023-02-03,-108.09,129.63
2705,86190489,2023-02-05,860.7,990.33
3423,86190489,2023-02-07,-182.27,808.0600000000001
5000,86190489,2023-02-07,-184.29,623.77
6804,86190489,2023-02-13,-89.42,534.35
2340,86190489,2023-02-13,-136.67,397.68000000000006
7543,86190489,2023-02-14,191.09,588.7700000000001
2561,86207903,2023-01-31,,911.44
6896,86207903,2023-02-01,-41.18,870.2600000000001
8633,86207903,2023-02-01,-131.27,738.99
7379,86207903,2023-02-05,-97.55,641.44
78,86207903,2023-02-06,1085.4,1726.8400000000001
4463,86207903,2023-02-06,-54.71,1672.13
7178,86207903,2023-02-07,-189.62,1482.5100000000002
5657,86207903,2023-02-10,-108.81,1373.7
8230,86207903,2023-02-11,-1035.1,338.60000000000014
5071,86207903,2023-02-12,-92.53,246.07000000000014
2562,86218347,2023-01-31,,481.16
3998,86218347,2023-02-01,165.66,646.82
8488,86218347,2023-02-07,1581.8,2228.62
1475,86218347,2023-02-07,-80.47,2148.15
6998,86218347,2023-02-09,-52.73,2095.42
713,86218347,2023-02-10,146.12,2241.54
1587,86218347,2023-02-10,-1463.6,777.9400000000003
5720,86218347,2023-02-11,100.23,878.1700000000003
5153,86218347,2023-02-14,156.02,1034.1900000000003
2563,86228741,2023-01-31,,562.04
819,86228741,2023-02-06,-114.11,447.92999999999995
4513,86228741,2023-02-10,-139.65,308.28
2739,86228741,2023-02-13,156.49,464.77
2564,86263956,2023-01-31,,852.67
5828,86263956,2023-02-10,-80.77,771.9
8108,86263956,2023-02-12,-111.68,660.2199999999999
2565,86266595,2023-01-31,,539.96
7745,86266595,2023-02-01,-156.73,383.23
7990,86266595,2023-02-02,115.05,498.28000000000003
6848,86266595,2023-02-05,357.9,856.1800000000001
1037,86266595,2023-02-05,-159.3,696.88
4333,86266595,2023-02-09,-8.38,688.5
1968,86266595,2023-02-09,-47.07,641.43
354,86266595,2023-02-10,122.66,764.09
3212,86266595,2023-02-11,-60.37,703.72
5315,86266595,2023-02-13,-100.05,603.67
2333,86266595,2023-02-14,-36.2,567.47
2566,86268635,2023-01-31,,679.32
4411,86268635,2023-02-02,77.54,756.86
3001,86268635,2023-02-03,84.12,840.98
1706,86268635,2023-02-04,152.48,993.46
2567,86272488,2023-01-31,,11.73
3249,86272488,2023-02-01,-90.79,-79.06
4161,86272488,2023-02-03,13.61,-65.45
2132,86272488,2023-02-03,-156.35,-221.8
6440,86272488,2023-02-05,144.1,-77.69999999999999
6300,86272488,2023-02-14,88.35,10.650000000000006
2568,86297017,2023-01-31,,803.81
595,86297017,2023-02-01,103.04,906.8499999999999
7733,86297017,2023-02-03,-80.26,826.5899999999999
3455,86297017,2023-02-04,-67.91,758.68
3691,86297017,2023-02-10,715.5,1474.1799999999998
769,86297017,2023-02-11,531.4,2005.58
4716,86297017,2023-02-13,-89.3,1916.28
2569,86339581,2023-01-31,,91.76
8311,86339581,2023-02-02,126.16,217.92000000000002
4294,86339581,2023-02-03,48.23,266.15
4864,86339581,2023-02-04,-47.33,218.82
2618,86339581,2023-02-06,-246.82,-28.0
8532,86339581,2023-02-07,-108.09,-136.09
498,86339581,2023-02-08,166.36,30.27000000000001
7179,86339581,2023-02-10,-74.6,-44.329999999999984
8612,86339581,2023-02-11,133.59,89.26000000000002
3576,86339581,2023-02-11,-1107.1,-1017.8399999999999
2570,86339899,2023-01-31,,460.69
5849,86339899,2023-02-01,615.8,1076.49
8139,86339899,2023-02-01,-601.7,474.78999999999996
3507,86339899,2023-02-03,171.99,646.78
6299,86339899,2023-02-04,-127.8,518.98
2799,86339899,2023-02-06,1792.7,2311.6800000000003
2122,86339899,2023-02-06,-138.32,2173.36
2568,86339899,2023-02-07,71.01,2244.37
8538,86339899,2023-02-10,80.58,2324.9500000000003
2050,86339899,2023-02-10,-64.28,2260.67
7890,86339899,2023-02-11,-114.84,2145.83
2571,86406958,2023-01-31,,842.43
1865,86406958,2023-02-02,-27.69,814.7399999999999
5816,86406958,2023-02-06,-687.1,127.63999999999987
8147,86406958,2023-02-10,34.99,162.62999999999988
2483,86406958,2023-02-13,93.14,255.76999999999987
5889,86406958,2023-02-14,68.7,324.46999999999986
2848,86406958,2023-02-14,66.88,391.34999999999985
2572,86439949,2023-01-31,,782.42
1084,86439949,2023-02-02,66.42,848.8399999999999
5159,86439949,2023-02-02,12.87,861.7099999999999
4585,86439949,2023-02-03,-27.88,833.8299999999999
5425,86439949,2023-02-03,-56.99,776.8399999999999
5011,86439949,2023-02-05,-109.7,667.14
2536,86439949,2023-02-09,-735.1,-67.96000000000004
2573,86489618,2023-01-31,,488.7
4170,86489618,2023-02-03,-5.31,483.39
1904,86489618,2023-02-06,37.9,521.29
6176,86489618,2023-02-09,166.16,687.45
4066,86489618,2023-02-13,2.0,689.45
2574,86496446,2023-01-31,,124.84
6313,86496446,2023-02-01,-85.61,39.230000000000004
1472,86496446,2023-02-07,137.51,176.74
1071,86496446,2023-02-08,138.31,315.05
341,86496446,2023-02-11,151.17,466.22
1732,86496446,2023-02-14,95.87,562.09
2575,86530050,2023-01-31,,447.17
2124,86530050,2023-02-01,103.16,550.33
1985,86530050,2023-02-03,-90.66,459.67
2169,86530050,2023-02-04,-128.26,331.41
6479,86530050,2023-02-07,-169.25,162.16000000000003
4590,86530050,2023-02-09,138.85,301.01
7488,86530050,2023-02-09,31.87,332.88
5855,86530050,2023-02-09,-57.36,275.52000000000004
5792,86530050,2023-02-09,-102.35,173.17000000000002
4052,86530050,2023-02-14,158.33,331.50000000000006
3571,86530050,2023-02-14,30.74,362.24000000000007
3831,86530050,2023-02-14,-119.1,243.14000000000004
2576,86596620,2023-01-31,,512.69
6831,86596620,2023-02-04,42.74,555.4300000000001
4636,86596620,2023-02-07,-24.34,531.09
1741,86596620,2023-02-10,-70.43,460.6600000000001
4995,86596620,2023-02-11,84.35,545.01
3537,86596620,2023-02-12,-142.86,402.15000000000003
2577,86624158,2023-01-31,,818.29
1796,86624158,2023-02-04,-124.23,694.06
2762,86624158,2023-02-05,97.55,791.6099999999999
1500,86624158,2023-02-07,169.03,960.64
672,86624158,2023-02-08,-101.89,858.75
7995,86624158,2023-02-09,56.03,914.78
6215,86624158,2023-02-10,-94.45,820.3299999999999
559,86624158,2023-02-11,179.27,999.5999999999999
2990,86624158,2023-02-11,126.42,1126.02
2578,86637863,2023-01-31,,672.86
7545,86637863,2023-02-03,105.11,777.97
8537,86637863,2023-02-04,155.63,933.6
5041,86637863,2023-02-05,-78.36,855.24
1708,86637863,2023-02-06,-27.56,827.6800000000001
2845,86637863,2023-02-08,87.73,915.4100000000001
761,86637863,2023-02-12,-91.23,824.1800000000001
2579,86655008,2023-01-31,,671.72
4192,86655008,2023-02-01,84.07,755.79
2076,86655008,2023-02-01,-52.9,702.89
8683,86655008,2023-02-03,-198.29,504.6
5086,86655008,2023-02-04,-900.7,-396.1
3340,86655008,2023-02-09,98.31,-297.79
3495,86655008,2023-02-09,-66.83,-364.62
7236,86655008,2023-02-13,-142.99,-507.61
7240,86655008,2023-02-14,115.38,-392.23
2580,86698396,2023-01-31,,314.21
4895,86698396,2023-02-03,113.68,427.89
2581,86728138,2023-01-31,,175.36
5518,86728138,2023-02-04,-214.78,-39.41999999999999
1946,86728138,2023-02-07,162.23,122.81
5685,86728138,2023-02-07,-113.6,9.210000000000008
1134,86728138,2023-02-08,-157.76,-148.54999999999998
2582,86737119,2023-01-31,,432.69
5891,86737119,2023-02-04,244.13,676.8199999999999
5261,86737119,2023-02-04,-158.98,517.84
2906,86737119,2023-02-05,-772.5,-254.65999999999997
8036,86737119,2023-02-06,-193.27,-447.92999999999995
6047,86737119,2023-02-07,197.12,-250.80999999999997
400,86737119,2023-02-07,123.68,-127.12999999999997
4015,86737119,2023-02-07,76.84,-50.289999999999964
1430,86737119,2023-02-07,-152.63,-202.91999999999996
939,86737119,2023-02-09,176.56,-26.359999999999957
3864,86737119,2023-02-13,148.57,122.21000000000004
1881,86737119,2023-02-14,73.77,195.98000000000002
2583,86765156,2023-01-31,,290.53
5780,86765156,2023-02-02,118.87,409.4
8358,86765156,2023-02-05,-65.68,343.71999999999997
2042,86765156,2023-02-09,176.29,520.01
2319,86765156,2023-02-09,97.79,617.8
2584,86785126,2023-01-31,,148.21
3964,86785126,2023-02-02,-225.34,-77.13
1658,86785126,2023-02-03,104.95,27.820000000000007
546,86785126,2023-02-04,-103.81,-75.99
2704,86785126,2023-02-05,-80.83,-156.82
8528,86785126,2023-02-07,147.04,-9.780000000000001
5308,86785126,2023-02-11,-47.98,-57.76
8000,86785126,2023-02-14,643.9,586.14
1139,86785126,2023-02-14,-412.8,173.33999999999997
2585,86788651,2023-01-31,,593.38
2148,86788651,2023-02-01,218.14,811.52
3943,86788651,2023-02-01,152.04,963.56
7657,86788651,2023-02-04,-85.5,878.06
1664,86788651,2023-02-07,-101.07,776.99
1504,86788651,2023-02-07,-283.4,493.59000000000003
8487,86788651,2023-02-13,128.76,622.35
6205,86788651,2023-02-14,-90.79,531.5600000000001
3481,86788651,2023-02-14,-162.35,369.21000000000004
2586,86795912,2023-01-31,,295.95
7202,86795912,2023-02-05,-119.75,176.2
5449,86795912,2023-02-08,-98.0,78.19999999999999
6038,86795912,2023-02-09,132.48,210.67999999999998
8471,86795912,2023-02-12,-877.5,-666.82
4509,86795912,2023-02-14,170.78,-496.0400000000001
2587,86816054,2023-01-31,,391.59
6489,86816054,2023-02-03,109.86,501.45
629,86816054,2023-02-06,-83.26,418.18999999999994
5890,86816054,2023-02-07,-1255.9,-837.7100000000002
1457,86816054,2023-02-09,164.72,-672.9900000000001
653,86816054,2023-02-09,69.0,-603.9900000000001
7218,86816054,2023-02-12,80.44,-523.5500000000002
2588,86864320,2023-01-31,,611.14
5897,86864320,2023-02-01,-103.58,507.56
4815,86864320,2023-02-05,183.42,690.98
633,86864320,2023-02-06,138.14,829.1199999999999
4048,86864320,2023-02-06,-63.43,765.6899999999999
6660,86864320,2023-02-13,99.8,865.49
8596,86864320,2023-02-14,126.71,992.1999999999999
2589,86870860,2023-01-31,,987.14
7447,86870860,2023-02-02,130.93,1118.07
4012,86870860,2023-02-02,-1556.9,-438.83000000000015
5750,86870860,2023-02-05,-146.29,-585.1200000000001
630,86870860,2023-02-06,-187.58,-772.7000000000002
3548,86870860,2023-02-07,78.9,-693.8000000000002
8003,86870860,2023-02-10,-98.63,-792.4300000000002
5440,86870860,2023-02-12,228.38,-564.0500000000002
3797,86870860,2023-02-13,-133.35,-697.4000000000001
8238,86870860,2023-02-14,-131.53,-828.9300000000002
2590,86893452,2023-01-31,,641.84
3315,86893452,2023-02-01,108.17,750.01
158,86893452,2023-02-01,-1152.9,-402.8900000000001
7199,86893452,2023-02-04,-46.13,-449.0200000000001
1249,86893452,2023-02-06,119.58,-329.4400000000001
1430,86893452,2023-02-07,152.63,-176.81000000000012
4960,86893452,2023-02-08,92.25,-84.56000000000012
7996,86893452,2023-02-09,-96.28,-180.84000000000012
320,86893452,2023-02-10,79.77,-101.07000000000012
2714,86893452,2023-02-10,-46.29,-147.36000000000013
1763,86893452,2023-02-12,-94.03,-241.39000000000013
7903,86893452,2023-02-14,-124.48,-365.8700000000001
2591,86941058,2023-01-31,,337.99
1840,86941058,2023-02-01,466.7,804.69
7247,86941058,2023-02-01,150.96,955.65
6123,86941058,2023-02-01,148.96,1104.6100000000001
4382,86941058,2023-02-01,-92.85,1011.76
6244,86941058,2023-02-03,-21.03,990.73
1782,86941058,2023-02-05,1233.7,2224.4300000000003
2400,86941058,2023-02-07,110.05,2334.48
6647,86941058,2023-02-07,-53.6,2280.88
8481,86941058,2023-02-07,-64.02,2216.86
6095,86941058,2023-02-08,-1800.8,416.0600000000002
448,86941058,2023-02-09,105.33,521.3900000000002
7858,86941058,2023-02-09,-85.04,436.35000000000014
1748,86941058,2023-02-09,-102.59,333.76000000000016
6110,86941058,2023-02-11,173.15,506.9100000000002
2397,86941058,2023-02-13,159.64,666.5500000000002
6924,86941058,2023-02-14,505.6,1172.15
7785,86941058,2023-02-14,-148.07,1024.0800000000002
2592,86995846,2023-01-31,,956.26
3897,86995846,2023-02-04,-50.69,905.5699999999999
7346,86995846,2023-02-06,132.29,1037.86
618,86995846,2023-02-07,96.08,1133.94
5915,86995846,2023-02-09,45.7,1179.6399999999999
435,86995846,2023-02-09,-88.73,1090.91
275,86995846,2023-02-10,-126.15,964.76
2593,87010556,2023-01-31,,175.33
3544,87010556,2023-02-03,41.04,216.37
995,87010556,2023-02-07,112.22,328.59000000000003
7395,87010556,2023-02-07,105.53,434.12
5356,87010556,2023-02-11,90.36,524.48
3221,87010556,2023-02-12,99.56,624.04
6353,87010556,2023-02-13,-0.58,623.46
2594,87101816,2023-01-31,,862.87
7247,87101816,2023-02-01,-150.96,711.91
854,87101816,2023-02-04,-567.7,144.20999999999992
826,87101816,2023-02-07,164.85,309.05999999999995
4380,87101816,2023-02-08,7.94,316.99999999999994
5892,87101816,2023-02-10,182.87,499.8699999999999
6148,87101816,2023-02-11,77.75,577.6199999999999
116,87101816,2023-02-14,-81.74,495.87999999999994
5280,87101816,2023-02-14,-99.95,395.92999999999995
2595,87121270,2023-01-31,,122.09
4190,87121270,2023-02-04,-86.9,35.19
8653,87121270,2023-02-04,-94.72,-59.53
2187,87121270,2023-02-08,-175.97,-235.5
6838,87121270,2023-02-12,-109.65,-345.15
2596,87133080,2023-01-31,,947.42
6064,87133080,2023-02-05,-197.22,750.1999999999999
4082,87133080,2023-02-07,-1151.1,-400.9
6087,87133080,2023-02-08,-85.98,-486.88
3757,87133080,2023-02-10,127.34,-359.53999999999996
5678,87133080,2023-02-14,-67.47,-427.01
2597,87171530,2023-01-31,,705.41
6665,87171530,2023-02-01,-102.91,602.5
4164,87171530,2023-02-03,107.8,710.3
381,87171530,2023-02-05,-55.38,654.92
3666,87171530,2023-02-06,21.12,676.04
4684,87171530,2023-02-06,-784.3,-108.25999999999999
5571,87171530,2023-02-10,112.36,4.1000000000000085
980,87171530,2023-02-10,-39.48,-35.37999999999999
2447,87171530,2023-02-11,182.68,147.3
3247,87171530,2023-02-13,-36.43,110.87
449,87171530,2023-02-14,-113.78,-2.9099999999999966
2598,87179572,2023-01-31,,527.23
4979,87179572,2023-02-01,1292.5,1819.73
6270,87179572,2023-02-02,-107.47,1712.26
768,87179572,2023-02-03,74.5,1786.76
6005,87179572,2023-02-04,185.63,1972.39
4276,87179572,2023-02-05,-69.93,1902.46
4488,87179572,2023-02-07,-43.28,1859.18
269,87179572,2023-02-07,-109.43,1749.75
3463,87179572,2023-02-13,223.88,1973.63
2490,87179572,2023-02-13,91.43,2065.06
2599,87195449,2023-01-31,,493.58
1525,87195449,2023-02-09,126.81,620.39
6099,87195449,2023-02-10,110.9,731.29
3235,87195449,2023-02-13,-445.8,285.49
2600,87231063,2023-01-31,,305.69
5127,87231063,2023-02-04,83.95,389.64
7039,87231063,2023-02-07,-96.86,292.78
2601,87261089,2023-01-31,,613.62
7384,87261089,2023-02-13,152.6,766.22
2602,87261106,2023-01-31,,203.16
857,87261106,2023-02-06,-57.88,145.28
1466,87261106,2023-02-08,-24.94,120.33999999999999
2236,87261106,2023-02-09,187.78,308.12
3092,87261106,2023-02-09,-55.42,252.7
1525,87261106,2023-02-09,-126.81,125.88999999999997
719,87261106,2023-02-11,-149.28,-23.39000000000003
4729,87261106,2023-02-13,-18.04,-41.43000000000003
2603,87276000,2023-01-31,,826.21
3800,87276000,2023-02-01,179.6,1005.8100000000001
8264,87276000,2023-02-01,119.88,1125.69
852,87276000,2023-02-05,-74.37,1051.32
5293,87276000,2023-02-09,46.3,1097.6200000000001
5840,87276000,2023-02-10,-40.2,1057.42
4697,87276000,2023-02-13,90.4,1147.82
2604,87297577,2023-01-31,,351.06
472,87297577,2023-02-03,109.74,460.8
5833,87297577,2023-02-03,-101.75,359.05
8155,87297577,2023-02-04,-155.57,203.48000000000002
8627,87297577,2023-02-05,117.54,321.02000000000004
1834,87297577,2023-02-14,-49.4,271.62
2605,87325576,2023-01-31,,354.27
6602,87325576,2023-02-01,-185.45,168.82
129,87325576,2023-02-03,134.13,302.95
1483,87325576,2023-02-07,-79.32,223.63
5853,87325576,2023-02-10,-196.24,27.389999999999986
3348,87325576,2023-02-11,116.37,143.76
1308,87325576,2023-02-13,2.26,146.01999999999998
2606,87356428,2023-01-31,,705.05
8329,87356428,2023-02-06,42.19,747.24
7054,87356428,2023-02-08,79.16,826.4
7308,87356428,2023-02-10,213.8,1040.2
4116,87356428,2023-02-10,101.74,1141.94
2607,87373821,2023-01-31,,945.0
5757,87373821,2023-02-01,-69.91,875.09
13,87373821,2023-02-01,-163.82,711.27
4585,87373821,2023-02-03,27.88,739.15
6372,87373821,2023-02-06,999.1,1738.25
5331,87373821,2023-02-07,-54.28,1683.97
3165,87373821,2023-02-08,133.65,1817.62
2783,87373821,2023-02-08,-111.05,1706.57
3539,87373821,2023-02-14,175.48,1882.05
2608,87433733,2023-01-31,,34.77
4241,87433733,2023-02-02,104.72,139.49
3365,87433733,2023-02-02,-139.25,0.2400000000000091
8440,87433733,2023-02-05,-71.17,-70.92999999999999
4505,87433733,2023-02-06,-83.76,-154.69
3040,87433733,2023-02-08,-158.67,-313.36
6803,87433733,2023-02-09,239.1,-74.25999999999999
7412,87433733,2023-02-12,-139.75,-214.01
2397,87433733,2023-02-13,-159.64,-373.65
2609,87456121,2023-01-31,,257.5
5054,87456121,2023-02-01,76.69,334.19
2784,87456121,2023-02-06,-29.95,304.24
6817,87456121,2023-02-09,-58.71,245.53
220,87456121,2023-02-09,-82.14,163.39
2709,87456121,2023-02-10,62.31,225.7
7111,87456121,2023-02-11,51.18,276.88
2610,87504607,2023-01-31,,605.63
1383,87504607,2023-02-01,86.21,691.84
1101,87504607,2023-02-03,91.97,783.81
792,87504607,2023-02-11,142.53,926.3399999999999
673,87504607,2023-02-11,-83.49,842.85
4551,87504607,2023-02-13,162.05,1004.9
2611,87533652,2023-01-31,,156.61
5838,87533652,2023-02-03,22.57,179.18
1757,87533652,2023-02-06,-176.4,2.780000000000001
808,87533652,2023-02-07,199.97,202.75
8336,87533652,2023-02-07,-67.88,134.87
4580,87533652,2023-02-10,153.19,288.06
7536,87533652,2023-02-14,81.26,369.32
2612,87543952,2023-01-31,,14.85
6750,87543952,2023-02-07,-93.88,-79.03
3073,87543952,2023-02-08,77.04,-1.9899999999999949
7362,87543952,2023-02-09,125.94,123.95
5941,87543952,2023-02-11,112.24,236.19
2613,87556975,2023-01-31,,657.17
8320,87556975,2023-02-02,-57.04,600.13
2486,87556975,2023-02-05,-200.2,399.92999999999995
4736,87556975,2023-02-06,-173.27,226.65999999999997
895,87556975,2023-02-07,1372.5,1599.1599999999999
4801,87556975,2023-02-13,99.78,1698.9399999999998
1246,87556975,2023-02-14,1469.3,3168.24
2614,87726203,2023-01-31,,55.92
76,87726203,2023-02-06,152.16,208.07999999999998
7135,87726203,2023-02-07,-21.61,186.47000000000003
7714,87726203,2023-02-09,-124.33,62.140000000000015
6226,87726203,2023-02-10,-57.63,4.510000000000012
6418,87726203,2023-02-12,-28.57,-24.059999999999988
2615,87735660,2023-01-31,,990.25
7562,87735660,2023-02-03,28.0,1018.25
1969,87735660,2023-02-04,-82.87,935.38
5781,87735660,2023-02-11,-64.84,870.54
7815,87735660,2023-02-11,-138.99,731.55
6769,87735660,2023-02-12,101.83,833.38
3473,87735660,2023-02-13,152.92,986.3
2885,87735660,2023-02-13,79.81,1066.11
2616,87746071,2023-01-31,,215.91
6670,87746071,2023-02-01,-106.3,109.61
7021,87746071,2023-02-06,135.04,244.64999999999998
7687,87746071,2023-02-14,259.3,503.95000000000005
2617,87801896,2023-01-31,,181.56
2470,87801896,2023-02-03,1632.0,1813.56
3245,87801896,2023-02-05,118.55,1932.11
6003,87801896,2023-02-06,108.14,2040.25
922,87801896,2023-02-12,-171.12,1869.1299999999999
2618,87807990,2023-01-31,,317.4
6932,87807990,2023-02-01,72.79,390.19
3441,87807990,2023-02-02,-97.47,292.71999999999997
1051,87807990,2023-02-04,957.5,1250.22
8187,87807990,2023-02-06,178.88,1429.1
7766,87807990,2023-02-08,57.32,1486.42
1486,87807990,2023-02-10,38.88,1525.3
2619,87817645,2023-01-31,,983.36
6822,87817645,2023-02-01,181.11,1164.47
4569,87817645,2023-02-03,-17.26,1147.21
2203,87817645,2023-02-04,64.93,1212.14
4332,87817645,2023-02-05,-114.48,1097.66
3533,87817645,2023-02-05,-141.51,956.1500000000001
8171,87817645,2023-02-06,-660.3,295.85000000000014
396,87817645,2023-02-08,-103.89,191.96000000000015
2683,87817645,2023-02-09,-155.76,36.20000000000016
4369,87817645,2023-02-10,616.1,652.3000000000002
1464,87817645,2023-02-10,80.91,733.2100000000002
2620,87827496,2023-01-31,,935.66
5827,87827496,2023-02-02,-103.39,832.27
2346,87827496,2023-02-05,-107.8,724.47
2516,87827496,2023-02-13,72.65,797.12
2621,87836000,2023-01-31,,937.46
2436,87836000,2023-02-07,-115.15,822.3100000000001
7974,87836000,2023-02-13,-93.97,728.34
2622,87876065,2023-01-31,,627.15
1738,87876065,2023-02-01,1821.6,2448.75
8598,87876065,2023-02-01,123.29,2572.04
1114,87876065,2023-02-11,140.15,2712.19
3667,87876065,2023-02-11,-75.65,2636.54
1280,87876065,2023-02-12,-84.4,2552.14
236,87876065,2023-02-14,-64.45,2487.69
2623,87906438,2023-01-31,,196.99
2097,87906438,2023-02-05,-144.67,52.32000000000002
1725,87906438,2023-02-07,0.83,53.15000000000002
2695,87906438,2023-02-09,136.48,189.63
1516,87906438,2023-02-10,174.95,364.58000000000004
5840,87906438,2023-02-10,40.2,404.78000000000003
6790,87906438,2023-02-10,-75.98,328.8
7158,87906438,2023-02-12,159.82,488.62
8109,87906438,2023-02-12,-99.99,388.63
2624,87911550,2023-01-31,,149.29
2417,87911550,2023-02-02,-91.54,57.749999999999986
6267,87911550,2023-02-04,74.75,132.5
7519,87911550,2023-02-11,-72.76,59.73999999999998
4735,87911550,2023-02-13,24.32,84.05999999999997
2625,87913244,2023-01-31,,730.48
5120,87913244,2023-02-01,136.95,867.4300000000001
1109,87913244,2023-02-02,-237.02,630.41
6147,87913244,2023-02-06,-123.31,507.1
6180,87913244,2023-02-08,104.55,611.65
2088,87913244,2023-02-08,-54.56,557.09
1603,87913244,2023-02-10,-210.07,347.02
7676,87913244,2023-02-11,-139.07,207.95
1570,87913244,2023-02-12,-131.58,76.36999999999998
2626,87967388,2023-01-31,,682.7
4745,87967388,2023-02-03,-114.6,568.1
6866,87967388,2023-02-05,135.04,703.1400000000001
3590,87967388,2023-02-05,77.0,780.1400000000001
2599,87967388,2023-02-10,932.3,1712.44
4426,87967388,2023-02-12,-882.7,829.74
6238,87967388,2023-02-13,1393.1,2222.84
6966,87967388,2023-02-13,89.23,2312.0699999999997
1662,87967388,2023-02-13,-2359.1,-47.0300000000002
2863,87967388,2023-02-14,-137.37,-184.4000000000002
2627,88033693,2023-01-31,,917.7
6574,88033693,2023-02-06,-114.15,803.5500000000001
917,88033693,2023-02-07,19.21,822.76
7410,88033693,2023-02-07,-109.39,713.37
1325,88033693,2023-02-09,81.22,794.59
1652,88033693,2023-02-12,-19.56,775.0300000000001
2628,88040274,2023-01-31,,550.79
5637,88040274,2023-02-03,-89.14,461.65
7093,88040274,2023-02-05,158.27,619.92
328,88040274,2023-02-06,1743.5,2363.42
1621,88040274,2023-02-14,76.31,2439.73
2629,88074391,2023-01-31,,851.54
7512,88074391,2023-02-02,-111.21,740.3299999999999
2723,88074391,2023-02-05,-127.52,612.81
710,88074391,2023-02-06,115.19,728.0
1245,88074391,2023-02-09,-83.26,644.74
6693,88074391,2023-02-10,-121.44,523.3
2630,88106566,2023-01-31,,477.78
7576,88106566,2023-02-02,211.27,689.05
2578,88106566,2023-02-02,93.52,782.5699999999999
7954,88106566,2023-02-03,-221.11,561.46
881,88106566,2023-02-05,12.23,573.6899999999999
5629,88106566,2023-02-09,140.26,713.9499999999999
1973,88106566,2023-02-14,-134.69,579.26
2631,88160468,2023-01-31,,640.07
604,88160468,2023-02-01,-84.03,556.0400000000001
8554,88160468,2023-02-01,-1041.9,-485.86
735,88160468,2023-02-04,127.8,-358.06
6627,88160468,2023-02-07,46.31,-311.75
4225,88160468,2023-02-08,-103.69,-415.44
2721,88160468,2023-02-09,142.59,-272.85
3515,88160468,2023-02-12,-143.47,-416.32000000000005
2432,88160468,2023-02-13,44.17,-372.15000000000003
366,88160468,2023-02-14,-151.02,-523.1700000000001
2632,88229109,2023-01-31,,730.76
6080,88229109,2023-02-05,-65.1,665.66
8391,88229109,2023-02-10,182.81,848.47
2620,88229109,2023-02-12,140.82,989.29
6321,88229109,2023-02-12,76.6,1065.8899999999999
7294,88229109,2023-02-12,67.02,1132.91
3281,88229109,2023-02-14,115.32,1248.23
2633,88235115,2023-01-31,,150.58
3917,88235115,2023-02-02,-51.28,99.30000000000001
2617,88235115,2023-02-02,-137.17,-37.869999999999976
270,88235115,2023-02-05,167.85,129.98000000000002
2448,88235115,2023-02-07,-74.11,55.87000000000002
3642,88235115,2023-02-08,89.97,145.84000000000003
7518,88235115,2023-02-08,-118.94,26.90000000000002
104,88235115,2023-02-09,98.98,125.88000000000002
6478,88235115,2023-02-12,154.56,280.44000000000005
4767,88235115,2023-02-12,-797.7,-517.26
8000,88235115,2023-02-14,-643.9,-1161.1599999999999
2634,88285378,2023-01-31,,473.79
575,88285378,2023-02-03,94.79,568.58
1514,88285378,2023-02-06,887.9,1456.48
7913,88285378,2023-02-08,180.39,1636.87
8587,88285378,2023-02-09,-230.97,1405.9
6955,88285378,2023-02-14,-104.53,1301.37
2635,88293767,2023-01-31,,487.22
2467,88293767,2023-02-04,-102.71,384.51000000000005
5131,88293767,2023-02-07,-82.79,301.72
96,88293767,2023-02-09,-65.38,236.34000000000003
2636,88306714,2023-01-31,,808.0
5686,88306714,2023-02-08,36.71,844.71
490,88306714,2023-02-13,-114.54,730.17
4217,88306714,2023-02-14,-112.72,617.45
2637,88343796,2023-01-31,,338.0
6894,88343796,2023-02-02,-224.12,113.88
7784,88343796,2023-02-08,-30.57,83.31
6463,88343796,2023-02-11,66.07,149.38
2638,88381437,2023-01-31,,472.65
7910,88381437,2023-02-04,-100.94,371.71
7217,88381437,2023-02-05,-65.54,306.16999999999996
8166,88381437,2023-02-05,-74.21,231.95999999999998
2639,88399132,2023-01-31,,751.13
193,88399132,2023-02-02,56.02,807.15
5597,88399132,2023-02-03,-83.69,723.46
8515,88399132,2023-02-08,195.95,919.41
911,88399132,2023-02-10,151.6,1071.01
7243,88399132,2023-02-10,69.69,1140.7
853,88399132,2023-02-11,32.0,1172.7
3321,88399132,2023-02-14,-159.09,1013.61
2640,88436283,2023-01-31,,689.71
4357,88436283,2023-02-09,-233.91,455.80000000000007
2641,88466448,2023-01-31,,920.61
4202,88466448,2023-02-03,-640.4,280.21000000000004
3219,88466448,2023-02-03,-1453.5,-1173.29
5538,88466448,2023-02-04,131.11,-1042.1799999999998
642,88466448,2023-02-04,-79.47,-1121.6499999999999
3614,88466448,2023-02-05,627.1,-494.54999999999995
4101,88466448,2023-02-05,-51.26,-545.81
384,88466448,2023-02-07,-143.04,-688.8499999999999
5682,88466448,2023-02-08,-58.82,-747.67
736,88466448,2023-02-09,11.47,-736.1999999999999
8547,88466448,2023-02-10,-121.97,-858.17
3002,88466448,2023-02-12,112.58,-745.5899999999999
2642,88476961,2023-01-31,,524.76
3364,88476961,2023-02-01,75.85,600.61
8577,88476961,2023-02-04,86.15,686.76
4399,88476961,2023-02-05,138.66,825.42
8231,88476961,2023-02-07,75.95,901.37
1285,88476961,2023-02-10,-55.13,846.24
2165,88476961,2023-02-11,-133.78,712.46
2643,88482062,2023-01-31,,149.31
3582,88482062,2023-02-01,-321.2,-171.89
6958,88482062,2023-02-07,130.23,-41.66
7433,88482062,2023-02-07,85.25,43.59
4433,88482062,2023-02-08,-1096.2,-1052.6100000000001
583,88482062,2023-02-10,-87.07,-1139.68
2644,88489173,2023-01-31,,476.26
721,88489173,2023-02-01,169.18,645.44
4367,88489173,2023-02-02,-115.09,530.35
4442,88489173,2023-02-08,-0.47,529.88
2707,88489173,2023-02-09,-145.71,384.16999999999996
1998,88489173,2023-02-13,-133.97,250.2
2645,88538200,2023-01-31,,518.77
1204,88538200,2023-02-02,-83.89,434.88
6581,88538200,2023-02-06,40.91,475.78999999999996
4999,88538200,2023-02-10,1394.1,1869.8899999999999
3282,88538200,2023-02-12,1077.3,2947.1899999999996
1334,88538200,2023-02-12,127.83,3075.02
5736,88538200,2023-02-13,76.09,3151.1099999999997
2646,88551691,2023-01-31,,979.24
6881,88551691,2023-02-01,89.41,1068.65
6096,88551691,2023-02-05,1136.4,2205.05
3444,88551691,2023-02-07,-75.03,2130.02
5037,88551691,2023-02-08,-118.77,2011.2500000000002
2647,88558016,2023-01-31,,156.64
7824,88558016,2023-02-04,84.53,241.17
790,88558016,2023-02-09,-37.65,203.51999999999998
3301,88558016,2023-02-12,84.83,288.35
473,88558016,2023-02-12,76.51,364.86
8447,88558016,2023-02-14,76.93,441.79
2648,88568543,2023-01-31,,472.83
5953,88568543,2023-02-01,-168.34,304.49
4970,88568543,2023-02-02,-86.62,217.86999999999998
3531,88568543,2023-02-02,-723.0,-505.13
7752,88568543,2023-02-03,-102.35,-607.48
2533,88568543,2023-02-07,126.03,-481.45
3758,88568543,2023-02-10,-65.54,-546.99
3039,88568543,2023-02-11,1215.8,668.81
6542,88568543,2023-02-13,26.24,695.05
2413,88568543,2023-02-14,-17.11,677.9399999999999
2649,88570753,2023-01-31,,62.48
7011,88570753,2023-02-07,1440.9,1503.38
4454,88570753,2023-02-07,-99.56,1403.8200000000002
5025,88570753,2023-02-09,-127.53,1276.2900000000002
423,88570753,2023-02-12,-90.66,1185.63
2282,88570753,2023-02-14,89.9,1275.5300000000002
2650,88580402,2023-01-31,,118.18
2061,88580402,2023-02-01,104.47,222.65
8037,88580402,2023-02-03,59.01,281.66
5064,88580402,2023-02-06,143.3,424.96000000000004
2146,88580402,2023-02-09,-83.99,340.97
6621,88580402,2023-02-14,-175.7,165.27000000000004
2651,88646863,2023-01-31,,250.52
3134,88646863,2023-02-03,35.32,285.84000000000003
8029,88646863,2023-02-08,947.8,1233.6399999999999
2652,88657589,2023-01-31,,712.85
5128,88657589,2023-02-03,-97.96,614.89
8653,88657589,2023-02-04,94.72,709.61
2200,88657589,2023-02-05,98.03,807.64
7965,88657589,2023-02-07,50.49,858.13
2786,88657589,2023-02-09,163.99,1022.12
3479,88657589,2023-02-09,11.2,1033.32
212,88657589,2023-02-10,-129.33,903.99
1576,88657589,2023-02-13,26.71,930.7
6945,88657589,2023-02-14,77.4,1008.1
2653,88676459,2023-01-31,,285.95
1643,88676459,2023-02-01,94.56,380.51
555,88676459,2023-02-03,-493.5,-112.99000000000001
4715,88676459,2023-02-09,-113.5,-226.49
1391,88676459,2023-02-12,-183.53,-410.02
1010,88676459,2023-02-14,-42.94,-452.96000000000004
2654,88681540,2023-01-31,,531.01
574,88681540,2023-02-01,122.46,653.47
8296,88681540,2023-02-01,-158.59,494.88
5576,88681540,2023-02-03,-11.36,483.52
45,88681540,2023-02-08,-96.66,386.86
3866,88681540,2023-02-13,144.82,531.6800000000001
2655,88710457,2023-01-31,,818.28
5670,88710457,2023-02-03,-49.28,769.0
5910,88710457,2023-02-03,-70.8,698.1999999999999
1630,88710457,2023-02-09,156.03,854.23
4416,88710457,2023-02-11,-128.07,726.16
5960,88710457,2023-02-14,-137.37,588.79
2656,88732093,2023-01-31,,57.56
6345,88732093,2023-02-01,81.49,139.05
8310,88732093,2023-02-01,-132.52,6.529999999999973
5882,88732093,2023-02-06,1502.6,1509.1299999999999
4552,88732093,2023-02-06,878.3,2387.43
5624,88732093,2023-02-08,-88.5,2298.93
4579,88732093,2023-02-12,-164.29,2134.64
2657,88824263,2023-01-31,,295.9
1552,88824263,2023-02-01,-28.95,266.95
278,88824263,2023-02-02,-38.78,228.16999999999996
2161,88824263,2023-02-09,-132.11,96.05999999999995
2047,88824263,2023-02-12,133.13,229.18999999999994
6165,88824263,2023-02-12,31.2,260.38999999999993
2658,88831746,2023-01-31,,565.27
3190,88831746,2023-02-03,128.25,693.52
4323,88831746,2023-02-04,-101.49,592.03
2971,88831746,2023-02-07,64.68,656.71
1914,88831746,2023-02-08,-179.3,477.40999999999997
1125,88831746,2023-02-10,204.71,682.12
2659,88834465,2023-01-31,,18.3
967,88834465,2023-02-05,-87.06,-68.76
837,88834465,2023-02-06,26.04,-42.720000000000006
7854,88834465,2023-02-10,-400.1,-442.82000000000005
2660,88837750,2023-01-31,,269.14
5095,88837750,2023-02-03,116.84,385.98
1613,88837750,2023-02-04,111.74,497.71999999999997
3624,88837750,2023-02-05,-61.25,436.46999999999997
511,88837750,2023-02-06,-127.59,308.88
1303,88837750,2023-02-07,-26.09,282.78999999999996
358,88837750,2023-02-09,-38.34,244.45
6242,88837750,2023-02-10,187.69,432.14
858,88837750,2023-02-10,-149.53,282.61
6081,88837750,2023-02-12,76.82,359.42999999999995
2661,88857879,2023-01-31,,601.01
1591,88857879,2023-02-03,-16.43,584.58
4974,88857879,2023-02-08,86.36,670.94
6772,88857879,2023-02-11,181.25,852.19
1595,88857879,2023-02-11,-85.41,766.78
2662,88926132,2023-01-31,,275.1
5341,88926132,2023-02-02,12.65,287.75
6401,88926132,2023-02-04,1618.2,1905.95
5540,88926132,2023-02-04,1031.4,2937.3500000000004
3471,88926132,2023-02-04,-381.6,2555.75
2971,88926132,2023-02-07,-64.68,2491.07
7533,88926132,2023-02-08,113.38,2604.4500000000003
1695,88926132,2023-02-10,-75.67,2528.78
1231,88926132,2023-02-13,152.58,2681.36
7762,88926132,2023-02-13,-116.52,2564.84
5230,88926132,2023-02-13,-2264.3,300.53999999999996
6621,88926132,2023-02-14,175.7,476.23999999999995
2663,88933315,2023-01-31,,289.79
3005,88933315,2023-02-01,115.4,405.19000000000005
7114,88933315,2023-02-01,101.08,506.27000000000004
2221,88933315,2023-02-06,-114.74,391.53000000000003
134,88933315,2023-02-09,108.34,499.87
8630,88933315,2023-02-09,-82.08,417.79
3851,88933315,2023-02-11,-150.26,267.53000000000003
4727,88933315,2023-02-11,-1828.9,-1561.3700000000001
2240,88933315,2023-02-13,-61.19,-1622.5600000000002
8091,88933315,2023-02-14,87.23,-1535.3300000000002
8600,88933315,2023-02-14,-157.43,-1692.7600000000002
2664,88968006,2023-01-31,,952.66
8320,88968006,2023-02-02,57.04,1009.6999999999999
3129,88968006,2023-02-04,-89.95,919.75
2259,88968006,2023-02-04,-129.7,790.05
1321,88968006,2023-02-08,176.94,966.99
2665,88974311,2023-01-31,,501.47
2090,88974311,2023-02-01,-152.59,348.88
2750,88974311,2023-02-02,-153.2,195.68000000000004
2666,89065134,2023-01-31,,447.32
2427,89065134,2023-02-02,153.04,600.36
2578,89065134,2023-02-02,-93.52,506.84
5648,89065134,2023-02-02,-111.91,394.93
3400,89065134,2023-02-02,-119.89,275.03999999999996
7232,89065134,2023-02-14,-120.46,154.57999999999998
2667,89088715,2023-01-31,,336.6
8165,89088715,2023-02-02,1180.2,1516.8000000000002
8253,89088715,2023-02-03,36.14,1552.94
2900,89088715,2023-02-04,104.24,1657.1799999999998
4582,89088715,2023-02-07,-65.96,1591.22
1148,89088715,2023-02-10,-63.35,1527.87
8203,89088715,2023-02-11,79.06,1606.9299999999998
6397,89088715,2023-02-12,77.54,1684.47
5007,89088715,2023-02-14,117.34,1801.81
2668,89117536,2023-01-31,,123.22
2389,89117536,2023-02-02,150.57,273.78999999999996
5286,89117536,2023-02-02,74.5,348.28999999999996
1708,89117536,2023-02-06,27.56,375.84999999999997
2669,89194917,2023-01-31,,332.56
5276,89194917,2023-02-08,61.4,393.96
8274,89194917,2023-02-10,-99.66,294.3
2535,89194917,2023-02-12,-122.32,171.98000000000002
6235,89194917,2023-02-13,-75.77,96.21000000000002
2670,89223056,2023-01-31,,139.98
7955,89223056,2023-02-08,149.64,289.62
3882,89223056,2023-02-09,-39.08,250.53999999999996
7338,89223056,2023-02-09,-98.06,152.47999999999996
4866,89223056,2023-02-09,-141.4,11.079999999999984
6181,89223056,2023-02-11,48.78,59.859999999999985
5705,89223056,2023-02-14,1660.2,1720.06
2671,89225677,2023-01-31,,660.05
5226,89225677,2023-02-04,-52.76,607.29
6407,89225677,2023-02-05,-80.23,527.06
5733,89225677,2023-02-06,24.38,551.4399999999999
7016,89225677,2023-02-06,-141.06,410.37999999999994
544,89225677,2023-02-07,1107.6,1517.9799999999998
7279,89225677,2023-02-09,-123.84,1394.1399999999999
1102,89225677,2023-02-11,90.85,1484.9899999999998
3124,89225677,2023-02-12,108.0,1592.9899999999998
7636,89225677,2023-02-12,-104.9,1488.0899999999997
2672,89244577,2023-01-31,,706.67
8402,89244577,2023-02-02,555.5,1262.17
3901,89244577,2023-02-05,134.55,1396.72
2588,89244577,2023-02-06,-50.86,1345.86
962,89244577,2023-02-06,-117.46,1228.4
2173,89244577,2023-02-08,-96.58,1131.82
7119,89244577,2023-02-09,103.8,1235.62
6653,89244577,2023-02-11,-122.21,1113.41
8637,89244577,2023-02-12,55.85,1169.26
2673,89309725,2023-01-31,,858.68
6513,89309725,2023-02-02,-124.23,734.4499999999999
3219,89309725,2023-02-03,1453.5,2187.95
4011,89309725,2023-02-04,-135.89,2052.06
7047,89309725,2023-02-07,121.91,2173.97
5366,89309725,2023-02-08,63.8,2237.77
336,89309725,2023-02-09,45.07,2282.8399999999997
5140,89309725,2023-02-12,146.24,2429.08
2674,89318229,2023-01-31,,675.08
2718,89318229,2023-02-02,-72.72,602.36
2030,89318229,2023-02-02,-98.51,503.85
1040,89318229,2023-02-07,209.73,713.58
2935,89318229,2023-02-08,132.6,846.1800000000001
4222,89318229,2023-02-09,46.37,892.5500000000001
683,89318229,2023-02-14,-85.66,806.8900000000001
2675,89353946,2023-01-31,,809.48
7085,89353946,2023-02-05,142.19,951.6700000000001
6900,89353946,2023-02-07,117.45,1069.1200000000001
5027,89353946,2023-02-07,-1.03,1068.09
3379,89353946,2023-02-08,-94.96,973.13
5567,89353946,2023-02-11,-161.25,811.88
2676,89369216,2023-01-31,,404.56
2947,89369216,2023-02-01,-99.09,305.47
3213,89369216,2023-02-02,57.51,362.98
1220,89369216,2023-02-06,-87.82,275.15999999999997
318,89369216,2023-02-07,93.19,368.35
4588,89369216,2023-02-07,-141.99,226.35999999999999
2365,89369216,2023-02-08,80.72,307.08
6731,89369216,2023-02-10,100.23,407.31
6705,89369216,2023-02-10,61.16,468.46999999999997
1460,89369216,2023-02-10,-107.56,360.90999999999997
3941,89369216,2023-02-11,1944.9,2305.81
2677,89406032,2023-01-31,,453.31
4255,89406032,2023-02-05,-123.79,329.52
4706,89406032,2023-02-05,-176.37,153.14999999999998
6032,89406032,2023-02-11,-141.71,11.43999999999997
2678,89407337,2023-01-31,,211.2
2679,89438779,2023-01-31,,347.92
1156,89438779,2023-02-01,-104.57,243.35000000000002
4203,89438779,2023-02-02,-21.71,221.64000000000001
8182,89438779,2023-02-02,-205.22,16.420000000000016
5033,89438779,2023-02-07,140.14,156.56
5240,89438779,2023-02-07,125.71,282.27
7789,89438779,2023-02-07,-113.6,168.67000000000002
8476,89438779,2023-02-12,198.2,366.87
4570,89438779,2023-02-12,-69.44,297.43
611,89438779,2023-02-13,1062.5,1359.93
2680,89471153,2023-01-31,,52.29
6105,89471153,2023-02-12,153.64,205.92999999999998
197,89471153,2023-02-13,81.41,287.34
5653,89471153,2023-02-13,-114.78,172.55999999999997
8352,89471153,2023-02-14,-68.12,104.43999999999997
2681,89497773,2023-01-31,,637.02
64,89497773,2023-02-02,131.02,768.04
8597,89497773,2023-02-03,-94.57,673.47
6640,89497773,2023-02-04,-100.39,573.08
5684,89497773,2023-02-06,-55.52,517.56
206,89497773,2023-02-07,141.01,658.5699999999999
6232,89497773,2023-02-07,50.93,709.5
6224,89497773,2023-02-09,123.35,832.85
8223,89497773,2023-02-12,123.38,956.23
2028,89497773,2023-02-14,-172.96,783.27
2682,89503991,2023-01-31,,204.52
1320,89503991,2023-02-02,95.08,299.6
215,89503991,2023-02-09,72.3,371.9
131,89503991,2023-02-12,1030.7,1402.6
2683,89608054,2023-01-31,,495.15
2419,89608054,2023-02-04,80.37,575.52
7535,89608054,2023-02-11,92.62,668.14
7073,89608054,2023-02-12,190.17,858.31
802,89608054,2023-02-12,-86.73,771.5799999999999
691,89608054,2023-02-14,-116.09,655.49
2684,89629293,2023-01-31,,292.31
6700,89629293,2023-02-11,-124.56,167.75
6070,89629293,2023-02-14,-191.52,-23.77000000000001
2685,89632856,2023-01-31,,557.83
8311,89632856,2023-02-02,-126.16,431.6700000000001
4351,89632856,2023-02-03,-119.95,311.72
2468,89632856,2023-02-06,50.84,362.56000000000006
1376,89632856,2023-02-08,-1908.7,-1546.1399999999999
2686,89645445,2023-01-31,,287.29
7469,89645445,2023-02-03,-112.15,175.14000000000001
1979,89645445,2023-02-09,1726.4,1901.5400000000002
2687,89650416,2023-01-31,,146.17
438,89650416,2023-02-01,-205.89,-59.72
3649,89650416,2023-02-04,-127.68,-187.4
2349,89650416,2023-02-10,71.44,-115.96000000000001
6575,89650416,2023-02-12,55.39,-60.57000000000001
6437,89650416,2023-02-12,-120.12,-180.69
2688,89689059,2023-01-31,,906.88
7618,89689059,2023-02-02,-173.89,732.99
6835,89689059,2023-02-03,-99.14,633.85
1484,89689059,2023-02-04,-76.44,557.41
581,89689059,2023-02-06,100.18,657.59
6548,89689059,2023-02-06,-69.68,587.91
942,89689059,2023-02-09,-1576.6,-988.6899999999999
5961,89689059,2023-02-14,103.89,-884.8
2689,89697097,2023-01-31,,449.71
7198,89697097,2023-02-02,128.36,578.0699999999999
842,89697097,2023-02-08,-1737.4,-1159.3300000000002
5763,89697097,2023-02-13,44.38,-1114.95
2121,89697097,2023-02-14,100.83,-1014.1200000000001
2690,89720252,2023-01-31,,672.88
1049,89720252,2023-02-03,101.53,774.41
608,89720252,2023-02-03,91.02,865.43
5610,89720252,2023-02-11,-55.02,810.41
556,89720252,2023-02-12,192.75,1003.16
8145,89720252,2023-02-13,182.14,1185.3
4095,89720252,2023-02-14,40.13,1225.43
2691,89761152,2023-01-31,,923.01
4245,89761152,2023-02-05,-166.03,756.98
7300,89761152,2023-02-06,-44.43,712.55
3979,89761152,2023-02-09,-1365.7,-653.1500000000001
6503,89761152,2023-02-11,-67.06,-720.21
4088,89761152,2023-02-11,-144.17,-864.3800000000001
2962,89761152,2023-02-12,89.43,-774.95
2383,89761152,2023-02-12,85.04,-689.9100000000001
7192,89761152,2023-02-14,-99.21,-789.1200000000001
2692,89905732,2023-01-31,,883.38
4300,89905732,2023-02-02,-1921.4,-1038.02
5796,89905732,2023-02-05,-128.78,-1166.8
7480,89905732,2023-02-05,-141.29,-1308.09
5304,89905732,2023-02-10,1147.5,-160.58999999999992
1843,89905732,2023-02-14,156.56,-4.029999999999916
2693,89916489,2023-01-31,,726.43
6451,89916489,2023-02-01,-174.0,552.43
5833,89916489,2023-02-03,101.75,654.18
6921,89916489,2023-02-06,-81.53,572.65
2694,89972805,2023-01-31,,456.55
7555,89972805,2023-02-08,35.2,491.75
2695,89983842,2023-01-31,,880.93
7776,89983842,2023-02-03,39.37,920.3
3686,89983842,2023-02-05,-80.89,839.41
5907,89983842,2023-02-07,60.4,899.81
7420,89983842,2023-02-11,145.45,1045.26
7112,89983842,2023-02-11,-129.67,915.5899999999999
2696,90019913,2023-01-31,,430.21
1198,90019913,2023-02-02,-69.49,360.71999999999997
6432,90019913,2023-02-08,-1693.2,-1332.48
2403,90019913,2023-02-09,156.34,-1176.14
6743,90019913,2023-02-10,72.21,-1103.93
3528,90019913,2023-02-12,-622.0,-1725.93
4269,90019913,2023-02-14,66.36,-1659.5700000000002
2697,90044139,2023-01-31,,568.28
7699,90044139,2023-02-04,-72.06,496.21999999999997
8179,90044139,2023-02-05,-94.48,401.73999999999995
8529,90044139,2023-02-13,-138.94,262.79999999999995
2698,90054505,2023-01-31,,586.12
1324,90054505,2023-02-01,-129.54,456.58000000000004
3303,90054505,2023-02-08,88.44,545.02
6897,90054505,2023-02-10,108.6,653.62
2699,90090889,2023-01-31,,836.85
7142,90090889,2023-02-04,-105.37,731.48
5909,90090889,2023-02-05,142.54,874.02
5858,90090889,2023-02-10,-1499.1,-625.0799999999999
1620,90090889,2023-02-12,-190.9,-815.9799999999999
5298,90090889,2023-02-14,-136.43,-952.41
2700,90118682,2023-01-31,,58.16
5983,90118682,2023-02-02,-129.77,-71.61000000000001
3737,90118682,2023-02-03,149.58,77.97
7924,90118682,2023-02-03,69.26,147.23000000000002
3336,90118682,2023-02-05,-62.8,84.43
4978,90118682,2023-02-07,105.38,189.81
6863,90118682,2023-02-08,143.57,333.38
3788,90118682,2023-02-09,-203.24,130.14
3119,90118682,2023-02-10,-123.94,6.199999999999989
1519,90118682,2023-02-13,-4.66,1.5399999999999885
2701,90168031,2023-01-31,,196.48
5031,90168031,2023-02-01,-170.35,26.129999999999995
7339,90168031,2023-02-04,157.26,183.39
6124,90168031,2023-02-09,-74.6,108.78999999999999
2403,90168031,2023-02-09,-156.34,-47.55000000000001
2702,90203948,2023-01-31,,689.49
5845,90203948,2023-02-03,133.06,822.55
779,90203948,2023-02-03,103.32,925.87
1200,90203948,2023-02-06,110.71,1036.58
2905,90203948,2023-02-08,1608.4,2644.98
3348,90203948,2023-02-11,-116.37,2528.61
2395,90203948,2023-02-13,63.14,2591.75
2703,90233696,2023-01-31,,628.02
4648,90233696,2023-02-01,73.14,701.16
6340,90233696,2023-02-02,-197.62,503.53999999999996
4504,90233696,2023-02-05,138.32,641.8599999999999
8629,90233696,2023-02-08,62.15,704.01
5066,90233696,2023-02-11,-40.3,663.7099999999999
4728,90233696,2023-02-13,-38.7,625.01
2704,90287712,2023-01-31,,316.17
5534,90287712,2023-02-01,105.25,421.42
8307,90287712,2023-02-03,-46.33,375.09000000000003
5197,90287712,2023-02-05,-108.31,266.78000000000003
2348,90287712,2023-02-08,115.99,382.77
4168,90287712,2023-02-10,-65.52,317.25
2058,90287712,2023-02-14,59.8,377.05
2705,90313378,2023-01-31,,743.7
3727,90313378,2023-02-03,622.9,1366.6
1119,90313378,2023-02-03,-99.93,1266.67
6710,90313378,2023-02-06,169.47,1436.14
6006,90313378,2023-02-07,57.59,1493.73
1627,90313378,2023-02-08,24.38,1518.1100000000001
6638,90313378,2023-02-11,-27.58,1490.53
251,90313378,2023-02-12,-103.79,1386.74
6551,90313378,2023-02-13,74.74,1461.48
2706,90336689,2023-01-31,,847.88
4223,90336689,2023-02-02,169.64,1017.52
497,90336689,2023-02-03,-120.88,896.64
983,90336689,2023-02-04,973.3,1869.94
5297,90336689,2023-02-07,-48.04,1821.8999999999999
6573,90336689,2023-02-09,-69.33,1752.57
1962,90336689,2023-02-11,-954.4,798.17
2707,90338454,2023-01-31,,748.63
4210,90338454,2023-02-01,-162.02,586.61
4396,90338454,2023-02-06,57.25,643.86
4798,90338454,2023-02-08,72.15,716.01
1987,90338454,2023-02-10,-105.08,610.93
2708,90349791,2023-01-31,,568.63
3712,90349791,2023-02-06,93.16,661.79
2709,90446254,2023-01-31,,930.0
7881,90446254,2023-02-03,-372.2,557.8
4361,90446254,2023-02-12,-100.81,456.99
4337,90446254,2023-02-13,-92.53,364.46000000000004
8415,90446254,2023-02-14,-50.66,313.8
2710,90480183,2023-01-31,,465.06
3151,90480183,2023-02-03,72.03,537.09
793,90480183,2023-02-03,-34.72,502.37
4839,90480183,2023-02-05,94.53,596.9
3938,90480183,2023-02-05,-167.77,429.13
1115,90480183,2023-02-06,-140.76,288.37
1908,90480183,2023-02-07,74.75,363.12
2711,90549616,2023-01-31,,37.69
2917,90549616,2023-02-01,-169.68,-131.99
8392,90549616,2023-02-01,-787.2,-919.19
3887,90549616,2023-02-04,27.43,-891.7600000000001
1920,90549616,2023-02-04,-99.93,-991.69
794,90549616,2023-02-06,-1338.0,-2329.69
5325,90549616,2023-02-07,-165.34,-2495.03
8243,90549616,2023-02-08,34.93,-2460.1
1444,90549616,2023-02-10,69.64,-2390.46
2047,90549616,2023-02-12,-133.13,-2523.59
5298,90549616,2023-02-14,136.43,-2387.16
2712,90589761,2023-01-31,,535.28
5514,90589761,2023-02-02,82.9,618.18
948,90589761,2023-02-05,108.08,726.26
1242,90589761,2023-02-06,118.48,844.74
2026,90589761,2023-02-11,-166.8,677.9399999999999
5789,90589761,2023-02-12,158.31,836.25
2713,90625637,2023-01-31,,477.46
3076,90625637,2023-02-03,-110.66,366.79999999999995
3222,90625637,2023-02-07,39.59,406.39
4711,90625637,2023-02-10,-90.09,316.29999999999995
7013,90625637,2023-02-11,107.06,423.36
6733,90625637,2023-02-13,60.63,483.99
2748,90625637,2023-02-13,-186.35,297.64
2714,90717656,2023-01-31,,409.99
4087,90717656,2023-02-02,224.91,634.9
5698,90717656,2023-02-04,668.8,1303.6999999999998
2627,90717656,2023-02-09,-39.39,1264.31
6390,90717656,2023-02-12,114.27,1378.58
3643,90717656,2023-02-12,-98.81,1279.77
2715,90745743,2023-01-31,,375.07
4792,90745743,2023-02-01,-142.99,232.07999999999998
6808,90745743,2023-02-02,111.9,343.98
7207,90745743,2023-02-03,-113.54,230.44
1730,90745743,2023-02-06,98.92,329.36
2939,90745743,2023-02-10,104.75,434.11
8056,90745743,2023-02-11,-9.21,424.9
2822,90745743,2023-02-13,49.9,474.79999999999995
2716,90824896,2023-01-31,,484.11
4195,90824896,2023-02-02,92.36,576.47
6467,90824896,2023-02-04,104.15,680.62
3635,90824896,2023-02-06,-74.25,606.37
561,90824896,2023-02-08,-10.05,596.32
2717,90851200,2023-01-31,,361.43
4891,90851200,2023-02-02,-755.8,-394.36999999999995
629,90851200,2023-02-06,83.26,-311.10999999999996
3381,90851200,2023-02-07,46.27,-264.8399999999999
3499,90851200,2023-02-10,150.77,-114.06999999999994
4484,90851200,2023-02-10,-81.71,-195.77999999999992
5178,90851200,2023-02-13,98.19,-97.58999999999993
7196,90851200,2023-02-14,-86.1,-183.68999999999994
2718,90871147,2023-01-31,,362.86
3661,90871147,2023-02-08,64.27,427.13
2258,90871147,2023-02-08,-76.59,350.54
4444,90871147,2023-02-09,-484.0,-133.45999999999998
5188,90871147,2023-02-10,58.45,-75.00999999999998
8478,90871147,2023-02-10,-59.42,-134.42999999999998
2719,90894195,2023-01-31,,157.01
4889,90894195,2023-02-02,90.49,247.5
5751,90894195,2023-02-03,40.13,287.63
5811,90894195,2023-02-04,-150.38,137.25
4093,90894195,2023-02-05,-112.34,24.909999999999997
7276,90894195,2023-02-07,45.83,70.74
2720,90932350,2023-01-31,,480.51
2352,90932350,2023-02-02,98.11,578.62
6801,90932350,2023-02-06,189.84,768.46
563,90932350,2023-02-07,-65.9,702.56
945,90932350,2023-02-08,-24.76,677.8
93,90932350,2023-02-08,-837.3,-159.5
774,90932350,2023-02-09,126.46,-33.040000000000006
5535,90932350,2023-02-09,67.99,34.94999999999999
4417,90932350,2023-02-10,-121.71,-86.76
2721,90951743,2023-01-31,,220.81
4318,90951743,2023-02-02,1559.2,1780.01
6433,90951743,2023-02-02,-64.9,1715.11
7792,90951743,2023-02-03,-83.25,1631.86
3557,90951743,2023-02-04,-1548.2,83.65999999999985
3545,90951743,2023-02-05,74.55,158.20999999999987
4464,90951743,2023-02-08,81.17,239.37999999999985
5391,90951743,2023-02-09,112.31,351.6899999999998
5284,90951743,2023-02-11,26.95,378.6399999999999
7875,90951743,2023-02-11,-96.88,281.7599999999999
2722,90982016,2023-01-31,,776.15
1952,90982016,2023-02-07,-92.8,683.35
4039,90982016,2023-02-09,142.5,825.8499999999999
3682,90982016,2023-02-13,124.37,950.22
4264,90982016,2023-02-14,-97.59,852.63
2723,91020929,2023-01-31,,348.12
3786,91020929,2023-02-01,-107.56,240.56
2538,91020929,2023-02-05,99.91,340.47
7382,91020929,2023-02-05,-111.54,228.93
2729,91020929,2023-02-08,-40.13,188.79999999999998
4398,91020929,2023-02-10,-165.41,23.389999999999986
2817,91020929,2023-02-11,39.39,62.77999999999999
2529,91020929,2023-02-13,102.35,165.13
7240,91020929,2023-02-14,-115.38,49.749999999999986
2724,91062192,2023-01-31,,211.52
417,91062192,2023-02-02,-170.79,40.73000000000002
4341,91062192,2023-02-03,-130.7,-89.96999999999997
4247,91062192,2023-02-06,981.9,891.9300000000001
2725,91142310,2023-01-31,,363.08
4106,91142310,2023-02-06,162.13,525.21
3461,91142310,2023-02-07,-1225.0,-699.79
7288,91142310,2023-02-14,-666.1,-1365.8899999999999
2726,91184544,2023-01-31,,64.05
3355,91184544,2023-02-02,12.35,76.39999999999999
5232,91184544,2023-02-07,-91.56,-15.16000000000001
8304,91184544,2023-02-08,159.35,144.19
2576,91184544,2023-02-09,71.26,215.45
250,91184544,2023-02-11,1207.7,1423.15
5346,91184544,2023-02-13,-105.4,1317.75
2727,91246568,2023-01-31,,147.43
7958,91246568,2023-02-02,88.8,236.23000000000002
7923,91246568,2023-02-02,-111.58,124.65
4789,91246568,2023-02-02,-189.79,-65.13999999999999
2464,91246568,2023-02-06,86.91,21.77000000000001
5295,91246568,2023-02-06,-88.91,-67.13999999999999
7809,91246568,2023-02-06,-120.78,-187.92
7659,91246568,2023-02-09,94.78,-93.13999999999999
1382,91246568,2023-02-13,55.07,-38.069999999999986
7128,91246568,2023-02-14,79.76,41.69000000000002
2728,91251995,2023-01-31,,244.0
1534,91251995,2023-02-05,-135.59,108.41
6363,91251995,2023-02-07,-181.11,-72.70000000000002
1964,91251995,2023-02-12,92.56,19.859999999999985
2729,91259453,2023-01-31,,816.68
6103,91259453,2023-02-02,224.1,1040.78
142,91259453,2023-02-11,6.19,1046.97
8475,91259453,2023-02-12,1801.4,2848.37
8061,91259453,2023-02-13,-52.26,2796.11
2730,91305080,2023-01-31,,123.21
2570,91305080,2023-02-01,105.63,228.83999999999997
412,91305080,2023-02-07,-66.78,162.06
8215,91305080,2023-02-11,-29.76,132.29999999999998
1470,91305080,2023-02-11,-125.91,6.389999999999986
7070,91305080,2023-02-14,1288.0,1294.3899999999999
1562,91305080,2023-02-14,111.08,1405.4699999999998
2731,91349198,2023-01-31,,669.58
6974,91349198,2023-02-06,-1.46,668.12
7176,91349198,2023-02-09,-54.69,613.4300000000001
3579,91349198,2023-02-10,123.66,737.09
2317,91349198,2023-02-11,-101.75,635.34
5927,91349198,2023-02-12,-1149.0,-513.66
2732,91373446,2023-01-31,,561.42
89,91373446,2023-02-01,-87.59,473.8299999999999
7042,91373446,2023-02-03,-126.64,347.18999999999994
4568,91373446,2023-02-05,55.81,402.99999999999994
7159,91373446,2023-02-05,-112.73,290.27
8236,91373446,2023-02-06,-137.1,153.16999999999996
2378,91373446,2023-02-09,165.46,318.63
5012,91373446,2023-02-09,-64.96,253.66999999999996
1310,91373446,2023-02-11,-510.2,-256.53000000000003
2732,91373446,2023-02-14,64.61,-191.92000000000002
2733,91382872,2023-01-31,,782.62
8539,91382872,2023-02-10,96.17,878.79
1232,91382872,2023-02-12,-96.6,782.19
2734,91423814,2023-01-31,,957.99
6102,91423814,2023-02-06,-59.52,898.47
3426,91423814,2023-02-06,-113.54,784.9300000000001
2735,91445572,2023-01-31,,405.88
520,91445572,2023-02-02,58.4,464.28
1983,91445572,2023-02-03,156.41,620.69
2736,91576212,2023-01-31,,824.71
526,91576212,2023-02-02,-120.45,704.26
523,91576212,2023-02-03,-117.46,586.8000000000001
353,91576212,2023-02-05,53.81,640.61
3680,91576212,2023-02-08,1254.7,1895.31
4769,91576212,2023-02-08,-85.9,1809.41
6815,91576212,2023-02-09,-1301.5,507.9100000000001
3388,91576212,2023-02-12,989.2,1497.1100000000001
2737,91605034,2023-01-31,,560.96
6230,91605034,2023-02-02,162.1,723.0600000000001
4455,91605034,2023-02-09,91.82,814.88
131,91605034,2023-02-12,-1030.7,-215.82000000000005
2738,91621026,2023-01-31,,834.74
3529,91621026,2023-02-06,96.79,931.53
818,91621026,2023-02-10,-739.5,192.02999999999997
5190,91621026,2023-02-12,145.55,337.58
3537,91621026,2023-02-12,142.86,480.44
7554,91621026,2023-02-12,129.73,610.17
5862,91621026,2023-02-12,65.91,676.0799999999999
2739,91658755,2023-01-31,,347.59
8379,91658755,2023-02-01,126.06,473.65
966,91658755,2023-02-03,59.28,532.93
1781,91658755,2023-02-03,-1016.9,-483.97
245,91658755,2023-02-08,-69.56,-553.53
369,91658755,2023-02-08,-189.28,-742.8100000000001
8185,91658755,2023-02-10,882.0,139.18999999999994
1488,91658755,2023-02-11,-112.56,26.62999999999994
8046,91658755,2023-02-14,166.87,193.49999999999994
2740,91703213,2023-01-31,,891.67
2066,91703213,2023-02-01,54.25,945.92
1901,91703213,2023-02-06,43.89,989.81
2392,91703213,2023-02-07,104.21,1094.02
345,91703213,2023-02-08,-62.19,1031.83
1434,91703213,2023-02-09,-201.62,830.2099999999999
4609,91703213,2023-02-09,-780.7,49.50999999999988
5277,91703213,2023-02-10,132.35,181.85999999999987
2741,91747441,2023-01-31,,356.85
6518,91747441,2023-02-03,87.05,443.90000000000003
7238,91747441,2023-02-05,202.11,646.01
3068,91747441,2023-02-05,-103.17,542.84
830,91747441,2023-02-09,76.74,619.58
82,91747441,2023-02-11,108.78,728.36
119,91747441,2023-02-11,-129.66,598.7
7315,91747441,2023-02-13,-151.93,446.77000000000004
2742,91819341,2023-01-31,,701.61
696,91819341,2023-02-02,-99.58,602.03
5739,91819341,2023-02-07,-44.98,557.0500000000001
6606,91819341,2023-02-07,-90.26,466.79
7268,91819341,2023-02-09,115.89,582.6800000000001
114,91819341,2023-02-09,-103.88,478.8
5074,91819341,2023-02-10,-170.55,308.25
2743,91829198,2023-01-31,,103.19
3844,91829198,2023-02-09,-1156.9,-1053.71
204,91829198,2023-02-10,1585.0,531.29
7248,91829198,2023-02-12,90.34,621.63
5959,91829198,2023-02-13,-138.85,482.78
2744,91834926,2023-01-31,,793.19
5986,91834926,2023-02-03,53.42,846.61
8581,91834926,2023-02-04,-8.63,837.98
753,91834926,2023-02-09,-121.5,716.48
5273,91834926,2023-02-11,-143.86,572.6200000000001
6470,91834926,2023-02-12,75.44,648.0600000000001
7721,91834926,2023-02-14,89.16,737.22
2745,91859090,2023-01-31,,10.38
1085,91859090,2023-02-02,231.9,242.28
2583,91859090,2023-02-04,97.84,340.12
569,91859090,2023-02-06,114.75,454.87
5248,91859090,2023-02-08,206.07,660.94
2327,91859090,2023-02-09,160.06,821.0
632,91859090,2023-02-14,52.73,873.73
2746,91885907,2023-01-31,,652.65
8067,91885907,2023-02-03,610.8,1263.4499999999998
5896,91885907,2023-02-05,107.87,1371.32
7816,91885907,2023-02-05,-125.05,1246.27
841,91885907,2023-02-06,-70.1,1176.1699999999998
5229,91885907,2023-02-08,-110.64,1065.53
1958,91885907,2023-02-13,-114.36,951.17
2747,91939298,2023-01-31,,61.59
6024,91939298,2023-02-01,-121.69,-60.099999999999994
5092,91939298,2023-02-02,-122.81,-182.91
3992,91939298,2023-02-04,-110.99,-293.9
6780,91939298,2023-02-07,86.83,-207.07
6619,91939298,2023-02-12,-91.62,-298.69
8522,91939298,2023-02-14,126.03,-172.66
2748,91943555,2023-01-31,,438.21
530,91943555,2023-02-04,-119.74,318.46999999999997
2803,91943555,2023-02-07,201.7,520.17
5687,91943555,2023-02-13,-112.0,408.16999999999996
2749,91944915,2023-01-31,,601.21
3325,91944915,2023-02-01,100.12,701.33
1608,91944915,2023-02-10,192.08,893.4100000000001
1033,91944915,2023-02-12,-68.26,825.1500000000001
2750,91957838,2023-01-31,,587.57
7733,91957838,2023-02-03,80.26,667.83
1970,91957838,2023-02-05,81.6,749.4300000000001
954,91957838,2023-02-05,-100.87,648.5600000000001
3003,91957838,2023-02-05,-152.02,496.54
1157,91957838,2023-02-10,-209.84,286.70000000000005
6748,91957838,2023-02-11,169.33,456.03000000000003
2751,91971494,2023-01-31,,74.37
7612,91971494,2023-02-02,-787.6,-713.23
3362,91971494,2023-02-06,1053.5,340.27
634,91971494,2023-02-09,-645.9,-305.63
3971,91971494,2023-02-10,-168.19,-473.82
2752,91972687,2023-01-31,,463.97
1288,91972687,2023-02-07,93.03,557.0
7941,91972687,2023-02-10,1128.4,1685.4
5330,91972687,2023-02-14,-144.57,1540.8300000000002
2753,92001688,2023-01-31,,339.08
750,92001688,2023-02-05,-100.23,238.84999999999997
695,92001688,2023-02-07,60.76,299.60999999999996
1867,92001688,2023-02-08,203.33,502.94
4278,92001688,2023-02-08,94.91,597.85
8656,92001688,2023-02-08,-72.05,525.8
3522,92001688,2023-02-11,62.36,588.16
663,92001688,2023-02-14,-207.36,380.79999999999995
2754,92015508,2023-01-31,,457.52
3773,92015508,2023-02-04,-76.06,381.46
2118,92015508,2023-02-05,-52.36,329.09999999999997
7597,92015508,2023-02-06,171.67,500.77
326,92015508,2023-02-07,-119.25,381.52
4016,92015508,2023-02-10,-83.79,297.72999999999996
3790,92015508,2023-02-11,-29.25,268.47999999999996
2519,92015508,2023-02-14,-150.24,118.23999999999995
2755,92037264,2023-01-31,,252.95
8207,92037264,2023-02-03,1131.6,1384.55
720,92037264,2023-02-05,81.8,1466.35
5399,92037264,2023-02-05,-109.6,1356.75
3587,92037264,2023-02-09,7.4,1364.1499999999999
8479,92037264,2023-02-09,-128.74,1235.4099999999999
7711,92037264,2023-02-10,-56.59,1178.82
3754,92037264,2023-02-11,126.5,1305.32
3674,92037264,2023-02-12,-151.48,1153.84
7658,92037264,2023-02-14,-73.4,1080.44
8652,92037264,2023-02-14,-128.56,951.8799999999999
2756,92052516,2023-01-31,,466.43
6348,92052516,2023-02-02,1082.7,1549.13
1095,92052516,2023-02-06,368.9,1918.0300000000002
3570,92052516,2023-02-07,56.32,1974.3500000000001
970,92052516,2023-02-12,-27.9,1946.45
5889,92052516,2023-02-14,-68.7,1877.75
2757,92145159,2023-01-31,,61.65
7437,92145159,2023-02-01,122.63,184.28
4196,92145159,2023-02-01,105.61,289.89
959,92145159,2023-02-01,105.36,395.25
4109,92145159,2023-02-06,-104.1,291.15
2506,92145159,2023-02-07,-134.99,156.16
5662,92145159,2023-02-10,136.31,292.47
8047,92145159,2023-02-12,-2208.4,-1915.93
3454,92145159,2023-02-13,1370.8,-545.1300000000001
6991,92145159,2023-02-14,-615.6,-1160.73
2758,92155262,2023-01-31,,501.67
3266,92155262,2023-02-03,-95.71,405.96000000000004
429,92155262,2023-02-08,1051.3,1457.26
2929,92155262,2023-02-09,1060.0,2517.26
3945,92155262,2023-02-10,134.54,2651.8
4230,92155262,2023-02-11,175.16,2826.96
4291,92155262,2023-02-12,58.39,2885.35
7497,92155262,2023-02-12,-39.42,2845.93
2759,92195724,2023-01-31,,726.92
4172,92195724,2023-02-01,98.75,825.67
807,92195724,2023-02-01,-124.27,701.4
2670,92195724,2023-02-04,-1579.8,-878.4
7314,92195724,2023-02-07,-78.1,-956.5
1449,92195724,2023-02-08,-221.0,-1177.5
2760,92212099,2023-01-31,,584.21
990,92212099,2023-02-09,-120.47,463.74
1582,92212099,2023-02-12,68.21,531.95
6163,92212099,2023-02-12,-7.59,524.36
7033,92212099,2023-02-13,-59.45,464.91
6736,92212099,2023-02-14,-122.94,341.97
2761,92214557,2023-01-31,,258.42
4127,92214557,2023-02-01,173.01,431.43
786,92214557,2023-02-02,-80.13,351.3
3650,92214557,2023-02-04,158.56,509.86
4698,92214557,2023-02-05,98.2,608.0600000000001
4556,92214557,2023-02-07,1567.0,2175.06
1744,92214557,2023-02-07,123.67,2298.73
5228,92214557,2023-02-12,113.72,2412.45
2973,92214557,2023-02-13,95.71,2508.16
2762,92221411,2023-01-31,,849.46
574,92221411,2023-02-01,-122.46,727.0
3601,92221411,2023-02-02,-23.22,703.7800000000001
7699,92221411,2023-02-04,72.06,775.84
1770,92221411,2023-02-06,96.4,872.24
1365,92221411,2023-02-08,122.18,994.4200000000001
3642,92221411,2023-02-08,-89.97,904.45
2312,92221411,2023-02-12,-123.13,781.32
4201,92221411,2023-02-14,-78.83,702.49
2763,92232319,2023-01-31,,416.11
5753,92232319,2023-02-02,165.3,581.4100000000001
5045,92232319,2023-02-04,-126.98,454.43
3976,92232319,2023-02-05,-212.21,242.22000000000003
6502,92232319,2023-02-08,-114.69,127.53000000000003
4844,92232319,2023-02-10,67.69,195.22000000000003
7875,92232319,2023-02-11,96.88,292.1
2764,92234913,2023-01-31,,613.18
3484,92234913,2023-02-07,-142.6,470.5799999999999
712,92234913,2023-02-12,803.9,1274.48
3978,92234913,2023-02-13,-40.95,1233.53
2765,92287463,2023-01-31,,257.14
176,92287463,2023-02-01,-84.96,172.18
8672,92287463,2023-02-03,-85.62,86.55999999999999
7856,92287463,2023-02-06,110.26,196.82
6864,92287463,2023-02-06,-109.51,87.30999999999999
4586,92287463,2023-02-07,-102.22,-14.91000000000001
5777,92287463,2023-02-09,111.55,96.63999999999999
8565,92287463,2023-02-11,31.41,128.04999999999998
8172,92287463,2023-02-12,79.05,207.09999999999997
2766,92319358,2023-01-31,,116.51
2986,92319358,2023-02-01,94.06,210.57
7356,92319358,2023-02-05,700.4,910.97
965,92319358,2023-02-06,143.57,1054.54
3540,92319358,2023-02-07,-96.55,957.9899999999999
532,92319358,2023-02-07,-135.69,822.3
1133,92319358,2023-02-09,1877.3,2699.6
6292,92319358,2023-02-09,-625.1,2074.5
6269,92319358,2023-02-10,-47.75,2026.75
8400,92319358,2023-02-10,-137.56,1889.1899999999998
6703,92319358,2023-02-11,157.6,2046.79
4520,92319358,2023-02-13,-126.66,1920.1299999999999
2767,92338537,2023-01-31,,316.24
1876,92338537,2023-02-01,-75.36,240.88
5965,92338537,2023-02-05,170.82,411.7
2398,92338537,2023-02-05,-403.6,8.099999999999966
132,92338537,2023-02-08,30.21,38.30999999999997
8232,92338537,2023-02-13,262.4,300.7099999999999
8458,92338537,2023-02-13,-22.49,278.2199999999999
2768,92340721,2023-01-31,,844.79
6417,92340721,2023-02-05,1168.4,2013.19
7491,92340721,2023-02-06,-163.65,1849.54
190,92340721,2023-02-07,744.0,2593.54
6400,92340721,2023-02-07,34.65,2628.19
5229,92340721,2023-02-08,110.64,2738.83
5775,92340721,2023-02-11,-58.37,2680.46
6360,92340721,2023-02-11,-187.8,2492.66
459,92340721,2023-02-12,-112.23,2380.43
2769,92376825,2023-01-31,,323.68
8296,92376825,2023-02-01,158.59,482.27
6640,92376825,2023-02-04,100.39,582.66
8437,92376825,2023-02-05,197.01,779.6700000000001
5247,92376825,2023-02-10,145.53,925.2
5129,92376825,2023-02-11,1214.6,2139.8
2048,92376825,2023-02-12,120.9,2260.7
3017,92376825,2023-02-13,103.99,2364.69
2770,92390334,2023-01-31,,602.62
7960,92390334,2023-02-01,-136.22,466.4
8077,92390334,2023-02-04,-68.87,397.53
2771,92423759,2023-01-31,,475.1
2377,92423759,2023-02-04,131.28,606.38
538,92423759,2023-02-04,-664.6,-58.22000000000003
5729,92423759,2023-02-06,90.64,32.41999999999997
2772,92437489,2023-01-31,,24.19
566,92437489,2023-02-04,-40.15,-15.959999999999997
1757,92437489,2023-02-06,176.4,160.44
4787,92437489,2023-02-10,-73.65,86.78999999999999
3230,92437489,2023-02-10,-89.99,-3.200000000000003
2773,92551293,2023-01-31,,252.3
2858,92551293,2023-02-03,55.02,307.32
7807,92551293,2023-02-13,-122.87,184.45000000000002
2774,92563438,2023-01-31,,965.81
3786,92563438,2023-02-01,107.56,1073.37
6920,92563438,2023-02-01,-164.94,908.43
5842,92563438,2023-02-04,139.7,1048.1299999999999
6229,92563438,2023-02-09,-99.18,948.9499999999999
3852,92563438,2023-02-10,-118.13,830.8199999999999
2347,92563438,2023-02-13,-76.58,754.2399999999999
2848,92563438,2023-02-14,-66.88,687.3599999999999
2775,92684055,2023-01-31,,430.86
7806,92684055,2023-02-03,-165.51,265.35
2980,92684055,2023-02-11,121.16,386.51
6877,92684055,2023-02-11,59.3,445.81
408,92684055,2023-02-13,-63.47,382.34000000000003
2776,92750088,2023-01-31,,560.4
6702,92750088,2023-02-01,-1069.7,-509.30000000000007
1187,92750088,2023-02-04,199.36,-309.94000000000005
3352,92750088,2023-02-05,149.93,-160.01000000000005
2912,92750088,2023-02-06,66.17,-93.84000000000005
4584,92750088,2023-02-07,104.75,10.909999999999954
2777,92770567,2023-01-31,,949.66
6237,92770567,2023-02-01,-120.09,829.5699999999999
4510,92770567,2023-02-04,-68.76,760.81
3280,92770567,2023-02-05,-39.31,721.5
3094,92770567,2023-02-06,-162.2,559.3
7984,92770567,2023-02-07,135.62,694.92
3733,92770567,2023-02-07,-102.52,592.4
6476,92770567,2023-02-13,136.98,729.3799999999999
2510,92770567,2023-02-13,-33.75,695.6299999999999
2629,92770567,2023-02-13,-144.25,551.3799999999999
2778,92840827,2023-01-31,,403.77
6462,92840827,2023-02-03,106.35,510.12
5579,92840827,2023-02-10,82.0,592.12
4152,92840827,2023-02-13,-78.01,514.11
6499,92840827,2023-02-13,-157.41,356.7
2779,92872571,2023-01-31,,933.03
3572,92872571,2023-02-01,96.06,1029.09
4371,92872571,2023-02-05,89.62,1118.71
805,92872571,2023-02-09,-50.78,1067.93
1317,92872571,2023-02-12,233.91,1301.84
754,92872571,2023-02-14,124.26,1426.1
2780,92898446,2023-01-31,,64.49
5000,92898446,2023-02-07,184.29,248.77999999999997
4135,92898446,2023-02-07,41.35,290.13
5114,92898446,2023-02-07,1.77,291.9
3239,92898446,2023-02-08,-46.43,245.47
1224,92898446,2023-02-09,6.95,252.42000000000002
6632,92898446,2023-02-09,-132.58,119.84
4114,92898446,2023-02-12,81.83,201.67000000000002
2781,92910876,2023-01-31,,643.19
5530,92910876,2023-02-04,-8.85,634.34
7571,92910876,2023-02-05,-59.2,575.1400000000001
8368,92910876,2023-02-07,173.79,748.9300000000001
3176,92910876,2023-02-11,-85.36,663.57
631,92910876,2023-02-14,100.7,764.27
7183,92910876,2023-02-14,-86.73,677.5400000000001
2782,92920645,2023-01-31,,644.88
5680,92920645,2023-02-10,-35.64,609.24
3171,92920645,2023-02-12,-157.87,451.37
2783,92931020,2023-01-31,,754.11
2427,92931020,2023-02-02,-153.04,601.07
2094,92931020,2023-02-04,-34.82,566.25
5072,92931020,2023-02-05,-815.7,-249.45000000000005
4952,92931020,2023-02-06,48.31,-201.14000000000004
8622,92931020,2023-02-09,73.42,-127.72000000000004
2976,92931020,2023-02-10,136.1,8.379999999999953
2284,92931020,2023-02-11,-1742.7,-1734.3200000000002
1487,92931020,2023-02-12,-120.86,-1855.18
5806,92931020,2023-02-13,-77.95,-1933.13
2784,92943637,2023-01-31,,28.23
1745,92943637,2023-02-02,-140.57,-112.33999999999999
1529,92943637,2023-02-03,88.94,-23.39999999999999
7720,92943637,2023-02-05,-76.04,-99.44
6121,92943637,2023-02-08,-76.65,-176.09
6099,92943637,2023-02-10,-110.9,-286.99
2785,92944470,2023-01-31,,445.48
3854,92944470,2023-02-01,152.59,598.07
5922,92944470,2023-02-06,100.9,698.97
75,92944470,2023-02-10,-103.91,595.0600000000001
4549,92944470,2023-02-12,110.14,705.2
2786,92963966,2023-01-31,,983.65
8076,92963966,2023-02-01,3.04,986.6899999999999
5169,92963966,2023-02-06,90.05,1076.74
2787,93009261,2023-01-31,,675.04
6788,93009261,2023-02-02,100.36,775.4
4856,93009261,2023-02-05,119.42,894.8199999999999
6080,93009261,2023-02-05,65.1,959.92
3669,93009261,2023-02-06,1695.0,2654.92
7735,93009261,2023-02-07,-108.88,2546.04
5134,93009261,2023-02-08,1169.6,3715.64
830,93009261,2023-02-09,-76.74,3638.9
1387,93009261,2023-02-09,-97.8,3541.1
993,93009261,2023-02-10,147.51,3688.6099999999997
485,93009261,2023-02-10,93.3,3781.91
3858,93009261,2023-02-10,-213.83,3568.08
1890,93009261,2023-02-13,125.85,3693.93
2788,93039862,2023-01-31,,806.99
7289,93039862,2023-02-02,61.2,868.19
803,93039862,2023-02-03,27.83,896.02
3861,93039862,2023-02-07,-66.88,829.14
6038,93039862,2023-02-09,-132.48,696.6600000000001
3852,93039862,2023-02-10,118.13,814.79
4971,93039862,2023-02-14,82.7,897.49
2789,93076057,2023-01-31,,218.56
6615,93076057,2023-02-02,143.82,362.38
8433,93076057,2023-02-04,87.35,449.73
2790,93128216,2023-01-31,,834.73
2685,93128216,2023-02-03,-10.64,824.09
982,93128216,2023-02-03,-144.61,679.48
2500,93128216,2023-02-10,-44.74,634.74
2138,93128216,2023-02-11,168.92,803.66
8541,93128216,2023-02-14,-136.93,666.73
2791,93147630,2023-01-31,,403.93
5395,93147630,2023-02-07,148.81,552.74
7351,93147630,2023-02-11,-116.92,435.82
118,93147630,2023-02-13,130.18,566.0
7935,93147630,2023-02-13,-136.72,429.28
2792,93192347,2023-01-31,,298.01
2311,93192347,2023-02-01,-1277.2,-979.19
3236,93192347,2023-02-04,158.04,-821.1500000000001
4888,93192347,2023-02-04,-126.02,-947.1700000000001
3965,93192347,2023-02-05,51.72,-895.45
6706,93192347,2023-02-08,92.59,-802.86
3020,93192347,2023-02-09,1325.7,522.84
5887,93192347,2023-02-12,-2147.9,-1625.06
3718,93192347,2023-02-14,-171.25,-1796.31
1609,93192347,2023-02-14,-626.8,-2423.1099999999997
2793,93248179,2023-01-31,,376.57
1299,93248179,2023-02-01,-27.36,349.21
8593,93248179,2023-02-01,-130.11,219.09999999999997
2889,93248179,2023-02-04,182.66,401.76
2794,93306742,2023-01-31,,388.54
1003,93306742,2023-02-11,181.51,570.05
8575,93306742,2023-02-13,61.83,631.88
3371,93306742,2023-02-13,43.87,675.75
2795,93325549,2023-01-31,,161.45
1977,93325549,2023-02-01,177.63,339.08
3187,93325549,2023-02-05,790.5,1129.58
6194,93325549,2023-02-08,168.29,1297.87
5970,93325549,2023-02-10,106.29,1404.1599999999999
3960,93325549,2023-02-11,-68.2,1335.96
3133,93325549,2023-02-14,79.28,1415.24
2796,93346040,2023-01-31,,816.07
4670,93346040,2023-02-01,-69.18,746.8900000000001
3098,93346040,2023-02-06,-12.77,734.12
1329,93346040,2023-02-07,10.31,744.4300000000001
1160,93346040,2023-02-07,-135.7,608.73
7568,93346040,2023-02-07,-814.4,-205.66999999999996
5821,93346040,2023-02-08,153.79,-51.87999999999997
3611,93346040,2023-02-09,118.46,66.58000000000003
3000,93346040,2023-02-10,118.13,184.71000000000004
2797,93349543,2023-01-31,,329.45
7437,93349543,2023-02-01,-122.63,206.82
6249,93349543,2023-02-03,-103.43,103.38999999999999
6827,93349543,2023-02-04,-118.6,-15.210000000000008
6925,93349543,2023-02-05,66.8,51.58999999999999
7316,93349543,2023-02-05,-86.14,-34.55000000000001
2798,93355755,2023-01-31,,753.84
2031,93355755,2023-02-03,-49.54,704.3000000000001
4630,93355755,2023-02-09,104.28,808.58
6068,93355755,2023-02-10,-11.73,796.85
2799,93388304,2023-01-31,,73.0
1961,93388304,2023-02-04,162.79,235.79
4975,93388304,2023-02-04,66.05,301.84
5419,93388304,2023-02-08,38.91,340.75
4427,93388304,2023-02-09,157.3,498.05
4838,93388304,2023-02-11,-3.02,495.03000000000003
5390,93388304,2023-02-13,142.04,637.0699999999999
2800,93409343,2023-01-31,,748.45
4137,93409343,2023-02-01,830.7,1579.15
1670,93409343,2023-02-05,-81.2,1497.95
2912,93409343,2023-02-06,-66.17,1431.7800000000002
4471,93409343,2023-02-08,94.16,1525.94
3657,93409343,2023-02-12,-110.2,1415.74
2801,93429066,2023-01-31,,652.04
6671,93429066,2023-02-04,-146.82,505.21999999999997
6045,93429066,2023-02-05,131.36,636.5799999999999
3007,93429066,2023-02-05,-149.41,487.16999999999996
1395,93429066,2023-02-12,-96.27,390.9
2802,93443317,2023-01-31,,305.29
5902,93443317,2023-02-01,124.69,429.98
5954,93443317,2023-02-02,94.47,524.45
3451,93443317,2023-02-03,-141.16,383.29
6634,93443317,2023-02-04,87.13,470.42
2803,93446276,2023-01-31,,184.74
84,93446276,2023-02-01,187.15,371.89
669,93446276,2023-02-01,89.8,461.69
2821,93446276,2023-02-01,-142.15,319.54
3993,93446276,2023-02-02,701.1,1020.6400000000001
1202,93446276,2023-02-02,162.35,1182.99
3189,93446276,2023-02-02,-95.1,1087.8899999999999
904,93446276,2023-02-05,-106.71,981.18
5526,93446276,2023-02-07,-141.05,840.13
7191,93446276,2023-02-09,1679.2,2519.33
1972,93446276,2023-02-10,154.12,2673.4500000000003
2804,93529019,2023-01-31,,463.32
5464,93529019,2023-02-04,157.05,620.37
7899,93529019,2023-02-05,94.84,715.21
1596,93529019,2023-02-06,160.08,875.29
4621,93529019,2023-02-06,65.08,940.37
5481,93529019,2023-02-07,184.95,1125.32
7739,93529019,2023-02-08,-59.4,1065.92
5766,93529019,2023-02-09,-111.83,954.09
6582,93529019,2023-02-10,-82.73,871.36
5192,93529019,2023-02-11,1507.4,2378.76
3689,93529019,2023-02-14,-157.14,2221.6200000000003
2805,93559470,2023-01-31,,210.7
6771,93559470,2023-02-01,-126.64,84.05999999999999
3665,93559470,2023-02-05,64.51,148.57
1290,93559470,2023-02-05,-749.9,-601.3299999999999
3341,93559470,2023-02-08,162.59,-438.74
3297,93559470,2023-02-08,-107.7,-546.44
3467,93559470,2023-02-09,-150.22,-696.6600000000001
5081,93559470,2023-02-10,73.99,-622.6700000000001
2997,93559470,2023-02-10,-86.61,-709.28
2806,93564856,2023-01-31,,234.66
1765,93564856,2023-02-01,117.24,351.9
2211,93564856,2023-02-06,93.76,445.65999999999997
8118,93564856,2023-02-09,97.55,543.21
1123,93564856,2023-02-10,67.2,610.41
3199,93564856,2023-02-11,119.87,730.28
6275,93564856,2023-02-12,1690.9,2421.1800000000003
8277,93564856,2023-02-14,-96.41,2324.77
2807,93569124,2023-01-31,,221.11
5550,93569124,2023-02-10,156.63,377.74
4838,93569124,2023-02-11,3.02,380.76
6188,93569124,2023-02-14,-80.98,299.78
2808,93624474,2023-01-31,,622.14
6859,93624474,2023-02-02,114.87,737.01
4912,93624474,2023-02-03,85.3,822.31
5719,93624474,2023-02-04,80.51,902.8199999999999
3951,93624474,2023-02-04,-31.94,870.88
2351,93624474,2023-02-09,-940.9,-70.01999999999998
4263,93624474,2023-02-10,-57.04,-127.05999999999997
6963,93624474,2023-02-11,1058.7,931.6400000000001
5554,93624474,2023-02-14,93.52,1025.16
2809,93630048,2023-01-31,,317.95
1568,93630048,2023-02-02,35.9,353.84999999999997
8099,93630048,2023-02-03,-56.07,297.78
1177,93630048,2023-02-03,-61.29,236.48999999999998
1440,93630048,2023-02-14,34.96,271.45
4269,93630048,2023-02-14,-66.36,205.08999999999997
2810,93707181,2023-01-31,,321.91
8508,93707181,2023-02-01,99.63,421.54
7234,93707181,2023-02-03,144.82,566.36
967,93707181,2023-02-05,87.06,653.4200000000001
2811,93745446,2023-01-31,,574.89
7612,93745446,2023-02-02,787.6,1362.49
4709,93745446,2023-02-05,177.67,1540.16
3856,93745446,2023-02-08,136.68,1676.84
5598,93745446,2023-02-09,50.28,1727.12
7857,93745446,2023-02-10,-1275.3,451.82000000000016
5354,93745446,2023-02-12,94.0,545.8200000000002
8134,93745446,2023-02-12,-64.01,481.8100000000002
2035,93745446,2023-02-12,-91.07,390.7400000000002
8181,93745446,2023-02-13,-185.27,205.47000000000014
2812,93747938,2023-01-31,,724.31
8605,93747938,2023-02-07,-1076.8,-352.49
2194,93747938,2023-02-08,55.57,-296.92
6291,93747938,2023-02-09,-158.5,-455.42
1798,93747938,2023-02-10,-59.31,-514.73
2813,93840154,2023-01-31,,159.7
7223,93840154,2023-02-05,-94.38,65.32
7644,93840154,2023-02-08,114.36,179.68
4249,93840154,2023-02-10,-90.78,88.89999999999999
5280,93840154,2023-02-14,99.95,188.85
5367,93840154,2023-02-14,-22.59,166.26
2814,93932516,2023-01-31,,575.82
4712,93932516,2023-02-02,-110.52,465.30000000000007
1039,93932516,2023-02-05,-859.9,-394.5999999999999
7156,93932516,2023-02-07,132.98,-261.6199999999999
5477,93932516,2023-02-07,-36.15,-297.7699999999999
829,93932516,2023-02-08,217.58,-80.18999999999991
2106,93932516,2023-02-08,-15.71,-95.89999999999992
7998,93932516,2023-02-09,105.71,9.810000000000088
3522,93932516,2023-02-11,-62.36,-52.54999999999991
6106,93932516,2023-02-13,-153.14,-205.68999999999988
2815,93981472,2023-01-31,,175.68
3893,93981472,2023-02-02,1298.8,1474.48
5872,93981472,2023-02-05,178.08,1652.56
471,93981472,2023-02-08,114.16,1766.72
152,93981472,2023-02-08,-597.4,1169.3200000000002
6023,93981472,2023-02-10,131.62,1300.94
2163,93981472,2023-02-10,108.85,1409.79
248,93981472,2023-02-10,-82.23,1327.56
7073,93981472,2023-02-12,-190.17,1137.39
7515,93981472,2023-02-13,-104.7,1032.69
7505,93981472,2023-02-14,-135.14,897.5500000000001
2816,94044891,2023-01-31,,367.77
404,94044891,2023-02-03,123.6,491.37
997,94044891,2023-02-05,-102.47,388.9
2847,94044891,2023-02-06,57.47,446.37
6609,94044891,2023-02-13,-112.88,333.49
2817,94060198,2023-01-31,,309.9
2874,94060198,2023-02-01,-1663.4,-1353.5
601,94060198,2023-02-02,-166.1,-1519.6
779,94060198,2023-02-03,-103.32,-1622.92
7900,94060198,2023-02-05,1317.7,-305.22
8161,94060198,2023-02-09,-82.05,-387.27000000000004
7979,94060198,2023-02-10,145.86,-241.41000000000003
7397,94060198,2023-02-10,59.66,-181.75000000000003
8375,94060198,2023-02-13,47.89,-133.86
2818,94082779,2023-01-31,,49.87
6084,94082779,2023-02-03,-76.42,-26.550000000000004
5574,94082779,2023-02-06,89.28,62.73
237,94082779,2023-02-13,127.51,190.24
2819,94096082,2023-01-31,,342.2
244,94096082,2023-02-05,159.46,501.65999999999997
1872,94096082,2023-02-09,-134.28,367.38
3235,94096082,2023-02-13,445.8,813.1800000000001
2820,94106013,2023-01-31,,844.86
6344,94106013,2023-02-04,87.65,932.51
8028,94106013,2023-02-04,58.55,991.0600000000001
3015,94106013,2023-02-07,119.45,1110.51
7871,94106013,2023-02-12,-94.08,1016.4300000000001
7785,94106013,2023-02-14,148.07,1164.5
2821,94163785,2023-01-31,,953.91
8136,94163785,2023-02-03,886.3,1840.21
239,94163785,2023-02-04,-100.25,1739.96
3498,94163785,2023-02-06,-115.81,1624.1499999999999
39,94163785,2023-02-07,-118.34,1505.81
4075,94163785,2023-02-12,-100.49,1405.32
8046,94163785,2023-02-14,-166.87,1238.4499999999998
2822,94171142,2023-01-31,,261.94
6170,94171142,2023-02-01,-123.08,138.86
2613,94171142,2023-02-02,148.35,287.21
859,94171142,2023-02-02,-133.09,154.11999999999998
1575,94171142,2023-02-08,-522.3,-368.17999999999995
1337,94171142,2023-02-09,-65.15,-433.3299999999999
7257,94171142,2023-02-11,17.89,-415.43999999999994
3837,94171142,2023-02-11,-149.19,-564.6299999999999
5196,94171142,2023-02-14,-483.2,-1047.83
2823,94200289,2023-01-31,,207.5
3937,94200289,2023-02-05,-27.36,180.14
8072,94200289,2023-02-05,-123.78,56.36
4430,94200289,2023-02-06,178.95,235.31
5936,94200289,2023-02-06,-15.22,220.09
3328,94200289,2023-02-07,-70.76,149.32999999999998
8156,94200289,2023-02-12,153.75,303.08
1047,94200289,2023-02-14,-131.36,171.71999999999997
2824,94208888,2023-01-31,,97.84
4331,94208888,2023-02-03,-164.94,-67.1
3358,94208888,2023-02-04,109.5,42.400000000000006
3941,94208888,2023-02-11,-1944.9,-1902.5
1841,94208888,2023-02-12,-109.26,-2011.76
2825,94212460,2023-01-31,,215.27
2826,94228831,2023-01-31,,277.02
3662,94228831,2023-02-02,140.61,417.63
5034,94228831,2023-02-03,-131.74,285.89
2816,94228831,2023-02-06,109.48,395.37
2650,94228831,2023-02-06,-110.54,284.83
4817,94228831,2023-02-12,176.03,460.86
2827,94247629,2023-01-31,,308.63
6301,94247629,2023-02-04,39.76,348.39
1833,94247629,2023-02-05,105.91,454.29999999999995
6020,94247629,2023-02-07,-1738.7,-1284.4
3657,94247629,2023-02-12,110.2,-1174.2
2828,94331180,2023-01-31,,89.31
7948,94331180,2023-02-01,-54.98,34.330000000000005
2227,94331180,2023-02-07,101.44,135.77
6523,94331180,2023-02-11,-105.42,30.35000000000001
2838,94331180,2023-02-13,-70.85,-40.499999999999986
2829,94342965,2023-01-31,,282.51
4998,94342965,2023-02-02,107.51,390.02
6951,94342965,2023-02-05,-159.07,230.95
3959,94342965,2023-02-09,1208.0,1438.95
1542,94342965,2023-02-12,-133.51,1305.44
2830,94365401,2023-01-31,,81.28
1360,94365401,2023-02-02,37.62,118.9
8129,94365401,2023-02-03,-101.25,17.650000000000006
8015,94365401,2023-02-08,93.77,111.42
6653,94365401,2023-02-11,122.21,233.63
6165,94365401,2023-02-12,-31.2,202.43
2831,94409941,2023-01-31,,642.83
4328,94409941,2023-02-01,-92.51,550.32
2619,94409941,2023-02-04,629.0,1179.3200000000002
4949,94409941,2023-02-12,66.55,1245.8700000000001
7381,94409941,2023-02-14,-152.69,1093.18
1683,94409941,2023-02-14,-867.5,225.68000000000006
2832,94437482,2023-01-31,,415.91
246,94437482,2023-02-06,94.32,510.23
2957,94437482,2023-02-06,-143.44,366.79
5667,94437482,2023-02-09,-53.97,312.82000000000005
6245,94437482,2023-02-10,-46.55,266.27000000000004
5335,94437482,2023-02-14,950.7,1216.97
2833,94457332,2023-01-31,,764.02
6331,94457332,2023-02-05,-107.79,656.23
6538,94457332,2023-02-06,146.96,803.19
6598,94457332,2023-02-14,-33.66,769.53
2834,94493359,2023-01-31,,17.96
4993,94493359,2023-02-03,-133.41,-115.44999999999999
8255,94493359,2023-02-06,-112.02,-227.46999999999997
5363,94493359,2023-02-07,-171.17,-398.64
4198,94493359,2023-02-10,-83.93,-482.57
4310,94493359,2023-02-11,129.35,-353.22
8326,94493359,2023-02-11,-102.91,-456.13
3450,94493359,2023-02-12,-106.86,-562.99
2835,94525216,2023-01-31,,635.22
5420,94525216,2023-02-02,44.56,679.78
4423,94525216,2023-02-05,-115.1,564.6800000000001
3127,94525216,2023-02-07,132.14,696.82
971,94525216,2023-02-07,97.95,794.77
6902,94525216,2023-02-07,-183.44,611.33
5946,94525216,2023-02-09,190.82,802.1500000000001
6189,94525216,2023-02-10,139.51,941.6600000000001
2836,94566140,2023-01-31,,31.61
7783,94566140,2023-02-04,-54.15,-22.54
678,94566140,2023-02-06,-128.91,-151.45
3986,94566140,2023-02-07,38.88,-112.57
8098,94566140,2023-02-07,-152.23,-264.79999999999995
4171,94566140,2023-02-09,44.94,-219.85999999999999
4511,94566140,2023-02-13,-104.5,-324.36
5388,94566140,2023-02-14,38.12,-286.24
2837,94615411,2023-01-31,,147.21
2474,94615411,2023-02-02,-1015.8,-868.5899999999999
1894,94615411,2023-02-04,151.32,-717.27
5410,94615411,2023-02-08,71.98,-645.29
8461,94615411,2023-02-09,176.97,-468.31999999999994
1535,94615411,2023-02-09,-109.51,-577.8299999999999
320,94615411,2023-02-10,-79.77,-657.5999999999999
7667,94615411,2023-02-12,138.36,-519.2399999999999
8499,94615411,2023-02-12,-93.78,-613.02
2838,94629877,2023-01-31,,908.69
4593,94629877,2023-02-03,65.94,974.6300000000001
2967,94629877,2023-02-04,884.9,1859.53
3083,94629877,2023-02-04,-686.5,1173.03
5540,94629877,2023-02-04,-1031.4,141.62999999999988
4458,94629877,2023-02-05,-112.93,28.699999999999875
7475,94629877,2023-02-09,899.8,928.4999999999998
4637,94629877,2023-02-10,181.71,1110.2099999999998
4899,94629877,2023-02-12,72.46,1182.6699999999998
2839,94635297,2023-01-31,,353.43
21,94635297,2023-02-02,-25.81,327.62
2008,94635297,2023-02-03,115.87,443.49
5365,94635297,2023-02-04,-92.27,351.22
3802,94635297,2023-02-05,82.64,433.86
3488,94635297,2023-02-08,-76.81,357.05
2840,94645169,2023-01-31,,854.22
8117,94645169,2023-02-01,-98.05,756.1700000000001
698,94645169,2023-02-03,-12.0,744.1700000000001
5218,94645169,2023-02-07,125.24,869.4100000000001
3768,94645169,2023-02-07,-74.77,794.64
7336,94645169,2023-02-07,-133.96,660.6800000000001
5999,94645169,2023-02-11,-173.97,486.71000000000004
4603,94645169,2023-02-12,128.94,615.65
237,94645169,2023-02-13,-127.51,488.14
2904,94645169,2023-02-14,-0.73,487.41
2841,94660017,2023-01-31,,107.29
906,94660017,2023-02-01,-115.14,-7.849999999999994
2949,94660017,2023-02-10,86.75,78.9
2230,94660017,2023-02-12,41.61,120.51
1259,94660017,2023-02-13,123.64,244.15
3580,94660017,2023-02-13,47.03,291.18
2842,94677908,2023-01-31,,343.33
7769,94677908,2023-02-01,115.41,458.74
3244,94677908,2023-02-03,117.22,575.96
7043,94677908,2023-02-03,88.14,664.1
5281,94677908,2023-02-04,-106.07,558.03
3505,94677908,2023-02-07,-121.46,436.57
3157,94677908,2023-02-08,-143.85,292.72
6076,94677908,2023-02-09,138.19,430.90999999999997
5745,94677908,2023-02-12,-1534.6,-1103.69
2833,94677908,2023-02-13,170.79,-932.9000000000001
2843,94716844,2023-01-31,,605.84
6711,94716844,2023-02-01,-102.9,502.94000000000005
4031,94716844,2023-02-04,168.29,671.23
5600,94716844,2023-02-04,-90.09,581.14
5573,94716844,2023-02-06,-58.17,522.97
1129,94716844,2023-02-08,123.06,646.03
8014,94716844,2023-02-10,62.94,708.97
2793,94716844,2023-02-11,-62.9,646.07
3813,94716844,2023-02-13,80.74,726.81
8393,94716844,2023-02-13,-101.87,624.94
1727,94716844,2023-02-14,198.2,823.14
4804,94716844,2023-02-14,94.45,917.59
2844,94729530,2023-01-31,,635.76
7060,94729530,2023-02-01,136.75,772.51
2636,94729530,2023-02-01,62.95,835.46
3128,94729530,2023-02-01,58.96,894.42
947,94729530,2023-02-10,-142.57,751.85
2077,94729530,2023-02-13,163.99,915.84
4511,94729530,2023-02-13,104.5,1020.34
2845,94732589,2023-01-31,,697.54
3771,94732589,2023-02-02,-90.91,606.63
4781,94732589,2023-02-03,-139.6,467.03
79,94732589,2023-02-03,-180.87,286.15999999999997
4685,94732589,2023-02-04,102.44,388.59999999999997
468,94732589,2023-02-06,124.22,512.8199999999999
2033,94732589,2023-02-06,47.78,560.5999999999999
2764,94732589,2023-02-14,-120.42,440.17999999999995
2846,94748860,2023-01-31,,630.6
8460,94748860,2023-02-04,44.05,674.65
6879,94748860,2023-02-08,119.07,793.72
5427,94748860,2023-02-08,31.3,825.02
2847,94796578,2023-01-31,,700.49
2996,94796578,2023-02-01,-1057.7,-357.21000000000004
7419,94796578,2023-02-03,65.14,-292.07000000000005
2493,94796578,2023-02-03,40.39,-251.68000000000004
4623,94796578,2023-02-05,112.69,-138.99000000000004
7507,94796578,2023-02-06,110.83,-28.16000000000004
1196,94796578,2023-02-06,84.58,56.41999999999996
7394,94796578,2023-02-07,-169.36,-112.94000000000005
1238,94796578,2023-02-08,-167.11,-280.05000000000007
2924,94796578,2023-02-10,249.81,-30.240000000000066
7292,94796578,2023-02-12,48.09,17.849999999999937
3911,94796578,2023-02-13,34.3,52.149999999999935
5676,94796578,2023-02-14,79.54,131.68999999999994
8352,94796578,2023-02-14,68.12,199.80999999999995
2848,94814824,2023-01-31,,716.75
1037,94814824,2023-02-05,159.3,876.05
975,94814824,2023-02-07,11.37,887.42
5121,94814824,2023-02-09,-87.99,799.4300000000001
4695,94814824,2023-02-13,-119.69,679.74
7278,94814824,2023-02-14,60.02,739.76
2849,94893604,2023-01-31,,289.19
7556,94893604,2023-02-01,122.07,411.26
424,94893604,2023-02-02,-140.27,270.99
5442,94893604,2023-02-04,150.79,421.78
3457,94893604,2023-02-08,90.52,512.3
2099,94893604,2023-02-12,104.51,616.81
2850,94935991,2023-01-31,,645.53
472,94935991,2023-02-03,-109.74,535.79
5471,94935991,2023-02-04,118.19,653.98
1029,94935991,2023-02-04,7.06,661.04
4656,94935991,2023-02-09,84.03,745.0699999999999
2790,94935991,2023-02-10,116.72,861.79
4714,94935991,2023-02-12,1015.8,1877.59
4281,94935991,2023-02-14,-36.6,1840.99
2851,94973297,2023-01-31,,761.68
5901,94973297,2023-02-04,-112.13,649.55
3208,94973297,2023-02-06,-81.6,567.9499999999999
29,94973297,2023-02-09,-69.64,498.30999999999995
7857,94973297,2023-02-10,1275.3,1773.61
5446,94973297,2023-02-10,-73.16,1700.4499999999998
8302,94973297,2023-02-14,-1365.0,335.4499999999998
2852,95009921,2023-01-31,,658.77
807,95009921,2023-02-01,124.27,783.04
5059,95009921,2023-02-02,103.03,886.0699999999999
4059,95009921,2023-02-04,153.28,1039.35
3008,95009921,2023-02-05,158.54,1197.8899999999999
6013,95009921,2023-02-06,87.21,1285.1
4931,95009921,2023-02-08,94.29,1379.3899999999999
1539,95009921,2023-02-09,-144.93,1234.46
5348,95009921,2023-02-12,87.73,1322.19
7937,95009921,2023-02-14,188.3,1510.49
1869,95009921,2023-02-14,110.66,1621.1499999999999
1562,95009921,2023-02-14,-111.08,1510.07
2853,95060122,2023-01-31,,771.61
5095,95060122,2023-02-03,-116.84,654.77
5332,95060122,2023-02-03,-119.68,535.09
4448,95060122,2023-02-04,152.03,687.12
3057,95060122,2023-02-06,-633.0,54.120000000000005
8665,95060122,2023-02-10,70.94,125.06
4533,95060122,2023-02-10,-65.02,60.040000000000006
5158,95060122,2023-02-10,-163.3,-103.26
8026,95060122,2023-02-14,-29.41,-132.67000000000002
2854,95081571,2023-01-31,,712.07
3425,95081571,2023-02-01,-76.26,635.8100000000001
3227,95081571,2023-02-02,-88.57,547.24
4760,95081571,2023-02-02,-125.99,421.25000000000006
6856,95081571,2023-02-07,17.58,438.83000000000004
4759,95081571,2023-02-07,-168.17,270.6600000000001
4752,95081571,2023-02-08,1330.7,1601.3600000000001
1448,95081571,2023-02-08,60.7,1662.0600000000002
3096,95081571,2023-02-09,156.71,1818.7700000000002
1733,95081571,2023-02-13,104.02,1922.7900000000002
2855,95113741,2023-01-31,,102.12
1862,95113741,2023-02-02,113.73,215.85000000000002
2326,95113741,2023-02-03,189.03,404.88
8066,95113741,2023-02-07,171.53,576.41
8096,95113741,2023-02-08,63.41,639.8199999999999
2856,95213279,2023-01-31,,441.59
1029,95213279,2023-02-04,-7.06,434.53
2229,95213279,2023-02-04,-85.93,348.59999999999997
302,95213279,2023-02-05,-33.85,314.74999999999994
7965,95213279,2023-02-07,-50.49,264.26
8525,95213279,2023-02-08,-2591.7,-2327.4399999999996
3848,95213279,2023-02-11,-96.92,-2424.3599999999997
2857,95258436,2023-01-31,,59.55
3365,95258436,2023-02-02,139.25,198.8
742,95258436,2023-02-02,-89.87,108.93
303,95258436,2023-02-02,-158.32,-49.389999999999986
6135,95258436,2023-02-06,75.55,26.16000000000001
1191,95258436,2023-02-09,141.82,167.98000000000002
266,95258436,2023-02-09,112.05,280.03000000000003
5819,95258436,2023-02-10,121.81,401.84000000000003
5812,95258436,2023-02-14,963.5,1365.3400000000001
5485,95258436,2023-02-14,-101.59,1263.75
4719,95258436,2023-02-14,-105.98,1157.77
2858,95274344,2023-01-31,,990.84
3616,95274344,2023-02-05,159.79,1150.63
2216,95274344,2023-02-05,-165.04,985.59
8006,95274344,2023-02-05,-962.0,23.590000000000032
4717,95274344,2023-02-06,-99.03,-75.43999999999997
1548,95274344,2023-02-08,123.12,47.680000000000035
4813,95274344,2023-02-14,-85.48,-37.79999999999997
2859,95277712,2023-01-31,,235.91
5597,95277712,2023-02-03,83.69,319.6
516,95277712,2023-02-04,-88.83,230.76999999999998
1809,95277712,2023-02-05,99.25,330.02
400,95277712,2023-02-07,-123.68,206.33999999999997
2958,95277712,2023-02-11,-133.67,72.67000000000002
4701,95277712,2023-02-12,-934.7,-862.03
2860,95307629,2023-01-31,,502.48
600,95307629,2023-02-01,89.15,591.63
8390,95307629,2023-02-05,41.65,633.28
909,95307629,2023-02-09,-1324.2,-690.9200000000001
4118,95307629,2023-02-12,-68.37,-759.2900000000001
1154,95307629,2023-02-14,171.69,-587.6000000000001
4309,95307629,2023-02-14,31.7,-555.9000000000001
2861,95309911,2023-01-31,,171.61
3811,95309911,2023-02-01,-82.42,89.19000000000001
7673,95309911,2023-02-02,110.35,199.54000000000002
621,95309911,2023-02-05,39.2,238.74
3168,95309911,2023-02-06,154.75,393.49
8343,95309911,2023-02-06,32.34,425.83000000000004
1266,95309911,2023-02-09,363.8,789.63
2320,95309911,2023-02-09,-97.89,691.74
1841,95309911,2023-02-12,109.26,801.0
2862,95356167,2023-01-31,,170.2
1053,95356167,2023-02-08,-38.77,131.42999999999998
5981,95356167,2023-02-10,28.58,160.01
251,95356167,2023-02-12,103.79,263.79999999999995
699,95356167,2023-02-14,123.85,387.65
2863,95367755,2023-01-31,,926.51
1671,95367755,2023-02-04,-622.4,304.11
1599,95367755,2023-02-07,70.62,374.73
1559,95367755,2023-02-08,-130.71,244.02
2870,95367755,2023-02-13,63.17,307.19
3117,95367755,2023-02-13,-101.66,205.53000000000003
2864,95390412,2023-01-31,,553.04
4725,95390412,2023-02-01,-149.8,403.23999999999995
762,95390412,2023-02-02,-52.25,350.98999999999995
1451,95390412,2023-02-03,79.35,430.3399999999999
7734,95390412,2023-02-07,98.57,528.91
831,95390412,2023-02-09,-1176.8,-647.89
5720,95390412,2023-02-11,-100.23,-748.12
2865,95412973,2023-01-31,,892.85
6810,95412973,2023-02-02,-200.43,692.4200000000001
311,95412973,2023-02-10,-163.93,528.49
2781,95412973,2023-02-13,-33.78,494.71000000000004
2866,95446510,2023-01-31,,581.43
7751,95446510,2023-02-04,121.95,703.38
998,95446510,2023-02-04,88.15,791.53
4207,95446510,2023-02-04,-200.42,591.1099999999999
3775,95446510,2023-02-06,-45.01,546.0999999999999
4061,95446510,2023-02-08,-129.87,416.22999999999996
6133,95446510,2023-02-13,-96.41,319.81999999999994
2867,95452518,2023-01-31,,390.37
451,95452518,2023-02-06,172.27,562.64
815,95452518,2023-02-08,-110.07,452.57000000000005
1415,95452518,2023-02-12,-86.17,366.40000000000003
2868,95467370,2023-01-31,,307.45
3044,95467370,2023-02-02,1273.1,1580.55
5142,95467370,2023-02-03,31.0,1611.55
3897,95467370,2023-02-04,50.69,1662.24
7843,95467370,2023-02-05,-20.31,1641.93
7166,95467370,2023-02-06,-124.17,1517.76
4158,95467370,2023-02-09,-73.6,1444.1599999999999
5101,95467370,2023-02-10,162.32,1606.48
2869,95527674,2023-01-31,,688.37
6920,95527674,2023-02-01,164.94,853.31
4393,95527674,2023-02-03,-145.97,707.34
3398,95527674,2023-02-07,-86.51,620.83
6613,95527674,2023-02-09,123.88,744.71
3342,95527674,2023-02-09,-102.14,642.5699999999999
4502,95527674,2023-02-11,133.59,776.16
1496,95527674,2023-02-11,107.57,883.73
5314,95527674,2023-02-11,106.62,990.35
7115,95527674,2023-02-14,-167.84,822.51
2870,95564462,2023-01-31,,643.45
3220,95564462,2023-02-04,165.42,808.87
6008,95564462,2023-02-06,-22.99,785.88
2660,95564462,2023-02-12,78.89,864.77
2871,95600095,2023-01-31,,400.05
7867,95600095,2023-02-07,125.12,525.1700000000001
6057,95600095,2023-02-12,91.81,616.98
3504,95600095,2023-02-13,-125.16,491.82000000000005
2872,95642341,2023-01-31,,695.88
5743,95642341,2023-02-01,546.3,1242.1799999999998
3704,95642341,2023-02-05,-97.45,1144.73
5462,95642341,2023-02-07,-56.49,1088.24
2932,95642341,2023-02-10,-1375.3,-287.05999999999995
4529,95642341,2023-02-12,134.41,-152.64999999999995
3535,95642341,2023-02-13,104.51,-48.139999999999944
1495,95642341,2023-02-13,42.26,-5.879999999999946
3539,95642341,2023-02-14,-175.48,-181.35999999999993
2873,95645055,2023-01-31,,645.58
8356,95645055,2023-02-06,78.61,724.19
4626,95645055,2023-02-10,99.28,823.47
2152,95645055,2023-02-11,24.18,847.6500000000001
4266,95645055,2023-02-11,-40.71,806.94
2874,95674888,2023-01-31,,838.92
4030,95674888,2023-02-01,124.86,963.78
3382,95674888,2023-02-08,-19.59,944.1899999999999
7645,95674888,2023-02-13,1258.1,2202.29
1300,95674888,2023-02-13,77.47,2279.7599999999998
1519,95674888,2023-02-13,4.66,2284.42
7182,95674888,2023-02-13,-49.89,2234.5299999999997
5604,95674888,2023-02-14,178.46,2412.99
2875,95710324,2023-01-31,,978.16
1634,95710324,2023-02-02,-30.01,948.15
2626,95710324,2023-02-02,-82.72,865.43
3238,95710324,2023-02-09,-188.14,677.29
6884,95710324,2023-02-10,1484.2,2161.49
4787,95710324,2023-02-10,73.65,2235.14
3458,95710324,2023-02-10,-142.13,2093.01
2876,95723006,2023-01-31,,861.2
2476,95723006,2023-02-04,1084.8,1946.0
3729,95723006,2023-02-06,-83.83,1862.17
2855,95723006,2023-02-09,-96.82,1765.35
1480,95723006,2023-02-10,128.96,1894.31
5994,95723006,2023-02-10,91.88,1986.19
3660,95723006,2023-02-11,-73.66,1912.53
2877,95743658,2023-01-31,,586.9
3254,95743658,2023-02-01,58.18,645.0799999999999
3174,95743658,2023-02-02,-86.69,558.39
8042,95743658,2023-02-03,-147.01,411.38
4120,95743658,2023-02-07,934.2,1345.58
3108,95743658,2023-02-07,107.79,1453.3700000000001
3796,95743658,2023-02-07,54.63,1508.0
5482,95743658,2023-02-09,-96.52,1411.48
3255,95743658,2023-02-09,-121.16,1290.3200000000002
2305,95743658,2023-02-11,96.16,1386.48
37,95743658,2023-02-12,27.74,1414.22
860,95743658,2023-02-13,81.01,1495.23
2878,95759022,2023-01-31,,78.02
2191,95759022,2023-02-01,76.39,154.41
5632,95759022,2023-02-02,-28.18,126.22999999999999
302,95759022,2023-02-05,33.85,160.07999999999998
834,95759022,2023-02-06,179.08,339.16
4444,95759022,2023-02-09,484.0,823.1600000000001
5494,95759022,2023-02-09,-156.08,667.08
2879,95868007,2023-01-31,,974.32
4696,95868007,2023-02-01,-89.15,885.1700000000001
2024,95868007,2023-02-02,-69.41,815.76
2751,95868007,2023-02-03,-267.7,548.0600000000001
3901,95868007,2023-02-05,-134.55,413.51000000000005
5832,95868007,2023-02-06,56.08,469.59000000000003
4611,95868007,2023-02-06,-92.7,376.89000000000004
2753,95868007,2023-02-06,-95.31,281.58000000000004
1483,95868007,2023-02-07,79.32,360.90000000000003
1274,95868007,2023-02-11,-134.5,226.40000000000003
2880,95898143,2023-01-31,,197.65
1251,95898143,2023-02-05,97.37,295.02
6648,95898143,2023-02-09,-50.63,244.39000000000001
2000,95898143,2023-02-10,-782.2,-537.8100000000001
4033,95898143,2023-02-12,109.9,-427.9100000000001
2881,95993993,2023-01-31,,95.41
3393,95993993,2023-02-03,-1266.7,-1171.29
1492,95993993,2023-02-07,113.79,-1057.5
4728,95993993,2023-02-13,38.7,-1018.8
6382,95993993,2023-02-14,1137.7,118.90000000000009
2882,96050548,2023-01-31,,299.46
8667,96050548,2023-02-04,-72.83,226.63
2681,96050548,2023-02-08,125.91,352.53999999999996
181,96050548,2023-02-09,102.32,454.85999999999996
6335,96050548,2023-02-09,-84.55,370.30999999999995
5848,96050548,2023-02-11,-107.86,262.45
2883,96051784,2023-01-31,,21.7
6858,96051784,2023-02-01,111.89,133.59
8195,96051784,2023-02-05,-1121.5,-987.91
1701,96051784,2023-02-06,99.31,-888.5999999999999
3569,96051784,2023-02-07,77.46,-811.14
6556,96051784,2023-02-13,-141.46,-952.5999999999999
2884,96121732,2023-01-31,,771.81
5700,96121732,2023-02-01,84.68,856.49
5548,96121732,2023-02-01,-101.68,754.81
6116,96121732,2023-02-04,70.76,825.5699999999999
2424,96121732,2023-02-04,-81.94,743.63
2840,96121732,2023-02-05,98.3,841.93
2840,96121732,2023-02-05,-98.3,743.63
5951,96121732,2023-02-05,-99.15,644.4799999999999
1906,96121732,2023-02-10,102.74,747.2199999999999
2556,96121732,2023-02-11,1669.7,2416.92
553,96121732,2023-02-11,-75.16,2341.7599999999998
3248,96121732,2023-02-13,164.0,2505.7599999999998
5467,96121732,2023-02-13,99.06,2604.8199999999997
1827,96121732,2023-02-14,-164.38,2440.44
2885,96153427,2023-01-31,,24.33
3774,96153427,2023-02-01,84.08,108.41
2711,96153427,2023-02-03,120.56,228.97
5536,96153427,2023-02-07,85.35,314.32
2886,96197628,2023-01-31,,829.37
5864,96197628,2023-02-04,-104.91,724.46
277,96197628,2023-02-08,-27.53,696.9300000000001
6915,96197628,2023-02-13,134.97,831.9
2887,96200049,2023-01-31,,959.58
6375,96200049,2023-02-01,61.23,1020.8100000000001
5307,96200049,2023-02-02,94.5,1115.31
5632,96200049,2023-02-02,28.18,1143.49
7441,96200049,2023-02-03,141.04,1284.53
4984,96200049,2023-02-03,43.6,1328.13
409,96200049,2023-02-13,23.37,1351.5
2888,96208050,2023-01-31,,171.46
4837,96208050,2023-02-01,-48.99,122.47
1942,96208050,2023-02-01,-139.18,-16.710000000000008
8591,96208050,2023-02-08,-100.19,-116.9
6229,96208050,2023-02-09,99.18,-17.72
1523,96208050,2023-02-10,-115.74,-133.45999999999998
479,96208050,2023-02-11,89.22,-44.239999999999995
5141,96208050,2023-02-12,92.93,48.69000000000001
2889,96224831,2023-01-31,,926.76
5069,96224831,2023-02-02,-46.46,880.3
4739,96224831,2023-02-03,107.3,987.6
1760,96224831,2023-02-06,-66.16,921.44
7058,96224831,2023-02-09,-108.36,813.08
1988,96224831,2023-02-10,168.64,981.72
4567,96224831,2023-02-11,91.93,1073.65
4347,96224831,2023-02-12,1265.1,2338.75
649,96224831,2023-02-14,-113.07,2225.68
2890,96227490,2023-01-31,,242.11
3162,96227490,2023-02-05,118.23,360.34000000000003
4229,96227490,2023-02-07,945.2,1305.54
7468,96227490,2023-02-07,-162.51,1143.0300000000002
5644,96227490,2023-02-12,-1291.9,-148.8699999999999
4523,96227490,2023-02-13,-48.77,-197.6399999999999
8447,96227490,2023-02-14,-76.93,-274.56999999999994
2891,96236719,2023-01-31,,999.32
2474,96236719,2023-02-02,1015.8,2015.12
4491,96236719,2023-02-03,-177.67,1837.45
46,96236719,2023-02-09,55.83,1893.28
7703,96236719,2023-02-13,1370.1,3263.38
2892,96278865,2023-01-31,,930.45
8200,96278865,2023-02-06,1069.0,1999.45
4879,96278865,2023-02-06,100.71,2100.16
3332,96278865,2023-02-07,69.22,2169.38
6179,96278865,2023-02-07,-1298.9,870.48
7635,96278865,2023-02-09,37.9,908.38
2893,96281358,2023-01-31,,463.07
3708,96281358,2023-02-06,49.54,512.61
5894,96281358,2023-02-08,163.93,676.54
4290,96281358,2023-02-11,-56.16,620.38
2894,96291927,2023-01-31,,227.22
1923,96291927,2023-02-01,79.4,306.62
7496,96291927,2023-02-03,-84.7,221.92000000000002
2040,96291927,2023-02-07,-146.76,75.16000000000003
799,96291927,2023-02-09,-99.44,-24.279999999999973
6613,96291927,2023-02-09,-123.88,-148.15999999999997
256,96291927,2023-02-12,148.17,0.010000000000019327
389,96291927,2023-02-14,38.4,38.41000000000002
2895,96319450,2023-01-31,,779.16
4246,96319450,2023-02-01,186.45,965.6099999999999
1971,96319450,2023-02-09,16.12,981.7299999999999
2566,96319450,2023-02-10,-38.95,942.78
7768,96319450,2023-02-11,-207.88,734.9
4695,96319450,2023-02-13,119.69,854.5899999999999
2896,96367781,2023-01-31,,880.44
2897,96367914,2023-01-31,,528.67
1022,96367914,2023-02-09,155.69,684.3599999999999
2073,96367914,2023-02-12,-18.96,665.4
2898,96401230,2023-01-31,,21.44
2874,96401230,2023-02-01,1663.4,1684.8400000000001
1452,96401230,2023-02-02,-198.28,1486.5600000000002
7428,96401230,2023-02-03,-44.59,1441.9700000000003
5452,96401230,2023-02-03,-85.24,1356.7300000000002
8459,96401230,2023-02-07,-24.41,1332.3200000000002
5236,96401230,2023-02-08,96.33,1428.65
1679,96401230,2023-02-08,-797.2,631.45
5917,96401230,2023-02-11,-1813.6,-1182.1499999999999
2899,96510893,2023-01-31,,396.83
6043,96510893,2023-02-02,185.26,582.0899999999999
5164,96510893,2023-02-09,74.41,656.5
2112,96510893,2023-02-11,-782.2,-125.70000000000005
3547,96510893,2023-02-14,-108.65,-234.35000000000005
2900,96605778,2023-01-31,,70.72
7988,96605778,2023-02-01,-112.98,-42.260000000000005
1911,96605778,2023-02-02,-116.89,-159.15
2603,96605778,2023-02-02,-158.28,-317.43
5758,96605778,2023-02-04,-303.4,-620.8299999999999
8545,96605778,2023-02-08,697.8,76.97000000000003
3210,96605778,2023-02-09,75.39,152.36
6171,96605778,2023-02-09,51.97,204.33000000000004
5174,96605778,2023-02-09,-226.54,-22.20999999999998
2901,96649120,2023-01-31,,307.91
1966,96649120,2023-02-04,105.93,413.84000000000003
1316,96649120,2023-02-05,-46.34,367.5
7798,96649120,2023-02-05,-126.99,240.51000000000005
2930,96649120,2023-02-07,98.77,339.28000000000003
7074,96649120,2023-02-07,79.53,418.81000000000006
1825,96649120,2023-02-08,-135.91,282.90000000000003
1087,96649120,2023-02-12,-36.33,246.57000000000005
6684,96649120,2023-02-13,53.33,299.90000000000003
2902,96689242,2023-01-31,,896.22
4167,96689242,2023-02-01,45.7,941.9200000000001
8672,96689242,2023-02-03,85.62,1027.54
6601,96689242,2023-02-05,142.12,1169.66
5799,96689242,2023-02-06,-1253.1,-83.43999999999983
4560,96689242,2023-02-11,82.15,-1.2899999999998215
2903,96719450,2023-01-31,,633.74
190,96719450,2023-02-07,-744.0,-110.25999999999999
7518,96719450,2023-02-08,118.94,8.680000000000007
6585,96719450,2023-02-08,-104.01,-95.33
7940,96719450,2023-02-10,1362.1,1266.77
3338,96719450,2023-02-10,82.33,1349.1
709,96719450,2023-02-11,-59.16,1289.94
6394,96719450,2023-02-11,-86.86,1203.08
5023,96719450,2023-02-11,-754.3,448.78
2904,96756719,2023-01-31,,601.68
3037,96756719,2023-02-04,-69.05,532.63
2835,96756719,2023-02-05,-49.84,482.78999999999996
4308,96756719,2023-02-06,-64.62,418.16999999999996
1514,96756719,2023-02-06,-887.9,-469.73
7789,96756719,2023-02-07,113.6,-356.13
5674,96756719,2023-02-07,-155.69,-511.82000000000005
6180,96756719,2023-02-08,-104.55,-616.37
8679,96756719,2023-02-10,871.2,254.83000000000004
8010,96756719,2023-02-12,61.95,316.78000000000003
6468,96756719,2023-02-13,-154.58,162.20000000000005
2905,96837696,2023-01-31,,889.9
2071,96837696,2023-02-05,-1131.8,-241.89999999999998
5343,96837696,2023-02-07,-164.7,-406.59999999999997
6520,96837696,2023-02-08,19.11,-387.48999999999995
8417,96837696,2023-02-11,-173.7,-561.1899999999999
2906,96847078,2023-01-31,,412.48
5030,96847078,2023-02-01,105.94,518.4200000000001
2269,96847078,2023-02-02,-179.67,338.75
6876,96847078,2023-02-08,105.67,444.42
1627,96847078,2023-02-08,-24.38,420.04
6845,96847078,2023-02-10,121.67,541.71
3000,96847078,2023-02-10,-118.13,423.58000000000004
6119,96847078,2023-02-13,20.17,443.75000000000006
2907,96948178,2023-01-31,,217.26
4292,96948178,2023-02-07,86.52,303.78
2933,96948178,2023-02-07,-71.18,232.59999999999997
3200,96948178,2023-02-08,103.89,336.49
8538,96948178,2023-02-10,-80.58,255.90999999999997
1371,96948178,2023-02-12,134.36,390.27
2908,97010482,2023-01-31,,542.39
7796,97010482,2023-02-01,83.77,626.16
7399,97010482,2023-02-05,103.38,729.54
8543,97010482,2023-02-09,-41.77,687.77
4152,97010482,2023-02-13,78.01,765.78
2909,97036090,2023-01-31,,349.78
5044,97036090,2023-02-03,-161.37,188.40999999999997
3432,97036090,2023-02-04,118.37,306.78
3876,97036090,2023-02-06,86.95,393.72999999999996
6391,97036090,2023-02-09,951.0,1344.73
1454,97036090,2023-02-09,65.76,1410.49
2910,97048058,2023-01-31,,977.42
8355,97048058,2023-02-03,584.3,1561.7199999999998
7023,97048058,2023-02-03,96.94,1658.6599999999999
2145,97048058,2023-02-08,-77.23,1581.4299999999998
6910,97048058,2023-02-09,-121.34,1460.09
281,97048058,2023-02-10,103.59,1563.6799999999998
2911,97098684,2023-01-31,,463.91
7601,97098684,2023-02-01,-0.96,462.95000000000005
6423,97098684,2023-02-03,72.77,535.72
585,97098684,2023-02-04,76.94,612.6600000000001
1823,97098684,2023-02-05,144.38,757.04
7147,97098684,2023-02-07,-68.86,688.1800000000001
7423,97098684,2023-02-08,204.91,893.09
2912,97187999,2023-01-31,,170.66
6590,97187999,2023-02-01,43.65,214.31
4320,97187999,2023-02-03,-94.5,119.81
7592,97187999,2023-02-05,-27.88,91.93
3438,97187999,2023-02-10,-70.11,21.820000000000007
4026,97187999,2023-02-11,-9.25,12.570000000000007
3497,97187999,2023-02-13,518.3,530.87
7278,97187999,2023-02-14,-60.02,470.85
986,97187999,2023-02-14,-725.0,-254.14999999999998
2913,97258853,2023-01-31,,348.49
640,97258853,2023-02-01,106.33,454.82
5507,97258853,2023-02-02,1157.4,1612.22
8360,97258853,2023-02-03,78.66,1690.88
6880,97258853,2023-02-06,1912.9,3603.78
1898,97258853,2023-02-06,-833.9,2769.88
7146,97258853,2023-02-11,157.05,2926.9300000000003
7175,97258853,2023-02-12,-81.63,2845.3
3109,97258853,2023-02-14,-47.84,2797.46
2914,97265555,2023-01-31,,73.24
1795,97265555,2023-02-01,137.25,210.49
5019,97265555,2023-02-03,99.42,309.91
5163,97265555,2023-02-04,-77.66,232.25
2756,97265555,2023-02-09,-159.05,73.19999999999999
8290,97265555,2023-02-13,-158.03,-84.83000000000001
2915,97294152,2023-01-31,,700.06
780,97294152,2023-02-01,1194.4,1894.46
8034,97294152,2023-02-01,120.93,2015.39
3376,97294152,2023-02-01,3.55,2018.94
2465,97294152,2023-02-03,-240.55,1778.39
4327,97294152,2023-02-04,-153.31,1625.08
7468,97294152,2023-02-07,162.51,1787.5900000000001
4483,97294152,2023-02-11,-159.09,1628.5
1026,97294152,2023-02-12,-95.61,1532.89
1346,97294152,2023-02-13,-111.96,1420.93
4901,97294152,2023-02-14,-149.9,1271.03
2916,97305293,2023-01-31,,241.02
3215,97305293,2023-02-03,196.95,437.97
4799,97305293,2023-02-09,145.02,582.99
804,97305293,2023-02-10,-158.94,424.05
4754,97305293,2023-02-11,-99.56,324.49
7333,97305293,2023-02-14,-65.5,258.99
2917,97328154,2023-01-31,,535.51
2797,97328154,2023-02-03,-90.64,444.87
3548,97328154,2023-02-07,-78.9,365.96999999999997
3279,97328154,2023-02-08,-143.22,222.75
4141,97328154,2023-02-09,135.18,357.93
3178,97328154,2023-02-11,55.67,413.6
1496,97328154,2023-02-11,-107.57,306.03000000000003
2918,97405607,2023-01-31,,981.02
5160,97405607,2023-02-02,93.09,1074.11
551,97405607,2023-02-06,527.4,1601.51
3111,97405607,2023-02-06,5.35,1606.86
8173,97405607,2023-02-08,-147.08,1459.78
4035,97405607,2023-02-10,-98.32,1361.46
4592,97405607,2023-02-11,56.36,1417.82
4073,97405607,2023-02-12,122.13,1539.95
7866,97405607,2023-02-12,-139.57,1400.38
6443,97405607,2023-02-13,144.57,1544.95
2919,97426293,2023-01-31,,771.74
7879,97426293,2023-02-03,-44.25,727.49
3563,97426293,2023-02-08,-4.84,722.65
4189,97426293,2023-02-10,-28.23,694.42
7495,97426293,2023-02-11,-116.14,578.28
8618,97426293,2023-02-12,-26.9,551.38
7698,97426293,2023-02-12,-112.63,438.75
5676,97426293,2023-02-14,-79.54,359.21
2920,97439311,2023-01-31,,196.91
3635,97439311,2023-02-06,74.25,271.15999999999997
6565,97439311,2023-02-06,-43.59,227.57
8347,97439311,2023-02-07,218.5,446.07
7152,97439311,2023-02-10,705.9,1151.97
4066,97439311,2023-02-13,-2.0,1149.9699999999998
8541,97439311,2023-02-14,136.93,1286.8999999999999
2921,97445899,2023-01-31,,195.42
8020,97445899,2023-02-01,-473.7,-278.28
8557,97445899,2023-02-04,94.61,-183.67000000000002
3823,97445899,2023-02-04,-123.12,-306.79
4078,97445899,2023-02-06,42.54,-264.25000000000006
4902,97445899,2023-02-08,-687.1,-951.3500000000001
2922,97487639,2023-01-31,,403.96
6457,97487639,2023-02-01,110.45,514.41
622,97487639,2023-02-01,-119.97,394.44
4850,97487639,2023-02-02,151.59,546.03
3427,97487639,2023-02-03,48.79,594.8199999999999
2621,97487639,2023-02-08,157.04,751.8599999999999
8313,97487639,2023-02-09,-1582.3,-830.44
3310,97487639,2023-02-10,200.96,-629.48
2923,97501557,2023-01-31,,572.14
462,97501557,2023-02-05,148.09,720.23
7141,97501557,2023-02-08,-114.12,606.11
7018,97501557,2023-02-10,144.36,750.47
5323,97501557,2023-02-10,41.65,792.12
1490,97501557,2023-02-10,-66.98,725.14
6867,97501557,2023-02-10,-87.35,637.79
2924,97521278,2023-01-31,,833.78
3876,97521278,2023-02-06,-86.95,746.8299999999999
6547,97521278,2023-02-08,-165.57,581.26
2012,97521278,2023-02-10,121.92,703.18
4680,97521278,2023-02-13,-66.09,637.09
8649,97521278,2023-02-14,-120.16,516.93
2925,97526378,2023-01-31,,540.88
5613,97526378,2023-02-02,-63.42,477.46
3631,97526378,2023-02-03,-769.3,-291.84
4207,97526378,2023-02-04,200.42,-91.41999999999999
41,97526378,2023-02-07,-55.28,-146.7
7136,97526378,2023-02-12,-89.7,-236.39999999999998
2926,97541080,2023-01-31,,677.34
4628,97541080,2023-02-03,102.16,779.5
1778,97541080,2023-02-11,-2361.6,-1582.1
2927,97542348,2023-01-31,,768.87
1978,97542348,2023-02-01,97.36,866.23
7355,97542348,2023-02-01,77.94,944.17
1799,97542348,2023-02-02,33.06,977.23
7025,97542348,2023-02-03,89.38,1066.61
8462,97542348,2023-02-05,-897.5,169.11
928,97542348,2023-02-06,114.33,283.44
2101,97542348,2023-02-06,-193.06,90.38
3339,97542348,2023-02-14,-187.3,-96.92000000000002
2928,97555037,2023-01-31,,405.29
7480,97555037,2023-02-05,141.29,546.58
3552,97555037,2023-02-10,67.07,613.65
4676,97555037,2023-02-14,175.06,788.71
6945,97555037,2023-02-14,-77.4,711.31
2929,97558121,2023-01-31,,699.28
1534,97558121,2023-02-05,135.59,834.87
6879,97558121,2023-02-08,-119.07,715.8
7894,97558121,2023-02-14,132.91,848.71
7102,97558121,2023-02-14,105.11,953.8199999999999
1783,97558121,2023-02-14,53.27,1007.09
2930,97571696,2023-01-31,,622.92
8128,97571696,2023-02-01,1361.0,1983.92
2106,97571696,2023-02-08,15.71,1999.63
2931,97581232,2023-01-31,,608.89
2701,97581232,2023-02-07,135.32,744.21
8404,97581232,2023-02-09,1166.4,1910.6100000000001
2738,97581232,2023-02-11,134.72,2045.3300000000002
5433,97581232,2023-02-12,-143.91,1901.42
5140,97581232,2023-02-12,-146.24,1755.18
2932,97624673,2023-01-31,,481.09
426,97624673,2023-02-07,-92.81,388.28
7211,97624673,2023-02-08,95.08,483.35999999999996
2190,97624673,2023-02-11,130.33,613.69
8578,97624673,2023-02-13,116.67,730.36
2933,97738591,2023-01-31,,254.4
7934,97738591,2023-02-09,101.26,355.66
3243,97738591,2023-02-12,-88.41,267.25
209,97738591,2023-02-14,81.15,348.40000000000003
2934,97762952,2023-01-31,,411.87
1909,97762952,2023-02-01,-38.91,372.96000000000004
4997,97762952,2023-02-02,-15.44,357.52
4613,97762952,2023-02-04,-97.94,259.58000000000004
1986,97762952,2023-02-08,128.28,387.86
4604,97762952,2023-02-09,-101.53,286.33000000000004
548,97762952,2023-02-11,471.8,758.13
6979,97762952,2023-02-13,-113.3,644.83
2935,97773835,2023-01-31,,165.51
8611,97773835,2023-02-03,-72.44,93.07
3086,97773835,2023-02-09,-134.52,-41.45000000000002
2936,97843608,2023-01-31,,19.05
6541,97843608,2023-02-03,349.6,368.65000000000003
7692,97843608,2023-02-04,111.47,480.12
4548,97843608,2023-02-06,22.17,502.29
7994,97843608,2023-02-12,104.69,606.98
6605,97843608,2023-02-13,-187.8,419.18
2937,97844854,2023-01-31,,547.15
5155,97844854,2023-02-02,-142.95,404.2
7680,97844854,2023-02-12,-133.45,270.75
1602,97844854,2023-02-14,-91.73,179.01999999999998
2938,97870414,2023-01-31,,818.88
8544,97870414,2023-02-01,-160.61,658.27
2426,97870414,2023-02-01,-913.5,-255.23000000000002
4602,97870414,2023-02-03,-195.63,-450.86
6981,97870414,2023-02-06,-374.5,-825.36
5655,97870414,2023-02-07,-164.87,-990.23
3843,97870414,2023-02-12,-81.53,-1071.76
2939,97913385,2023-01-31,,498.49
1398,97913385,2023-02-01,98.26,596.75
7544,97913385,2023-02-01,50.55,647.3
6775,97913385,2023-02-03,117.86,765.16
3120,97913385,2023-02-05,-78.62,686.54
589,97913385,2023-02-08,-362.6,323.94
4773,97913385,2023-02-10,210.62,534.56
619,97913385,2023-02-10,-27.72,506.84000000000003
1600,97913385,2023-02-13,74.3,581.14
2940,97935683,2023-01-31,,40.96
76,97935683,2023-02-06,-152.16,-111.19999999999999
4859,97935683,2023-02-14,-173.88,-285.08
2941,97939041,2023-01-31,,320.97
2272,97939041,2023-02-04,66.17,387.14000000000004
5455,97939041,2023-02-06,-68.88,318.26000000000005
2911,97939041,2023-02-11,792.4,1110.66
7465,97939041,2023-02-11,-18.39,1092.27
3093,97939041,2023-02-13,80.1,1172.37
5770,97939041,2023-02-13,-145.1,1027.27
2942,97944124,2023-01-31,,258.19
7359,97944124,2023-02-14,-100.16,158.03
2943,97954732,2023-01-31,,506.16
5583,97954732,2023-02-04,-142.88,363.28000000000003
7351,97954732,2023-02-11,116.92,480.20000000000005
8288,97954732,2023-02-14,154.35,634.55
2944,97970258,2023-01-31,,309.14
150,97970258,2023-02-01,-35.88,273.26
600,97970258,2023-02-01,-89.15,184.10999999999999
4134,97970258,2023-02-03,-110.38,73.72999999999999
100,97970258,2023-02-08,-64.87,8.859999999999985
240,97970258,2023-02-11,-72.82,-63.96000000000001
8424,97970258,2023-02-12,-94.05,-158.01
314,97970258,2023-02-13,-37.31,-195.32
2945,97983552,2023-01-31,,584.92
7610,97983552,2023-02-01,670.1,1255.02
7724,97983552,2023-02-03,-214.53,1040.49
6880,97983552,2023-02-06,-1912.9,-872.4100000000001
3265,97983552,2023-02-10,-819.0,-1691.41
2946,97985291,2023-01-31,,234.19
1696,97985291,2023-02-02,-53.0,181.19
7949,97985291,2023-02-03,79.51,260.7
2546,97985291,2023-02-05,131.72,392.42
3292,97985291,2023-02-08,187.67,580.09
5913,97985291,2023-02-08,-62.88,517.21
3549,97985291,2023-02-13,-123.05,394.15999999999997
2947,97988499,2023-01-31,,344.28
7375,97988499,2023-02-01,-97.37,246.90999999999997
4957,97988499,2023-02-05,104.95,351.85999999999996
1223,97988499,2023-02-06,-160.17,191.69
5100,97988499,2023-02-08,1026.8,1218.49
49,97988499,2023-02-12,127.05,1345.54
4489,97988499,2023-02-12,-98.15,1247.39
2948,98043237,2023-01-31,,491.59
2734,98043237,2023-02-02,-99.34,392.25
7372,98043237,2023-02-08,-154.2,238.04999999999998
7666,98043237,2023-02-08,-473.2,-235.15
1422,98043237,2023-02-13,78.91,-156.24
3863,98043237,2023-02-13,-75.02,-231.26
2949,98070849,2023-01-31,,993.94
6834,98070849,2023-02-01,140.27,1134.21
3995,98070849,2023-02-01,125.14,1259.3500000000001
7948,98070849,2023-02-01,54.98,1314.3300000000002
4721,98070849,2023-02-01,-106.8,1207.53
549,98070849,2023-02-04,132.93,1340.46
2276,98070849,2023-02-08,442.3,1782.7600000000002
3920,98070849,2023-02-08,-110.55,1672.21
7633,98070849,2023-02-11,96.9,1769.1100000000001
3960,98070849,2023-02-11,68.2,1837.3100000000002
7232,98070849,2023-02-14,120.46,1957.7700000000002
2950,98107200,2023-01-31,,325.82
5520,98107200,2023-02-02,140.34,466.15999999999997
4041,98107200,2023-02-03,-9.03,457.13
2808,98107200,2023-02-03,-66.9,390.23
5641,98107200,2023-02-10,55.17,445.4
2951,98112233,2023-01-31,,123.26
178,98112233,2023-02-01,-54.5,68.76
1016,98112233,2023-02-04,163.03,231.79000000000002
2610,98112233,2023-02-04,111.88,343.66999999999996
8049,98112233,2023-02-04,74.95,418.62
2450,98112233,2023-02-04,-129.37,289.25
5750,98112233,2023-02-05,146.29,435.53999999999996
2294,98112233,2023-02-05,-44.78,390.76
2970,98112233,2023-02-06,75.16,465.91999999999996
2120,98112233,2023-02-06,-739.3,-273.38
1958,98112233,2023-02-13,114.36,-159.01999999999998
8642,98112233,2023-02-13,113.41,-45.61
8678,98112233,2023-02-13,-101.49,-147.1
2952,98119030,2023-01-31,,179.3
743,98119030,2023-02-04,75.25,254.55
6532,98119030,2023-02-04,48.63,303.18
8319,98119030,2023-02-07,89.15,392.33000000000004
1408,98119030,2023-02-14,-81.37,310.96000000000004
2953,98138904,2023-01-31,,885.18
4467,98138904,2023-02-08,-40.97,844.2099999999999
2714,98138904,2023-02-10,46.29,890.5
2283,98138904,2023-02-13,-126.07,764.43
1067,98138904,2023-02-14,-118.69,645.74
2954,98156945,2023-01-31,,449.81
1127,98156945,2023-02-02,45.22,495.03
5441,98156945,2023-02-06,711.2,1206.23
4556,98156945,2023-02-07,-1567.0,-360.77
3049,98156945,2023-02-08,150.5,-210.26999999999998
6198,98156945,2023-02-12,44.88,-165.39
4822,98156945,2023-02-14,60.92,-104.46999999999997
2955,98159348,2023-01-31,,703.62
494,98159348,2023-02-02,-61.45,642.17
7253,98159348,2023-02-04,-503.6,138.57
3801,98159348,2023-02-10,128.06,266.63
3014,98159348,2023-02-11,63.01,329.64
2310,98159348,2023-02-14,92.59,422.23
2956,98221133,2023-01-31,,596.52
4750,98221133,2023-02-01,97.92,694.4399999999999
4927,98221133,2023-02-03,-55.63,638.81
7382,98221133,2023-02-05,111.54,750.35
6720,98221133,2023-02-06,33.32,783.67
5461,98221133,2023-02-06,-28.71,754.96
8448,98221133,2023-02-08,1002.0,1756.96
5888,98221133,2023-02-09,89.48,1846.44
639,98221133,2023-02-09,-132.75,1713.69
562,98221133,2023-02-11,-557.0,1156.69
7144,98221133,2023-02-12,37.35,1194.04
5861,98221133,2023-02-12,-62.63,1131.41
7999,98221133,2023-02-14,40.73,1172.14
2957,98237008,2023-01-31,,437.26
4407,98237008,2023-02-02,865.4,1302.6599999999999
2220,98237008,2023-02-04,61.06,1363.72
5782,98237008,2023-02-05,72.53,1436.25
4966,98237008,2023-02-08,61.29,1497.54
6829,98237008,2023-02-09,-1038.5,459.03999999999996
1939,98237008,2023-02-12,93.16,552.1999999999999
2560,98237008,2023-02-13,199.57,751.77
4551,98237008,2023-02-13,-162.05,589.7199999999999
2958,98336782,2023-01-31,,266.46
7744,98336782,2023-02-06,-34.2,232.26
5432,98336782,2023-02-06,-95.71,136.54999999999998
4251,98336782,2023-02-08,-106.87,29.67999999999998
2692,98336782,2023-02-11,128.1,157.77999999999997
7517,98336782,2023-02-13,55.26,213.03999999999996
2959,98353764,2023-01-31,,763.6
1045,98353764,2023-02-03,-179.54,584.0600000000001
6986,98353764,2023-02-04,-85.2,498.86
6288,98353764,2023-02-13,80.09,578.95
2960,98372749,2023-01-31,,136.21
1579,98372749,2023-02-01,130.44,266.65
4366,98372749,2023-02-01,-45.11,221.54000000000002
2497,98372749,2023-02-07,-101.79,119.75
7305,98372749,2023-02-09,-75.46,44.290000000000006
7708,98372749,2023-02-10,72.61,116.9
4722,98372749,2023-02-12,-44.97,71.93
2961,98377332,2023-01-31,,343.09
3132,98377332,2023-02-03,127.44,470.53
262,98377332,2023-02-08,1779.2,2249.73
7894,98377332,2023-02-14,-132.91,2116.82
2962,98459176,2023-01-31,,168.19
3047,98459176,2023-02-01,-229.8,-61.610000000000014
797,98459176,2023-02-03,-87.44,-149.05
87,98459176,2023-02-03,-88.58,-237.63
3486,98459176,2023-02-05,-135.88,-373.51
4250,98459176,2023-02-06,82.75,-290.76
4733,98459176,2023-02-07,-737.4,-1028.1599999999999
6053,98459176,2023-02-12,-155.17,-1183.33
7992,98459176,2023-02-13,-63.98,-1247.31
2963,98517701,2023-01-31,,277.91
7660,98517701,2023-02-07,54.52,332.43
5224,98517701,2023-02-09,-151.14,181.29000000000005
2964,98568929,2023-01-31,,396.03
7500,98568929,2023-02-04,157.68,553.71
6153,98568929,2023-02-05,139.75,693.46
2552,98568929,2023-02-09,-83.47,609.99
541,98568929,2023-02-13,1121.3,1731.29
6560,98568929,2023-02-14,-119.48,1611.81
2965,98575383,2023-01-31,,937.72
3854,98575383,2023-02-01,-152.59,785.13
3172,98575383,2023-02-03,-10.53,774.6
7681,98575383,2023-02-08,-87.34,687.26
2635,98575383,2023-02-09,-24.12,663.14
4424,98575383,2023-02-11,-33.32,629.82
4599,98575383,2023-02-11,-83.01,546.8100000000001
2119,98575383,2023-02-11,-99.42,447.39
7206,98575383,2023-02-13,-139.76,307.63
6443,98575383,2023-02-13,-144.57,163.06000000000003
2966,98596312,2023-01-31,,768.92
3417,98596312,2023-02-03,-174.31,594.6099999999999
6559,98596312,2023-02-06,-158.11,436.49999999999994
5251,98596312,2023-02-07,-120.62,315.87999999999994
7449,98596312,2023-02-09,88.39,404.2699999999999
3520,98596312,2023-02-09,-33.68,370.5899999999999
2967,98611122,2023-01-31,,595.22
1556,98611122,2023-02-01,12.21,607.4300000000001
4793,98611122,2023-02-01,-84.44,522.99
4495,98611122,2023-02-03,913.8,1436.79
4103,98611122,2023-02-06,76.04,1512.83
203,98611122,2023-02-07,-123.36,1389.47
5883,98611122,2023-02-09,126.2,1515.67
6284,98611122,2023-02-09,-57.19,1458.48
1065,98611122,2023-02-13,118.5,1576.98
2833,98611122,2023-02-13,-170.79,1406.19
5961,98611122,2023-02-14,-103.89,1302.3
2968,98620342,2023-01-31,,976.13
6506,98620342,2023-02-05,1533.5,2509.63
980,98620342,2023-02-10,39.48,2549.11
202,98620342,2023-02-12,1006.5,3555.61
2549,98620342,2023-02-12,91.93,3647.54
7381,98620342,2023-02-14,152.69,3800.23
2969,98671410,2023-01-31,,218.46
5123,98671410,2023-02-01,-45.64,172.82
195,98671410,2023-02-01,-83.63,89.19000000000001
2491,98671410,2023-02-02,198.45,287.64
4576,98671410,2023-02-02,95.44,383.08
1781,98671410,2023-02-03,1016.9,1399.98
2731,98671410,2023-02-05,90.06,1490.04
734,98671410,2023-02-06,-32.37,1457.6699999999998
4749,98671410,2023-02-13,-73.86,1383.81
2970,98717357,2023-01-31,,183.63
5493,98717357,2023-02-03,-151.73,31.900000000000006
7859,98717357,2023-02-04,-1369.6,-1337.6999999999998
3623,98717357,2023-02-06,-51.75,-1389.4499999999998
7157,98717357,2023-02-06,-104.0,-1493.4499999999998
2971,98776498,2023-01-31,,79.4
2972,98821521,2023-01-31,,906.51
14,98821521,2023-02-01,-54.71,851.8
4293,98821521,2023-02-02,-87.06,764.74
5233,98821521,2023-02-07,84.76,849.5
6488,98821521,2023-02-08,-88.56,760.9399999999999
6723,98821521,2023-02-13,139.98,900.92
7384,98821521,2023-02-13,-152.6,748.3199999999999
2973,98849007,2023-01-31,,58.26
340,98849007,2023-02-01,4.45,62.71
8146,98849007,2023-02-11,103.41,166.12
1391,98849007,2023-02-12,183.53,349.65
2974,98882065,2023-01-31,,630.68
2443,98882065,2023-02-01,92.81,723.49
3364,98882065,2023-02-01,-75.85,647.64
2567,98882065,2023-02-06,-1065.6,-417.9599999999999
6911,98882065,2023-02-07,84.81,-333.1499999999999
7867,98882065,2023-02-07,-125.12,-458.2699999999999
6206,98882065,2023-02-09,56.29,-401.9799999999999
5099,98882065,2023-02-11,-45.84,-447.81999999999994
2975,98882225,2023-01-31,,881.65
7239,98882225,2023-02-05,153.59,1035.24
741,98882225,2023-02-05,-1712.2,-676.96
298,98882225,2023-02-11,259.39,-417.57000000000005
5778,98882225,2023-02-13,56.85,-360.72
2976,98886699,2023-01-31,,300.31
1506,98886699,2023-02-01,152.86,453.17
5287,98886699,2023-02-04,80.75,533.9200000000001
1938,98886699,2023-02-04,-44.06,489.86
1650,98886699,2023-02-10,-1124.9,-635.0400000000001
469,98886699,2023-02-11,32.04,-603.0000000000001
8278,98886699,2023-02-12,180.44,-422.56000000000006
2977,98931016,2023-01-31,,561.33
2376,98931016,2023-02-02,89.8,651.13
2024,98931016,2023-02-02,69.41,720.5400000000001
2544,98931016,2023-02-02,-755.3,-34.75999999999988
3702,98931016,2023-02-10,96.34,61.580000000000126
674,98931016,2023-02-14,349.1,410.6800000000002
2978,98940578,2023-01-31,,59.28
4027,98940578,2023-02-06,1032.3,1091.58
4528,98940578,2023-02-06,-94.25,997.3299999999999
6587,98940578,2023-02-07,99.74,1097.07
697,98940578,2023-02-08,-44.49,1052.58
2979,99000939,2023-01-31,,155.29
2304,99000939,2023-02-04,-58.31,96.97999999999999
633,99000939,2023-02-06,-138.14,-41.16
5611,99000939,2023-02-07,-11.35,-52.51
5810,99000939,2023-02-07,-92.7,-145.21
4516,99000939,2023-02-09,-84.51,-229.72
2980,99015119,2023-01-31,,443.55
8321,99015119,2023-02-03,565.2,1008.75
5,99015119,2023-02-03,-112.46,896.29
5584,99015119,2023-02-05,49.2,945.49
767,99015119,2023-02-06,-76.0,869.49
3391,99015119,2023-02-09,147.12,1016.61
6305,99015119,2023-02-11,-125.31,891.3
5351,99015119,2023-02-12,-18.99,872.3100000000001
2981,99244906,2023-01-31,,965.33
3435,99244906,2023-02-01,-88.65,876.6800000000001
312,99244906,2023-02-02,51.28,927.96
6341,99244906,2023-02-04,-105.17,822.7900000000001
8493,99244906,2023-02-08,-133.74,689.05
1136,99244906,2023-02-10,-50.52,638.53
8435,99244906,2023-02-13,-72.94,565.59
2982,99261094,2023-01-31,,475.8
3475,99261094,2023-02-01,-119.5,356.3
6986,99261094,2023-02-04,85.2,441.5
5642,99261094,2023-02-06,646.5,1088.0
8254,99261094,2023-02-10,-25.17,1062.83
6332,99261094,2023-02-12,209.98,1272.81
7765,99261094,2023-02-12,38.33,1311.14
6378,99261094,2023-02-14,-98.11,1213.03
1474,99261094,2023-02-14,-111.83,1101.2
2983,99296816,2023-01-31,,814.56
6752,99296816,2023-02-01,-246.14,568.42
6940,99296816,2023-02-02,-634.2,-65.78000000000009
8315,99296816,2023-02-05,-76.31,-142.0900000000001
6751,99296816,2023-02-06,56.09,-86.00000000000009
2375,99296816,2023-02-06,-77.23,-163.23000000000008
7245,99296816,2023-02-08,66.6,-96.6300000000001
7578,99296816,2023-02-10,178.01,81.3799999999999
3354,99296816,2023-02-14,-83.33,-1.9500000000001023
2984,99481977,2023-01-31,,940.06
4375,99481977,2023-02-01,114.04,1054.1
3032,99481977,2023-02-02,1695.5,2749.6
6031,99481977,2023-02-07,-43.31,2706.29
1710,99481977,2023-02-07,-1808.5,897.79
5888,99481977,2023-02-09,-89.48,808.31
5738,99481977,2023-02-13,-129.28,679.03
5328,99481977,2023-02-14,-40.82,638.2099999999999
2985,99496896,2023-01-31,,431.32
923,99496896,2023-02-08,65.82,497.14
2986,99514298,2023-01-31,,154.78
4648,99514298,2023-02-01,-73.14,81.64
7923,99514298,2023-02-02,111.58,193.22
5146,99514298,2023-02-04,-62.25,130.97
5021,99514298,2023-02-05,-81.05,49.92
8449,99514298,2023-02-06,-75.9,-25.980000000000004
646,99514298,2023-02-07,1121.9,1095.92
2392,99514298,2023-02-07,-104.21,991.71
993,99514298,2023-02-10,-147.51,844.2
256,99514298,2023-02-12,-148.17,696.0300000000001
5508,99514298,2023-02-14,-558.8,137.23000000000013
2987,99553778,2023-01-31,,621.65
386,99553778,2023-02-04,180.29,801.9399999999999
4778,99553778,2023-02-04,163.96,965.9
5864,99553778,2023-02-04,104.91,1070.81
8374,99553778,2023-02-04,-141.33,929.48
3072,99553778,2023-02-05,-974.8,-45.319999999999936
7523,99553778,2023-02-10,97.9,52.58000000000007
941,99553778,2023-02-12,-63.69,-11.109999999999928
431,99553778,2023-02-13,-47.54,-58.64999999999993
1621,99553778,2023-02-14,-76.31,-134.95999999999992
2988,99611232,2023-01-31,,849.72
6042,99611232,2023-02-01,-119.74,729.98
2605,99611232,2023-02-04,-117.6,612.38
7945,99611232,2023-02-06,69.84,682.22
1268,99611232,2023-02-09,-161.19,521.03
7956,99611232,2023-02-10,-38.38,482.65000000000003
8348,99611232,2023-02-14,49.55,532.2
2989,99657974,2023-01-31,,263.32
4614,99657974,2023-02-01,-114.47,148.85
1700,99657974,2023-02-03,-157.43,-8.580000000000013
2646,99657974,2023-02-06,1.58,-7.000000000000012
7061,99657974,2023-02-08,160.99,153.99
220,99657974,2023-02-09,82.14,236.13
4263,99657974,2023-02-10,57.04,293.17
5541,99657974,2023-02-14,134.42,427.59000000000003
2990,99678854,2023-01-31,,664.0
3424,99678854,2023-02-06,128.13,792.13
2103,99678854,2023-02-07,199.41,991.54
6000,99678854,2023-02-07,76.35,1067.8899999999999
4142,99678854,2023-02-14,111.15,1179.04
2991,99685765,2023-01-31,,43.01
4180,99685765,2023-02-02,10.1,53.11
2455,99685765,2023-02-04,91.11,144.22
2693,99685765,2023-02-06,-120.6,23.620000000000005
2534,99685765,2023-02-08,-957.8,-934.18
447,99685765,2023-02-09,34.17,-900.01
5820,99685765,2023-02-10,-98.69,-998.6999999999999
6787,99685765,2023-02-11,1815.0,816.3000000000001
2992,99709741,2023-01-31,,98.23
6816,99709741,2023-02-07,12.69,110.92
963,99709741,2023-02-09,73.82,184.74
1263,99709741,2023-02-13,-138.4,46.339999999999975
2993,99729369,2023-01-31,,751.01
780,99729369,2023-02-01,-1194.4,-443.3900000000001
7889,99729369,2023-02-02,124.21,-319.1800000000001
2715,99729369,2023-02-03,-240.26,-559.44
4797,99729369,2023-02-03,-1619.6,-2179.04
3649,99729369,2023-02-04,127.68,-2051.36
1289,99729369,2023-02-06,-89.63,-2140.99
8087,99729369,2023-02-07,138.38,-2002.61
442,99729369,2023-02-10,-144.33,-2146.94
2994,99730589,2023-01-31,,988.44
5591,99730589,2023-02-03,58.23,1046.67
4231,99730589,2023-02-09,155.34,1202.01
4260,99730589,2023-02-10,62.26,1264.27
2995,99734848,2023-01-31,,354.29
7253,99734848,2023-02-04,503.6,857.8900000000001
3688,99734848,2023-02-12,-1342.4,-484.51
7128,99734848,2023-02-14,-79.76,-564.27
2996,99760030,2023-01-31,,988.0
3252,99760030,2023-02-02,616.7,1604.7
156,99760030,2023-02-02,-1028.8,575.9000000000001
2865,99760030,2023-02-07,-173.55,402.3500000000001
2253,99760030,2023-02-08,80.13,482.4800000000001
6416,99760030,2023-02-11,118.35,600.83
1585,99760030,2023-02-12,-139.76,461.07000000000005
1277,99760030,2023-02-14,140.07,601.1400000000001
2997,99791709,2023-01-31,,15.05
7025,99791709,2023-02-03,-89.38,-74.33
5583,99791709,2023-02-04,142.88,68.55
1508,99791709,2023-02-04,-2.86,65.69
7625,99791709,2023-02-06,-1359.0,-1293.31
3063,99791709,2023-02-11,78.32,-1214.99
2941,99791709,2023-02-13,800.9,-414.0899999999999
2998,99877007,2023-01-31,,582.0
2124,99877007,2023-02-01,-103.16,478.84000000000003
4789,99877007,2023-02-02,189.79,668.63
1186,99877007,2023-02-05,-72.33,596.3
7799,99877007,2023-02-07,154.41,750.71
1155,99877007,2023-02-11,84.59,835.3
2999,99937043,2023-01-31,,918.42
867,99937043,2023-02-01,71.22,989.64
5417,99937043,2023-02-02,-142.45,847.1899999999999
7077,99937043,2023-02-03,-52.49,794.6999999999999
3823,99937043,2023-02-04,123.12,917.8199999999999
2118,99937043,2023-02-05,52.36,970.18
1735,99937043,2023-02-06,-92.42,877.76
6325,99937043,2023-02-09,-122.91,754.8499999999999
3284,99937043,2023-02-11,-125.33,629.52
8474,99937043,2023-02-13,75.16,704.68
